Date,Coalition,Region or State,Adult ICU Empty,Adult ICU Ful,Adult Intensive Care Unit Staffed Bed Capacity,At Admission Confirmed Covid19 Patients In 24 Hrs,At Admission Suspected Covid19 Patients In 24 Hrs,Full Adult Icu Covid19 Positive Patients,Hospital Cnt,Inpatient Empty Beds (all types),Inpatient Full (all bed types),Number of Additional Surge Beds Being Planned,Number of COVID-19 Positive Patients In Hospital,TOTAL Staffed Inpatient Capacity (all bed types),Ventilator available,Ventilator used (not specific to COVID-19)
4/6/2020,CapRAC,Region,74,150,224,,,,5,712,1254,587,50,1966,263,75
4/7/2020,CapRAC,Region,60,138,198,,,,4,664,1189,452,50,1853,255,67
4/8/2020,CapRAC,Region,65,159,224,,,,5,613,1354,587,56,1967,267,73
4/9/2020,CapRAC,Region,72,152,224,,,,5,566,1396,587,58,1962,272,68
4/10/2020,CapRAC,Region,9,31,40,,,,2,74,129,155,14,203,23,11
4/11/2020,CapRAC,Region,89,134,223,,,,5,965,889,587,65,1854,278,62
4/12/2020,CapRAC,Region,85,137,222,,,,5,773,1176,587,73,1949,277,63
4/13/2020,CapRAC,Region,78,144,222,,,,5,990,957,587,70,1947,279,61
4/14/2020,CapRAC,Region,78,142,220,,,,5,690,1276,496,68,1966,275,65
4/15/2020,CapRAC,Region,71,153,224,,,,5,649,1346,491,72,1995,266,74
4/16/2020,CapRAC,Region,72,152,224,,,,5,596,1362,552,73,1958,278,61
4/17/2020,CapRAC,Region,66,158,224,,,,5,608,1348,552,67,1956,279,60
4/18/2020,CapRAC,Region,80,144,224,,,,5,616,1342,556,66,1958,269,63
4/19/2020,CapRAC,Region,88,136,224,,,,5,704,1254,552,61,1958,282,56
4/20/2020,CapRAC,Region,82,142,224,,,,5,606,1352,552,66,1958,287,53
4/21/2020,CapRAC,Region,74,150,224,,,,5,444,1520,552,80,1964,279,61
4/22/2020,CapRAC,Region,79,141,220,,,,5,485,1485,552,81,1970,273,67
4/23/2020,CapRAC,Region,100,124,224,,,,5,554,1411,552,93,1965,283,57
4/24/2020,CapRAC,Region,99,125,224,,,,5,541,1432,552,92,1973,281,59
4/25/2020,CapRAC,Region,90,134,224,,,,5,517,1364,552,80,1881,282,58
4/26/2020,CapRAC,Region,93,131,224,,,,5,620,1344,552,73,1964,285,53
4/27/2020,CapRAC,Region,-14,238,224,,,,5,772,1194,558,78,1966,291,49
4/28/2020,CapRAC,Region,74,150,224,,,,5,676,1288,552,84,1964,275,53
4/29/2020,CapRAC,Region,65,159,224,,,,5,631,1333,552,98,1964,271,57
4/30/2020,CapRAC,Region,73,151,224,,,,5,617,1355,552,87,1972,262,66
5/1/2020,CapRAC,Region,77,147,224,,,,5,694,1275,552,86,1969,263,65
5/2/2020,CapRAC,Region,64,150,214,,,,4,687,1142,552,75,1829,262,58
5/3/2020,CapRAC,Region,86,138,224,,,,5,767,1209,552,81,1976,269,59
5/4/2020,CapRAC,Region,74,148,222,,,,5,743,1229,552,85,1972,264,64
5/5/2020,CapRAC,Region,54,170,224,,,,5,607,1366,552,84,1973,267,61
5/6/2020,CapRAC,Region,51,173,224,,,,5,578,1396,552,79,1974,272,56
5/7/2020,CapRAC,Region,47,177,224,,,,5,522,1458,552,75,1980,266,62
5/8/2020,CapRAC,Region,41,183,224,,,,5,551,1428,552,77,1979,270,58
5/9/2020,CapRAC,Region,47,177,224,,,,5,605,1375,552,72,1980,242,86
5/10/2020,CapRAC,Region,64,160,224,,,,5,657,1309,552,68,1966,256,72
5/11/2020,CapRAC,Region,76,148,224,,,,5,617,1364,552,73,1981,256,72
5/12/2020,CapRAC,Region,70,154,224,,,,5,568,1420,552,71,1988,254,74
5/13/2020,CapRAC,Region,52,172,224,,,,5,539,1453,552,57,1992,251,70
5/14/2020,CapRAC,Region,54,170,224,,,,5,564,1421,552,45,1985,254,74
5/15/2020,CapRAC,Region,56,168,224,,,,5,607,1375,552,37,1982,258,70
5/16/2020,CapRAC,Region,59,165,224,,,,5,601,1378,552,42,1979,263,65
5/17/2020,CapRAC,Region,78,146,224,,,,5,663,1321,552,43,1984,268,60
5/18/2020,CapRAC,Region,57,167,224,,,,5,623,1367,552,61,1990,278,50
5/19/2020,CapRAC,Region,57,167,224,,,,5,538,1468,552,64,2006,280,48
5/20/2020,CapRAC,Region,58,166,224,,,,5,535,1461,552,68,1996,272,56
5/21/2020,CapRAC,Region,63,159,222,,,,5,516,1472,552,68,1988,254,74
5/22/2020,CapRAC,Region,61,163,224,,,,5,493,1495,552,68,1988,259,69
5/23/2020,CapRAC,Region,52,172,224,,,,5,562,1430,552,72,1992,257,71
5/24/2020,CapRAC,Region,69,155,224,,,,5,588,1390,552,62,1978,251,77
5/25/2020,CapRAC,Region,42,182,224,,,,5,605,1373,552,66,1978,255,73
5/26/2020,CapRAC,Region,79,145,224,,,,5,644,1328,552,72,1972,254,74
5/27/2020,CapRAC,Region,54,170,224,,,,5,559,1423,552,68,1982,256,72
5/28/2020,CapRAC,Region,53,171,224,,,,5,500,1480,586,69,1980,249,79
5/29/2020,CapRAC,Region,47,177,224,,,,5,526,1458,587,69,1984,251,77
5/30/2020,CapRAC,Region,55,169,224,,,,5,479,1495,587,61,1974,254,74
5/31/2020,CapRAC,Region,55,169,224,,,,5,564,1411,587,69,1975,242,86
6/1/2020,CapRAC,Region,71,153,224,,,,5,596,1391,587,74,1987,243,85
6/2/2020,CapRAC,Region,60,138,198,,,,4,481,1368,452,60,1849,230,81
6/3/2020,CapRAC,Region,65,159,224,21,10,37,5,463,1539,587,80,2002,243,85
6/4/2020,CapRAC,Region,66,158,224,15,10,32,5,414,1568,587,84,1982,237,91
6/5/2020,CapRAC,Region,49,175,224,20,12,36,5,431,1543,587,98,1974,231,97
6/6/2020,CapRAC,Region,56,168,224,21,9,37,5,455,1523,587,105,1978,243,85
6/7/2020,CapRAC,Region,46,170,216,10,7,43,4,408,1421,587,101,1829,239,81
6/8/2020,CapRAC,Region,51,173,224,10,5,47,5,556,1422,587,108,1978,252,76
6/9/2020,CapRAC,Region,47,177,224,10,11,46,5,416,1564,587,107,1980,248,80
6/10/2020,CapRAC,Region,47,174,221,13,21,44,5,340,1670,587,119,2010,250,78
6/11/2020,CapRAC,Region,49,175,224,17,9,44,5,378,1635,587,117,2013,238,90
6/12/2020,CapRAC,Region,47,177,224,8,5,52,5,426,1593,587,123,2019,235,93
6/13/2020,CapRAC,Region,46,178,224,19,22,54,5,470,1533,587,125,2003,237,91
6/14/2020,CapRAC,Region,37,187,224,17,14,50,5,492,1497,587,124,1989,211,117
6/15/2020,CapRAC,Region,42,182,224,12,7,45,5,480,1528,587,120,2008,213,115
6/16/2020,CapRAC,Region,31,193,224,18,8,56,5,390,1607,587,134,1997,221,107
6/17/2020,CapRAC,Region,31,193,224,19,10,60,5,389,1607,587,140,1996,227,101
6/18/2020,CapRAC,Region,24,200,224,19,17,55,5,365,1644,587,137,2009,238,90
6/19/2020,CapRAC,Region,40,184,224,18,7,54,5,368,1633,465,146,2001,227,101
6/20/2020,CapRAC,Region,53,171,224,13,12,54,5,453,1554,587,146,2007,227,101
6/21/2020,CapRAC,Region,43,173,216,23,12,58,4,376,1472,587,154,1848,226,94
6/22/2020,CapRAC,Region,40,184,224,20,12,59,5,461,1543,587,169,2004,224,104
6/23/2020,CapRAC,Region,30,194,224,14,9,60,5,369,1642,587,163,2011,227,101
6/24/2020,CapRAC,Region,48,209,257,22,11,56,5,440,1586,469,160,2026,247,98
6/25/2020,CapRAC,Region,43,212,255,20,8,55,5,462,1570,469,156,2032,228,117
6/26/2020,CapRAC,Region,39,218,257,12,15,54,5,442,1590,469,150,2032,240,105
6/27/2020,CapRAC,Region,52,205,257,17,13,60,5,455,1560,469,146,2015,246,97
6/28/2020,CapRAC,Region,45,212,257,12,11,63,5,518,1498,469,146,2016,260,85
6/29/2020,CapRAC,Region,47,210,257,16,17,60,5,403,1609,469,152,2012,261,84
6/30/2020,CapRAC,Region,42,215,257,30,21,63,5,393,1633,469,156,2026,258,87
7/1/2020,CapRAC,Region,32,225,257,22,20,62,5,373,1647,469,165,2020,267,78
7/2/2020,CapRAC,Region,39,218,257,12,14,61,5,383,1627,469,156,2010,279,66
7/3/2020,CapRAC,Region,36,221,257,22,15,72,5,440,1588,469,177,2028,269,76
7/4/2020,CapRAC,Region,37,220,257,19,18,73,5,523,1487,469,189,2010,267,78
7/5/2020,CapRAC,Region,36,221,257,15,13,81,5,522,1490,469,185,2012,266,79
7/6/2020,CapRAC,Region,30,227,257,12,23,80,5,501,1519,469,182,2020,248,97
7/7/2020,CapRAC,Region,36,221,257,27,23,73,5,416,1604,469,204,2020,244,101
7/8/2020,CapRAC,Region,30,219,249,21,24,69,4,294,1591,474,207,1885,229,108
7/9/2020,CapRAC,Region,28,229,257,8,20,62,5,473,1547,474,187,2020,233,112
7/10/2020,CapRAC,Region,37,220,257,1,21,55,5,476,1542,394,193,2018,248,97
7/11/2020,CapRAC,Region,52,205,257,8,27,57,5,529,1489,424,185,2018,253,92
7/12/2020,CapRAC,Region,52,205,257,16,11,54,5,533,1485,428,191,2018,260,85
7/13/2020,CapRAC,Region,55,202,257,6,27,49,5,519,1497,474,189,2016,259,86
7/14/2020,CapRAC,Region,35,222,257,10,30,53,5,473,1553,476,186,2026,255,90
7/15/2020,CapRAC,Region,47,210,257,13,42,46,5,453,1567,476,197,2020,263,82
7/16/2020,CapRAC,Region,54,203,257,11,35,52,5,413,1611,476,197,2024,268,77
7/17/2020,CapRAC,Region,43,214,257,20,28,63,5,447,1573,476,199,2020,266,79
7/18/2020,CapRAC,Region,55,202,257,22,26,59,5,484,1538,476,199,2022,269,76
7/19/2020,CapRAC,Region,53,203,256,18,11,54,5,494,1511,476,171,2005,272,73
7/20/2020,CapRAC,Region,49,206,255,14,17,51,5,523,1493,476,187,2016,278,67
7/21/2020,CapRAC,Region,45,210,255,16,16,50,5,370,1650,476,196,2020,277,68
7/22/2020,CapRAC,Region,44,211,255,11,27,57,5,396,1616,476,196,2012,269,76
7/23/2020,CapRAC,Region,46,211,257,11,32,56,5,380,1640,476,179,2020,274,71
7/24/2020,CapRAC,Region,45,124,169,7,31,30,5,301,855,259,98,1156,165,37
7/25/2020,CapRAC,Region,51,118,169,8,23,35,5,433,721,259,99,1154,166,36
7/26/2020,CapRAC,Region,118,51,169,7,22,37,5,470,678,259,94,1148,163,39
7/27/2020,CapRAC,Region,118,50,168,7,24,33,5,378,678,259,91,1056,155,47
7/28/2020,CapRAC,Region,124,55,179,8,30,36,5,439,717,259,97,1156,152,50
7/29/2020,CapRAC,Region,35,134,169,8,24,37,5,236,912,259,99,1148,150,52
7/30/2020,CapRAC,Region,31,138,169,12,15,37,5,338,824,259,107,1162,151,51
7/31/2020,CapRAC,Region,40,129,169,9,25,42,5,376,782,259,100,1158,151,51
8/1/2020,CapRAC,Region,42,127,169,8,19,44,5,379,777,259,104,1156,151,51
8/2/2020,CapRAC,Region,40,121,161,3,18,37,4,272,743,259,97,1015,148,46
8/3/2020,CapRAC,Region,48,121,169,8,17,35,5,356,802,259,99,1158,151,49
8/4/2020,CapRAC,Region,44,125,169,6,31,33,5,339,828,259,96,1167,155,47
8/5/2020,CapRAC,Region,39,130,169,12,26,30,5,335,835,259,96,1170,157,45
8/6/2020,CapRAC,Region,43,118,161,6,24,26,4,266,751,259,94,1017,150,44
8/7/2020,CapRAC,Region,45,123,168,3,23,26,5,378,782,259,93,1160,155,43
8/8/2020,CapRAC,Region,52,117,169,2,26,27,5,421,742,259,98,1163,157,45
8/9/2020,CapRAC,Region,58,111,169,3,18,26,5,418,744,259,97,1162,164,38
8/10/2020,CapRAC,Region,34,135,169,1,26,27,5,361,809,259,86,1170,157,45
8/11/2020,CapRAC,Region,39,130,169,1,30,25,5,358,809,259,82,1167,154,48
8/12/2020,CapRAC,Region,47,122,169,5,31,24,5,339,814,259,76,1153,158,44
8/13/2020,CapRAC,Region,50,119,169,3,29,23,5,366,809,259,79,1175,154,48
8/14/2020,CapRAC,Region,47,113,160,1,27,24,4,265,762,259,63,1027,155,39
8/15/2020,CapRAC,Region,47,120,167,2,25,23,5,383,774,259,61,1157,155,47
8/16/2020,CapRAC,Region,44,123,167,5,18,25,5,381,782,258,62,1163,156,46
8/17/2020,CapRAC,Region,44,125,169,4,26,26,5,379,786,259,58,1165,159,43
8/18/2020,CapRAC,Region,44,125,169,0,22,24,5,364,801,259,62,1165,156,46
8/19/2020,CapRAC,Region,38,130,168,8,34,24,5,288,872,259,70,1160,152,50
8/20/2020,CapRAC,Region,45,123,168,7,23,24,5,365,797,259,65,1162,156,46
8/21/2020,CapRAC,Region,36,125,161,4,26,24,4,247,769,259,59,1016,155,39
4/6/2020,DHPC,Region,100,117,217,,,,7,791,1240,1028,29,2031,374,84
4/7/2020,DHPC,Region,92,125,217,,,,7,831,1241,1391,36,2072,340,91
4/8/2020,DHPC,Region,82,116,198,,,,6,620,1134,718,51,1754,335,81
4/9/2020,DHPC,Region,87,130,217,,,,6,704,1315,1400,51,2019,276,94
4/10/2020,DHPC,Region,77,142,219,,,,7,840,1360,1400,43,2200,331,96
4/11/2020,DHPC,Region,46,117,163,,,,4,580,959,1213,34,1539,239,83
4/12/2020,DHPC,Region,55,108,163,,,,4,602,936,1213,35,1538,237,91
4/13/2020,DHPC,Region,96,124,220,,,,6,838,1243,1321,50,2081,325,94
4/14/2020,DHPC,Region,74,143,217,,,,7,896,1305,1400,50,2201,330,97
4/15/2020,DHPC,Region,67,150,217,,,,7,855,1344,1400,52,2199,337,90
4/16/2020,DHPC,Region,70,147,217,,,,7,766,1425,1400,54,2191,339,88
4/17/2020,DHPC,Region,71,124,195,,,,6,756,1147,1301,42,1903,277,87
4/18/2020,DHPC,Region,45,118,163,,,,4,599,939,1213,42,1538,236,92
4/19/2020,DHPC,Region,36,127,163,,,,4,610,929,1213,48,1539,236,92
4/20/2020,DHPC,Region,50,141,191,,,,6,704,1159,1322,56,1863,306,92
4/21/2020,DHPC,Region,63,158,221,,,,8,802,1392,1327,62,2194,329,105
4/22/2020,DHPC,Region,59,164,223,,,,8,771,1433,1347,73,2204,319,115
4/23/2020,DHPC,Region,56,145,201,,,,7,658,1269,1307,65,1927,264,108
4/24/2020,DHPC,Region,55,140,195,,,,6,674,1238,1301,61,1912,263,101
4/25/2020,DHPC,Region,21,123,144,,,,3,352,940,531,48,1292,215,89
4/26/2020,DHPC,Region,33,130,163,,,,4,502,1058,1213,50,1560,224,104
4/27/2020,DHPC,Region,67,134,201,,,,7,718,1270,1307,53,1988,273,99
4/28/2020,DHPC,Region,60,160,220,,,,8,682,1548,1332,67,2230,327,108
4/29/2020,DHPC,Region,61,162,223,,,,8,673,1558,1327,72,2231,333,103
4/30/2020,DHPC,Region,54,150,204,,,,7,602,1573,1307,71,2175,339,90
5/1/2020,DHPC,Region,32,163,195,,,,6,613,1321,1301,61,1934,295,74
5/2/2020,DHPC,Region,18,145,163,,,,4,427,1132,1213,60,1559,242,87
5/3/2020,DHPC,Region,21,142,163,,,,4,449,1109,1213,63,1558,244,85
5/4/2020,DHPC,Region,46,149,195,,,,6,584,1330,644,67,1914,319,87
5/5/2020,DHPC,Region,21,148,169,,,,5,421,1162,556,62,1583,283,89
5/6/2020,DHPC,Region,53,166,219,,,,8,608,1651,1350,73,2259,346,94
5/7/2020,DHPC,Region,59,160,219,,,,8,593,1646,1324,71,2239,361,79
5/8/2020,DHPC,Region,63,157,220,,,,8,629,1626,1332,84,2255,360,76
5/9/2020,DHPC,Region,21,154,175,,,,5,448,1362,1223,75,1810,308,84
5/10/2020,DHPC,Region,30,133,163,,,,4,501,1058,1213,61,1559,247,82
5/11/2020,DHPC,Region,59,136,195,,,,6,703,1239,1301,64,1942,278,91
5/12/2020,DHPC,Region,47,170,217,,,,7,645,1553,1321,81,2198,335,97
5/13/2020,DHPC,Region,53,162,215,,,,7,596,1586,1326,73,2182,329,103
5/14/2020,DHPC,Region,45,172,217,,,,7,560,1634,1351,80,2194,335,97
5/15/2020,DHPC,Region,32,183,215,,,,7,554,1620,1321,75,2174,339,92
5/16/2020,DHPC,Region,24,157,181,,,,5,428,1360,1233,74,1788,297,95
5/17/2020,DHPC,Region,26,155,181,,,,5,442,1347,1221,77,1789,305,87
5/18/2020,DHPC,Region,34,189,223,,,,8,675,1575,1357,90,2250,354,85
5/19/2020,DHPC,Region,13,169,182,,,,6,351,1501,1273,71,1852,295,105
5/20/2020,DHPC,Region,37,155,192,,,,6,366,1548,669,71,1914,311,96
5/21/2020,DHPC,Region,8,180,188,,,,6,293,1589,1273,78,1882,293,107
5/22/2020,DHPC,Region,47,167,214,,,,7,465,1753,1351,95,2218,341,91
5/23/2020,DHPC,Region,28,149,177,,,,5,346,1460,1263,91,1806,301,91
5/24/2020,DHPC,Region,34,144,178,,,,5,383,1405,1263,97,1788,298,94
5/25/2020,DHPC,Region,31,143,174,,,,5,447,1376,1263,99,1823,307,85
5/26/2020,DHPC,Region,43,161,204,,,,7,608,1598,1351,107,2206,350,81
5/27/2020,DHPC,Region,43,164,207,,,,7,493,1698,1351,120,2191,351,80
5/28/2020,DHPC,Region,46,191,237,,,,7,457,1737,1351,109,2194,358,74
5/29/2020,DHPC,Region,44,180,224,,,,5,302,1590,669,84,1892,315,92
5/30/2020,DHPC,Region,18,160,178,,,,5,320,1490,1263,90,1810,300,92
5/31/2020,DHPC,Region,33,141,174,,,,5,364,1447,1223,93,1811,318,75
6/1/2020,DHPC,Region,31,137,168,,,,5,296,1299,591,79,1595,300,75
6/2/2020,DHPC,Region,26,142,168,,,,5,214,1399,592,81,1613,290,85
6/3/2020,DHPC,Region,10,152,162,9,1,29,5,263,1331,1223,81,1594,251,86
6/4/2020,DHPC,Region,49,185,234,17,4,42,7,265,1860,1351,116,2125,288,91
6/5/2020,DHPC,Region,14,165,179,8,1,40,7,247,1604,1273,104,1851,303,97
6/6/2020,DHPC,Region,14,161,175,9,10,37,5,295,1492,1263,98,1787,282,110
6/7/2020,DHPC,Region,17,158,175,6,13,42,5,357,1417,1263,98,1774,290,102
6/8/2020,DHPC,Region,42,180,222,11,4,42,6,359,1476,669,94,1835,312,95
6/9/2020,DHPC,Region,55,181,236,11,4,44,7,381,1739,1351,112,2120,332,100
6/10/2020,DHPC,Region,17,163,180,11,0,40,6,273,1601,1273,104,1874,303,97
6/11/2020,DHPC,Region,67,169,236,19,8,48,7,371,1762,1351,115,2133,331,101
6/12/2020,DHPC,Region,51,184,235,10,7,44,7,417,1719,1351,115,2136,332,100
6/13/2020,DHPC,Region,14,160,174,10,32,38,5,311,1524,1263,104,1835,297,95
6/14/2020,DHPC,Region,27,149,176,11,11,37,5,336,1451,1223,104,1787,290,103
6/15/2020,DHPC,Region,74,147,221,12,5,61,6,367,1475,1273,113,1842,301,99
6/16/2020,DHPC,Region,24,160,184,11,6,41,6,309,1562,1273,103,1871,472,98
6/17/2020,DHPC,Region,27,209,236,16,5,42,7,268,1836,1351,109,2104,313,117
6/18/2020,DHPC,Region,37,194,231,18,8,39,7,325,1805,1351,113,2130,334,98
6/19/2020,DHPC,Region,16,162,178,13,8,36,6,256,1545,1121,98,1801,143,87
6/20/2020,DHPC,Region,14,160,174,10,6,34,5,240,1475,1111,100,1715,163,86
6/21/2020,DHPC,Region,16,156,172,13,4,42,5,282,1407,1111,107,1689,140,82
6/22/2020,DHPC,Region,35,198,233,10,2,49,7,402,1613,1199,120,2015,164,98
6/23/2020,DHPC,Region,42,193,235,12,24,50,7,342,1726,1199,120,2068,163,98
6/24/2020,DHPC,Region,30,204,234,12,27,45,7,322,1741,1199,106,2063,169,93
6/25/2020,DHPC,Region,15,165,180,10,6,44,6,204,1585,1121,98,1789,132,98
6/26/2020,DHPC,Region,18,161,179,12,6,43,6,210,1586,1121,97,1796,140,90
6/27/2020,DHPC,Region,19,154,173,8,7,40,5,207,1517,1111,106,1724,123,99
6/28/2020,DHPC,Region,28,145,173,8,8,37,5,264,1432,1071,99,1696,131,91
6/29/2020,DHPC,Region,44,190,234,9,4,39,7,432,1598,1189,108,2030,181,89
6/30/2020,DHPC,Region,26,152,178,12,5,36,5,404,1359,1101,103,1763,147,84
7/1/2020,DHPC,Region,36,196,232,8,5,39,7,434,1621,1189,105,2055,178,91
7/2/2020,DHPC,Region,46,186,232,8,4,33,7,443,1608,1189,108,2051,185,86
7/3/2020,DHPC,Region,25,158,183,12,2,35,6,453,1339,1111,103,1792,154,84
7/4/2020,DHPC,Region,34,142,176,13,0,30,5,469,1253,1101,98,1722,153,78
7/5/2020,DHPC,Region,20,152,172,11,4,36,5,411,1278,1101,103,1689,147,84
7/6/2020,DHPC,Region,24,156,180,11,5,32,6,405,1379,1111,107,1784,145,94
7/7/2020,DHPC,Region,23,161,184,16,4,34,6,378,1417,1111,110,1795,139,99
7/8/2020,DHPC,Region,23,162,185,17,1,34,6,369,1432,1111,108,1801,161,77
7/9/2020,DHPC,Region,40,198,238,8,3,36,7,387,1661,1189,106,2048,178,92
7/10/2020,DHPC,Region,20,163,183,15,7,33,6,314,1457,1111,106,1771,145,92
7/11/2020,DHPC,Region,25,154,179,13,4,33,5,393,1328,1101,100,1721,133,98
7/12/2020,DHPC,Region,16,161,177,11,2,36,5,397,1318,1101,95,1715,139,92
7/13/2020,DHPC,Region,15,197,212,16,2,37,7,447,1557,1189,107,2004,167,104
7/14/2020,DHPC,Region,6,148,154,12,3,45,6,378,1397,1111,100,1775,144,95
7/15/2020,DHPC,Region,16,144,160,16,3,42,6,360,1415,1111,112,1775,153,85
7/16/2020,DHPC,Region,31,183,214,17,6,43,7,420,1620,1189,126,2040,186,84
7/17/2020,DHPC,Region,26,183,209,19,4,46,7,385,1639,1189,129,2024,189,81
7/18/2020,DHPC,Region,12,146,158,11,8,37,6,354,1365,1111,124,1719,153,85
7/19/2020,DHPC,Region,14,133,147,11,0,40,5,341,1326,1101,124,1667,150,81
7/20/2020,DHPC,Region,14,141,155,14,2,33,6,334,1423,1111,132,1757,155,83
7/21/2020,DHPC,Region,30,181,211,13,6,34,7,366,1662,1189,121,2028,198,73
7/22/2020,DHPC,Region,23,187,210,22,4,36,7,371,1666,1189,125,2037,197,74
7/23/2020,DHPC,Region,29,181,210,15,2,31,7,364,1666,1189,125,2030,192,79
7/24/2020,DHPC,Region,32,176,208,15,4,35,7,412,1604,1189,127,2016,190,81
7/25/2020,DHPC,Region,16,151,167,15,21,29,6,420,1322,429,120,1742,165,76
7/26/2020,DHPC,Region,17,145,162,9,8,29,5,436,1263,419,123,1699,160,73
7/27/2020,DHPC,Region,39,182,221,6,16,27,7,474,1544,507,125,2018,192,81
7/28/2020,DHPC,Region,21,145,166,10,16,25,6,365,1415,429,108,1780,150,91
7/29/2020,DHPC,Region,16,149,165,11,17,21,6,371,1416,429,101,1787,163,78
7/30/2020,DHPC,Region,15,152,167,10,23,21,6,347,1432,429,100,1779,160,81
7/31/2020,DHPC,Region,22,146,168,8,21,18,6,462,1319,429,89,1781,160,81
8/1/2020,DHPC,Region,23,145,168,16,15,19,6,438,1320,429,97,1758,168,73
8/2/2020,DHPC,Region,25,136,161,10,15,18,5,414,1292,419,99,1706,163,70
8/3/2020,DHPC,Region,74,143,217,10,24,22,7,466,1559,507,102,2025,202,71
8/4/2020,DHPC,Region,30,186,216,11,14,20,7,387,1644,507,99,2031,201,72
8/5/2020,DHPC,Region,39,179,218,6,15,20,7,393,1649,507,97,2042,198,75
8/6/2020,DHPC,Region,22,143,165,18,19,19,6,324,1441,429,83,1765,170,71
8/7/2020,DHPC,Region,22,143,165,13,19,18,6,350,1393,429,82,1743,173,68
8/8/2020,DHPC,Region,19,141,160,9,12,21,5,373,1324,419,81,1697,163,70
8/9/2020,DHPC,Region,16,145,161,7,11,23,5,377,1323,419,82,1700,164,69
8/10/2020,DHPC,Region,17,149,166,8,17,20,6,370,1374,429,80,1744,162,79
8/11/2020,DHPC,Region,17,152,169,11,19,23,6,351,1420,429,75,1771,157,84
8/12/2020,DHPC,Region,16,156,172,7,23,20,6,309,1467,429,78,1776,160,81
8/13/2020,DHPC,Region,10,157,167,14,15,19,6,306,1476,429,73,1782,162,79
8/14/2020,DHPC,Region,11,158,169,9,16,19,6,341,1427,429,74,1768,154,87
8/15/2020,DHPC,Region,26,147,173,9,20,19,6,429,1344,429,67,1773,174,67
8/16/2020,DHPC,Region,29,142,171,4,15,15,6,386,1368,429,81,1754,167,74
8/17/2020,DHPC,Region,23,148,171,4,12,18,6,323,1449,429,70,1772,160,81
8/18/2020,DHPC,Region,30,143,173,7,18,21,6,335,1446,429,68,1781,164,77
8/19/2020,DHPC,Region,26,147,173,9,14,17,6,355,1428,429,64,1783,156,82
8/20/2020,DHPC,Region,34,139,173,8,21,18,6,373,1412,429,65,1785,157,84
8/21/2020,DHPC,Region,27,140,167,14,17,17,6,403,1379,429,63,1782,157,81
4/6/2020,EHPC,Region,96,170,266,,,,18,1174,1233,778,53,2407,299,116
4/7/2020,EHPC,Region,99,185,284,,,,18,1366,1490,851,60,2856,343,123
4/8/2020,EHPC,Region,97,168,265,,,,17,1013,1346,737,56,2359,327,113
4/9/2020,EHPC,Region,98,175,273,,,,17,1207,1472,821,73,2679,344,117
4/10/2020,EHPC,Region,110,182,292,,,,19,1219,1517,801,73,2736,348,120
4/11/2020,EHPC,Region,40,165,205,,,,10,621,987,105,34,1608,222,99
4/12/2020,EHPC,Region,91,141,232,,,,12,904,1056,167,42,1960,244,108
4/13/2020,EHPC,Region,112,186,298,,,,19,1287,1547,829,75,2834,331,126
4/14/2020,EHPC,Region,104,191,295,,,,19,1206,1510,972,76,2716,362,121
4/15/2020,EHPC,Region,117,175,292,,,,19,1223,1533,854,81,2756,360,123
4/16/2020,EHPC,Region,109,173,282,,,,18,1122,1483,812,75,2605,337,124
4/17/2020,EHPC,Region,109,176,285,,,,18,1152,1427,779,71,2579,354,115
4/18/2020,EHPC,Region,39,237,276,,,,17,951,1351,732,77,2302,345,110
4/19/2020,EHPC,Region,104,186,290,,,,19,1188,1445,798,82,2633,351,123
4/20/2020,EHPC,Region,98,177,275,,,,18,1201,1421,842,81,2622,347,119
4/21/2020,EHPC,Region,92,198,290,,,,19,1095,1537,848,84,2632,337,123
4/22/2020,EHPC,Region,80,200,280,,,,18,932,1615,790,70,2547,353,120
4/23/2020,EHPC,Region,70,213,283,,,,18,964,1513,581,74,2477,347,117
4/24/2020,EHPC,Region,88,179,267,,,,16,902,1310,530,68,2212,342,99
4/25/2020,EHPC,Region,18,255,273,,,,17,743,1437,548,83,2180,283,121
4/26/2020,EHPC,Region,104,182,286,,,,18,952,1437,558,85,2389,331,109
4/27/2020,EHPC,Region,104,179,283,,,,18,999,1404,646,79,2403,359,112
4/28/2020,EHPC,Region,97,181,278,,,,18,925,1481,638,97,2406,289,125
4/29/2020,EHPC,Region,93,195,288,,,,19,988,1570,649,91,2558,376,124
4/30/2020,EHPC,Region,99,188,287,,,,18,1110,1563,655,93,2673,367,124
5/1/2020,EHPC,Region,103,148,251,,,,15,958,1305,562,61,2263,358,87
5/2/2020,EHPC,Region,42,221,263,,,,15,787,1390,517,75,2177,337,106
5/3/2020,EHPC,Region,93,172,265,,,,15,856,1323,521,78,2179,331,110
5/4/2020,EHPC,Region,103,187,290,,,,19,1071,1473,644,99,2544,392,111
5/5/2020,EHPC,Region,83,205,288,,,,19,1101,1542,641,105,2643,386,114
5/6/2020,EHPC,Region,87,203,290,,,,19,951,1570,387,94,2521,370,129
5/7/2020,EHPC,Region,127,152,279,,,,18,874,1453,638,78,2327,378,100
5/8/2020,EHPC,Region,99,187,286,,,,18,883,1489,587,85,2372,369,116
5/9/2020,EHPC,Region,40,211,251,,,,14,542,1356,590,56,1898,268,98
5/10/2020,EHPC,Region,98,162,260,,,,16,785,1345,439,81,2130,345,115
5/11/2020,EHPC,Region,145,172,317,,,,18,979,1587,743,98,2566,326,114
5/12/2020,EHPC,Region,121,169,290,,,,19,959,1567,635,96,2526,401,97
5/13/2020,EHPC,Region,107,181,288,,,,19,896,1644,746,95,2540,391,110
5/14/2020,EHPC,Region,101,184,285,,,,19,841,1650,628,98,2491,391,117
5/15/2020,EHPC,Region,90,178,268,,,,17,795,1497,548,85,2292,346,124
5/16/2020,EHPC,Region,49,241,290,,,,18,863,1659,800,102,2522,368,122
5/17/2020,EHPC,Region,93,170,263,,,,16,812,1402,437,95,2214,335,121
5/18/2020,EHPC,Region,99,192,291,,,,19,980,1596,642,122,2576,379,119
5/19/2020,EHPC,Region,83,204,287,,,,18,858,1626,725,111,2484,366,120
5/20/2020,EHPC,Region,85,185,270,,,,17,750,1594,435,109,2344,346,116
5/21/2020,EHPC,Region,88,159,247,,,,16,732,1334,662,80,2066,336,98
5/22/2020,EHPC,Region,79,159,238,,,,14,665,1341,231,87,2006,313,104
5/23/2020,EHPC,Region,39,201,240,,,,13,652,1322,237,93,1974,295,115
5/24/2020,EHPC,Region,122,166,288,,,,15,633,1519,289,101,2152,323,107
5/25/2020,EHPC,Region,103,149,252,,,,14,742,1345,387,98,2087,329,102
5/26/2020,EHPC,Region,95,175,270,,,,18,841,1506,333,114,2347,349,112
5/27/2020,EHPC,Region,79,191,270,,,,18,750,1597,363,115,2347,355,110
5/28/2020,EHPC,Region,76,182,258,,,,16,691,1520,389,90,2211,343,103
5/29/2020,EHPC,Region,90,186,276,,,,18,745,1593,423,96,2338,352,115
5/30/2020,EHPC,Region,17,249,266,,,,16,658,1560,362,88,2218,335,111
5/31/2020,EHPC,Region,-1,240,239,,,,15,535,1393,449,90,1928,288,104
6/1/2020,EHPC,Region,83,199,282,,,,19,888,1614,383,107,2502,357,112
6/2/2020,EHPC,Region,72,200,272,,,,18,818,1657,403,111,2475,338,121
6/3/2020,EHPC,Region,91,169,260,8,9,30,17,677,1549,403,103,2226,350,106
6/4/2020,EHPC,Region,91,173,264,7,3,29,17,661,1574,293,106,2235,340,109
6/5/2020,EHPC,Region,73,177,250,11,14,26,16,668,1479,363,87,2147,315,108
6/6/2020,EHPC,Region,86,154,240,14,11,21,14,427,1531,332,85,1958,288,95
6/7/2020,EHPC,Region,82,180,262,7,16,29,16,699,1531,436,118,2230,346,103
6/8/2020,EHPC,Region,91,174,265,15,14,29,17,819,1620,449,121,2439,360,100
6/9/2020,EHPC,Region,67,195,262,13,13,38,16,683,1685,357,114,2368,329,114
6/10/2020,EHPC,Region,61,207,268,10,23,35,18,646,1711,407,127,2357,367,100
6/11/2020,EHPC,Region,69,174,243,18,20,25,15,517,1547,256,85,2064,337,92
6/12/2020,EHPC,Region,80,188,268,10,16,33,17,604,1727,313,117,2331,346,105
6/13/2020,EHPC,Region,82,169,251,8,18,27,15,670,1518,487,87,2188,334,90
6/14/2020,EHPC,Region,78,168,246,11,17,27,15,797,1383,484,85,2180,327,97
6/15/2020,EHPC,Region,86,166,252,10,23,26,17,872,1488,362,93,2360,342,99
6/16/2020,EHPC,Region,79,200,279,16,26,37,17,695,1751,447,111,2446,368,108
6/17/2020,EHPC,Region,84,209,293,9,27,34,18,793,1856,565,116,2649,376,115
6/18/2020,EHPC,Region,73,220,293,16,25,39,19,702,1839,459,113,2541,373,119
6/19/2020,EHPC,Region,86,192,278,19,34,41,17,659,1799,382,110,2458,354,116
6/20/2020,EHPC,Region,71,170,241,10,14,30,13,695,1475,326,79,2170,304,100
6/21/2020,EHPC,Region,72,153,225,14,15,33,12,694,1222,239,86,1916,221,109
6/22/2020,EHPC,Region,90,196,286,11,19,33,19,825,1713,475,108,2538,371,114
6/23/2020,EHPC,Region,72,198,270,12,25,32,18,556,1826,365,104,2382,363,111
6/24/2020,EHPC,Region,63,185,248,16,30,33,17,775,1776,283,101,2551,403,111
6/25/2020,EHPC,Region,69,183,252,12,31,30,17,876,1684,273,102,2560,399,106
6/26/2020,EHPC,Region,75,173,248,13,26,33,14,747,1841,242,98,2588,391,106
6/27/2020,EHPC,Region,78,164,242,13,30,30,13,911,1560,250,80,2471,304,107
6/28/2020,EHPC,Region,83,165,248,9,33,25,14,885,1601,251,76,2486,306,110
6/29/2020,EHPC,Region,74,184,258,16,31,30,18,983,1682,300,100,2665,510,112
6/30/2020,EHPC,Region,59,186,245,9,23,26,16,888,1729,296,83,2617,382,109
7/1/2020,EHPC,Region,51,220,271,18,31,26,18,525,1995,317,74,2520,375,128
7/2/2020,EHPC,Region,67,211,278,18,31,29,19,867,1936,319,92,2803,400,131
7/3/2020,EHPC,Region,62,190,252,16,40,23,16,883,1703,287,67,2586,363,137
7/4/2020,EHPC,Region,74,169,243,10,18,15,15,848,1669,260,67,2517,287,124
7/5/2020,EHPC,Region,86,179,265,12,24,26,17,1046,1646,298,77,2692,390,127
7/6/2020,EHPC,Region,76,173,249,12,17,25,16,1096,1597,333,74,2693,381,115
7/7/2020,EHPC,Region,72,180,252,19,32,25,17,899,1809,336,82,2708,346,122
7/8/2020,EHPC,Region,65,196,261,21,42,28,17,819,1861,312,101,2680,400,121
7/9/2020,EHPC,Region,61,181,242,16,27,20,16,873,1593,253,82,2466,360,118
7/10/2020,EHPC,Region,63,182,245,13,29,26,16,741,1728,250,81,2469,378,110
7/11/2020,EHPC,Region,65,185,250,21,27,22,16,794,1802,276,79,2596,368,128
7/12/2020,EHPC,Region,66,179,245,14,16,22,14,783,1684,274,72,2467,342,139
7/13/2020,EHPC,Region,55,197,252,20,35,27,17,865,1681,286,101,2546,387,129
7/14/2020,EHPC,Region,54,200,254,15,35,28,17,878,1783,313,109,2661,381,127
7/15/2020,EHPC,Region,55,198,253,19,28,29,17,888,1836,231,107,2724,394,127
7/16/2020,EHPC,Region,68,196,264,21,32,32,18,839,1840,274,123,2679,338,117
7/17/2020,EHPC,Region,59,179,238,20,31,30,15,779,1641,221,110,2420,311,116
7/18/2020,EHPC,Region,76,184,260,7,32,24,16,805,1887,313,88,2692,305,121
7/19/2020,EHPC,Region,75,189,264,16,23,21,16,816,1867,299,76,2683,326,124
7/20/2020,EHPC,Region,76,191,267,27,21,35,18,905,1737,284,121,2642,342,122
7/21/2020,EHPC,Region,73,192,265,16,24,38,18,905,1799,275,118,2704,341,122
7/22/2020,EHPC,Region,71,200,271,16,32,35,18,805,1923,287,119,2728,333,132
7/23/2020,EHPC,Region,62,208,270,9,27,35,18,819,1961,289,120,2780,333,132
7/24/2020,EHPC,Region,57,212,269,18,28,35,18,804,1915,306,119,2719,315,145
7/25/2020,EHPC,Region,58,217,275,17,35,38,17,944,1958,329,119,2902,321,142
7/26/2020,EHPC,Region,49,208,257,14,23,43,17,838,1850,293,111,2688,305,148
7/27/2020,EHPC,Region,64,209,273,19,23,44,19,937,1831,300,136,2768,317,151
7/28/2020,EHPC,Region,74,213,287,20,26,43,19,892,1901,305,146,2793,323,143
7/29/2020,EHPC,Region,64,213,277,17,34,38,17,865,1870,307,118,2735,309,134
7/30/2020,EHPC,Region,78,215,293,18,36,39,19,847,1961,300,147,2808,331,133
7/31/2020,EHPC,Region,61,212,273,19,22,39,18,821,1884,288,131,2705,325,124
8/1/2020,EHPC,Region,67,200,267,19,27,32,16,725,1861,261,126,2586,316,117
8/2/2020,EHPC,Region,68,198,266,15,21,36,15,860,1711,255,133,2571,307,119
8/3/2020,EHPC,Region,67,183,250,18,22,40,16,702,1580,260,140,2282,281,123
8/4/2020,EHPC,Region,92,198,290,26,42,48,19,982,1922,292,164,2904,332,125
8/5/2020,EHPC,Region,80,186,266,13,32,41,16,828,1767,262,150,2595,295,110
8/6/2020,EHPC,Region,77,202,279,19,15,41,18,799,1897,307,144,2696,300,118
8/7/2020,EHPC,Region,83,198,281,22,24,51,16,960,1858,312,152,2818,286,113
8/8/2020,EHPC,Region,79,191,270,25,29,46,16,811,1783,283,158,2594,296,104
8/9/2020,EHPC,Region,72,188,260,11,26,45,15,799,1698,262,156,2497,289,109
8/10/2020,EHPC,Region,76,209,285,15,33,48,18,874,1818,293,160,2692,307,112
8/11/2020,EHPC,Region,79,202,281,31,32,45,18,847,1843,293,148,2690,287,123
8/12/2020,EHPC,Region,75,208,283,23,26,43,18,879,1943,267,156,2822,244,120
8/13/2020,EHPC,Region,65,197,262,21,30,36,16,778,1854,278,149,2632,274,120
8/14/2020,EHPC,Region,66,215,281,20,29,42,19,814,1959,307,166,2773,296,130
8/15/2020,EHPC,Region,81,203,284,26,38,38,17,888,1861,344,136,2749,275,122
8/16/2020,EHPC,Region,82,211,293,23,29,43,18,982,1836,360,137,2818,295,136
8/17/2020,EHPC,Region,85,207,292,23,34,49,19,986,1842,356,146,2828,277,139
8/18/2020,EHPC,Region,85,215,300,28,39,42,19,911,1931,361,137,2842,298,131
8/19/2020,EHPC,Region,78,207,285,33,29,41,18,847,2008,340,142,2855,290,132
8/20/2020,EHPC,Region,86,202,288,32,35,39,18,854,1980,331,146,2834,289,131
8/21/2020,EHPC,Region,89,192,281,36,37,45,18,860,1917,316,145,2777,292,121
4/6/2020,MAHPC,Region,74,82,156,,,,13,561,682,545,7,1243,173,34
4/7/2020,MAHPC,Region,70,84,154,,,,12,546,642,455,9,1188,173,29
4/8/2020,MAHPC,Region,57,75,132,,,,9,422,531,443,7,953,133,29
4/9/2020,MAHPC,Region,59,115,174,,,,16,562,738,572,8,1300,187,33
4/10/2020,MAHPC,Region,65,74,139,,,,10,448,639,466,6,1087,154,29
4/11/2020,MAHPC,Region,65,79,144,,,,10,407,605,443,8,1012,147,36
4/12/2020,MAHPC,Region,61,76,137,,,,8,402,575,414,10,977,142,33
4/13/2020,MAHPC,Region,77,93,170,,,,14,506,635,563,11,1141,179,29
4/14/2020,MAHPC,Region,68,101,169,,,,14,524,697,535,12,1221,173,33
4/15/2020,MAHPC,Region,65,98,163,,,,14,441,693,513,12,1134,167,34
4/16/2020,MAHPC,Region,68,91,159,,,,14,457,683,511,9,1140,165,34
4/17/2020,MAHPC,Region,73,88,161,,,,14,524,656,537,6,1180,167,30
4/18/2020,MAHPC,Region,59,74,133,,,,9,389,642,431,6,1031,149,30
4/19/2020,MAHPC,Region,66,75,141,,,,9,448,601,458,7,1049,145,39
4/20/2020,MAHPC,Region,73,92,165,,,,15,494,727,555,12,1221,172,36
4/21/2020,MAHPC,Region,65,102,167,,,,14,449,738,545,9,1187,167,39
4/22/2020,MAHPC,Region,41,35,76,,,,13,231,315,345,8,546,67,9
4/23/2020,MAHPC,Region,69,92,161,,,,14,294,790,622,13,1084,166,40
4/24/2020,MAHPC,Region,55,82,137,,,,11,245,730,517,9,975,146,39
4/25/2020,MAHPC,Region,54,95,149,,,,10,277,740,509,8,1017,154,31
4/26/2020,MAHPC,Region,61,81,142,,,,10,284,669,457,6,953,153,32
4/27/2020,MAHPC,Region,93,85,178,,,,16,516,758,575,11,1274,171,35
4/28/2020,MAHPC,Region,76,93,169,,,,15,410,778,538,9,1188,172,34
4/29/2020,MAHPC,Region,42,34,76,,,,13,256,316,328,7,572,72,4
4/30/2020,MAHPC,Region,76,83,159,,,,14,465,724,516,6,1189,173,29
5/1/2020,MAHPC,Region,79,82,161,,,,13,404,753,446,8,1157,167,26
5/2/2020,MAHPC,Region,22,28,50,,,,9,201,226,171,6,427,53,2
5/3/2020,MAHPC,Region,65,65,130,,,,8,337,704,340,8,1041,147,24
5/4/2020,MAHPC,Region,82,79,161,,,,14,440,775,472,13,1215,177,27
5/5/2020,MAHPC,Region,77,90,167,,,,15,393,852,534,12,1245,176,29
5/6/2020,MAHPC,Region,72,89,161,,,,14,368,856,500,12,1224,175,29
5/7/2020,MAHPC,Region,32,38,70,,,,12,237,310,305,4,547,69,5
5/8/2020,MAHPC,Region,70,78,148,,,,11,316,822,422,6,1138,157,35
5/9/2020,MAHPC,Region,73,71,144,,,,9,322,766,423,4,1088,158,26
5/10/2020,MAHPC,Region,76,57,133,,,,9,303,679,401,2,982,155,21
5/11/2020,MAHPC,Region,90,73,163,,,,15,441,783,534,3,1224,182,24
5/12/2020,MAHPC,Region,67,76,143,,,,11,257,775,422,2,1032,161,27
5/13/2020,MAHPC,Region,75,76,151,,,,13,299,821,454,3,1120,166,31
5/14/2020,MAHPC,Region,84,79,163,,,,15,553,919,534,5,1472,181,25
5/15/2020,MAHPC,Region,79,84,163,,,,14,318,917,524,3,1235,182,24
5/16/2020,MAHPC,Region,60,74,134,,,,8,177,809,378,4,986,157,19
5/17/2020,MAHPC,Region,62,68,130,,,,8,249,725,351,5,974,154,19
5/18/2020,MAHPC,Region,81,78,159,,,,13,369,825,484,6,1194,180,24
5/19/2020,MAHPC,Region,75,89,164,,,,15,328,922,516,6,1250,182,22
5/20/2020,MAHPC,Region,71,86,157,,,,13,237,933,470,9,1170,184,20
5/21/2020,MAHPC,Region,73,78,151,,,,12,289,897,438,13,1186,170,30
5/22/2020,MAHPC,Region,64,84,148,,,,11,283,854,441,14,1137,166,29
5/23/2020,MAHPC,Region,51,85,136,,,,9,214,788,407,13,1002,148,32
5/24/2020,MAHPC,Region,50,77,127,,,,8,228,730,365,15,958,141,33
5/25/2020,MAHPC,Region,57,70,127,,,,7,264,687,358,12,951,137,34
5/26/2020,MAHPC,Region,68,93,161,,,,13,355,835,478,9,1190,164,40
5/27/2020,MAHPC,Region,66,87,153,,,,12,311,870,456,9,1181,154,41
5/28/2020,MAHPC,Region,71,92,163,,,,14,274,965,514,10,1239,165,41
5/29/2020,MAHPC,Region,60,94,154,,,,11,241,914,482,12,1155,156,42
5/30/2020,MAHPC,Region,42,94,136,,,,7,182,791,372,18,973,138,38
5/31/2020,MAHPC,Region,49,81,130,,,,6,188,738,337,19,926,142,30
6/1/2020,MAHPC,Region,63,86,149,,,,11,357,807,440,18,1164,166,28
6/2/2020,MAHPC,Region,60,97,157,,,,13,341,884,476,20,1225,165,37
6/3/2020,MAHPC,Region,38,99,137,2,51,15,13,275,912,486,21,1187,151,40
6/4/2020,MAHPC,Region,48,100,148,1,40,9,14,297,934,464,22,1231,163,41
6/5/2020,MAHPC,Region,32,100,132,2,56,9,12,225,939,432,26,1164,157,43
6/6/2020,MAHPC,Region,23,89,112,1,31,8,7,187,770,337,20,957,134,41
6/7/2020,MAHPC,Region,28,86,114,4,18,7,9,198,798,372,21,996,140,39
6/8/2020,MAHPC,Region,17,97,114,4,35,9,12,301,829,456,27,1130,150,43
6/9/2020,MAHPC,Region,30,86,116,2,43,10,11,248,816,410,25,1064,142,42
6/10/2020,MAHPC,Region,23,93,116,0,48,10,10,190,849,399,26,1039,140,42
6/11/2020,MAHPC,Region,22,90,112,0,45,10,10,177,863,390,24,1040,147,36
6/12/2020,MAHPC,Region,24,85,109,2,33,10,9,199,812,390,26,1011,149,34
6/13/2020,MAHPC,Region,30,84,114,0,46,11,10,222,733,384,24,955,143,35
6/14/2020,MAHPC,Region,39,58,97,1,18,9,7,230,629,324,21,859,133,34
6/15/2020,MAHPC,Region,47,77,124,4,32,11,12,353,747,419,24,1100,150,41
6/16/2020,MAHPC,Region,36,84,120,2,46,9,11,327,744,434,22,1071,141,45
6/17/2020,MAHPC,Region,23,37,60,1,3,4,12,168,300,256,6,468,58,7
6/18/2020,MAHPC,Region,32,96,128,1,35,11,13,226,917,456,24,1143,150,43
6/19/2020,MAHPC,Region,42,91,133,2,53,7,12,282,885,446,24,1167,160,36
6/20/2020,MAHPC,Region,26,87,113,0,33,11,8,173,806,335,23,979,132,44
6/21/2020,MAHPC,Region,28,79,107,2,23,10,6,220,711,297,24,931,124,47
6/22/2020,MAHPC,Region,47,91,138,1,46,9,13,292,936,472,29,1228,163,41
6/23/2020,MAHPC,Region,40,99,139,0,49,11,12,239,948,450,25,1187,146,49
6/24/2020,MAHPC,Region,65,96,161,1,51,10,13,480,795,167,22,1275,113,49
6/25/2020,MAHPC,Region,69,103,172,3,48,10,14,470,894,189,26,1364,131,46
6/26/2020,MAHPC,Region,71,107,178,5,42,9,16,502,898,213,24,1400,141,37
6/27/2020,MAHPC,Region,70,79,149,1,48,8,11,476,674,83,24,1150,117,34
6/28/2020,MAHPC,Region,66,83,149,2,36,7,11,469,678,81,22,1147,114,37
6/29/2020,MAHPC,Region,81,95,176,0,41,9,16,538,855,216,25,1393,133,46
6/30/2020,MAHPC,Region,64,108,172,7,62,7,16,486,907,215,27,1393,137,42
7/1/2020,MAHPC,Region,68,110,178,4,45,8,16,496,905,213,25,1401,137,42
7/2/2020,MAHPC,Region,66,86,152,0,41,8,12,418,716,131,23,1134,114,40
7/3/2020,MAHPC,Region,63,98,161,2,43,7,13,500,768,159,25,1268,127,35
7/4/2020,MAHPC,Region,67,82,149,3,52,8,11,477,663,81,25,1140,119,32
7/5/2020,MAHPC,Region,57,80,137,3,30,7,10,450,595,67,24,1045,110,32
7/6/2020,MAHPC,Region,78,98,176,2,32,9,16,550,851,215,34,1401,138,41
7/7/2020,MAHPC,Region,60,110,170,2,42,11,15,487,858,193,31,1345,124,46
7/8/2020,MAHPC,Region,55,103,158,6,57,14,14,462,788,177,35,1250,120,41
7/9/2020,MAHPC,Region,68,104,172,11,53,15,15,460,824,171,36,1284,129,43
7/10/2020,MAHPC,Region,69,92,161,2,43,12,12,478,782,165,34,1260,120,42
7/11/2020,MAHPC,Region,53,96,149,1,36,15,10,456,681,81,30,1137,110,41
7/12/2020,MAHPC,Region,57,92,149,2,27,14,10,454,678,81,28,1132,103,48
7/13/2020,MAHPC,Region,64,108,172,5,45,19,14,531,839,173,44,1370,126,49
7/14/2020,MAHPC,Region,55,115,170,4,45,18,14,523,819,191,36,1342,120,50
7/15/2020,MAHPC,Region,69,101,170,8,53,16,15,536,809,193,40,1345,131,39
7/16/2020,MAHPC,Region,68,93,161,6,54,13,13,503,775,167,37,1278,117,43
7/17/2020,MAHPC,Region,59,102,161,4,55,15,13,493,780,167,41,1273,115,47
7/18/2020,MAHPC,Region,55,94,149,6,62,13,11,428,717,83,41,1145,111,40
7/19/2020,MAHPC,Region,63,92,155,2,38,11,11,523,712,125,41,1235,119,39
7/20/2020,MAHPC,Region,72,104,176,3,43,11,15,523,853,215,41,1376,132,47
7/21/2020,MAHPC,Region,73,86,159,10,43,12,12,457,762,175,38,1219,113,48
7/22/2020,MAHPC,Region,71,100,171,5,51,14,14,502,835,191,38,1337,128,42
7/23/2020,MAHPC,Region,68,103,171,7,68,15,14,502,835,191,44,1337,135,35
7/24/2020,MAHPC,Region,67,104,171,9,56,12,15,552,793,193,45,1345,128,42
7/25/2020,MAHPC,Region,53,91,144,5,33,12,9,452,650,57,41,1102,109,40
7/26/2020,MAHPC,Region,59,88,147,8,37,14,11,477,658,83,50,1135,118,33
7/27/2020,MAHPC,Region,73,104,177,5,41,19,16,490,839,215,60,1329,136,46
7/28/2020,MAHPC,Region,67,95,162,7,48,17,12,440,825,165,52,1265,126,39
7/29/2020,MAHPC,Region,72,99,171,8,49,18,14,443,894,191,55,1337,134,39
7/30/2020,MAHPC,Region,65,106,171,6,46,20,14,470,862,191,55,1332,133,40
7/31/2020,MAHPC,Region,70,99,169,13,45,20,15,504,841,198,59,1345,135,39
8/1/2020,MAHPC,Region,72,76,148,8,57,12,10,449,678,81,52,1127,125,30
8/2/2020,MAHPC,Region,65,83,148,1,42,12,10,449,678,81,51,1127,128,27
8/3/2020,MAHPC,Region,68,101,169,7,47,20,15,524,816,210,56,1340,139,35
8/4/2020,MAHPC,Region,66,97,163,2,61,19,14,486,834,153,53,1320,126,44
8/5/2020,MAHPC,Region,69,94,163,12,53,20,14,489,826,189,63,1315,131,41
8/6/2020,MAHPC,Region,66,103,169,8,52,21,15,500,840,215,63,1340,126,47
8/7/2020,MAHPC,Region,63,85,148,1,40,17,10,465,750,101,52,1215,117,43
8/8/2020,MAHPC,Region,64,90,154,3,44,12,11,440,702,138,43,1142,120,39
8/9/2020,MAHPC,Region,64,84,148,1,38,10,9,446,663,81,42,1109,118,37
8/10/2020,MAHPC,Region,74,95,169,5,29,13,14,529,797,191,51,1326,128,44
8/11/2020,MAHPC,Region,72,97,169,7,51,12,14,492,840,191,52,1332,128,44
8/12/2020,MAHPC,Region,57,97,154,10,63,14,11,446,794,141,51,1240,121,43
8/13/2020,MAHPC,Region,69,106,175,5,47,17,15,464,881,191,58,1345,134,40
8/14/2020,MAHPC,Region,75,94,169,5,46,17,15,480,865,196,59,1345,136,38
8/15/2020,MAHPC,Region,70,78,148,2,45,8,11,392,753,68,41,1145,116,37
8/16/2020,MAHPC,Region,65,83,148,3,33,9,10,411,716,81,45,1127,116,37
8/17/2020,MAHPC,Region,60,109,169,2,43,11,14,459,863,202,53,1322,137,37
8/18/2020,MAHPC,Region,66,103,169,10,44,12,14,421,906,191,54,1327,135,37
8/19/2020,MAHPC,Region,74,89,163,8,46,10,14,451,859,171,52,1310,125,47
8/20/2020,MAHPC,Region,58,105,163,4,51,9,13,426,881,162,51,1307,127,45
8/21/2020,MAHPC,Region,68,101,169,5,58,11,15,463,886,198,53,1349,131,43
4/6/2020,MCRHC,Region,138,193,331,,,,10,1031,1666,826,34,2697,309,98
4/7/2020,MCRHC,Region,121,207,328,,,,10,1092,1685,837,37,2777,316,108
4/8/2020,MCRHC,Region,116,200,316,,,,9,887,1650,781,40,2537,309,105
4/9/2020,MCRHC,Region,135,194,329,,,,10,864,1727,829,42,2591,312,109
4/10/2020,MCRHC,Region,123,206,329,,,,10,824,1746,829,49,2570,322,99
4/11/2020,MCRHC,Region,123,206,329,,,,10,911,1673,831,46,2584,309,108
4/12/2020,MCRHC,Region,130,152,282,,,,7,875,1216,636,33,2091,241,85
4/13/2020,MCRHC,Region,59,270,329,,,,10,1027,1628,829,51,2655,303,114
4/14/2020,MCRHC,Region,116,178,294,,,,7,805,1336,641,40,2141,250,82
4/15/2020,MCRHC,Region,119,222,341,,,,10,765,1832,844,56,2597,306,115
4/16/2020,MCRHC,Region,164,181,345,,,,10,691,1563,804,49,2254,265,107
4/17/2020,MCRHC,Region,92,214,306,,,,10,732,1814,837,45,2546,314,104
4/18/2020,MCRHC,Region,113,206,319,,,,10,756,1790,842,55,2546,323,92
4/19/2020,MCRHC,Region,120,162,282,,,,7,837,1299,641,31,2136,268,60
4/20/2020,MCRHC,Region,126,203,329,,,,10,849,1760,844,56,2609,309,110
4/21/2020,MCRHC,Region,131,198,329,,,,10,1032,1783,837,56,2815,338,90
4/22/2020,MCRHC,Region,117,212,329,,,,10,996,1811,837,74,2807,327,95
4/23/2020,MCRHC,Region,120,235,355,,,,10,1013,1864,805,62,2877,323,100
4/24/2020,MCRHC,Region,140,219,359,,,,10,868,1922,827,66,2790,331,92
4/25/2020,MCRHC,Region,160,199,359,,,,10,757,1941,827,71,2698,331,92
4/26/2020,MCRHC,Region,145,214,359,,,,9,906,1845,807,70,2751,302,99
4/27/2020,MCRHC,Region,138,221,359,,,,10,878,1868,827,75,2746,314,107
4/28/2020,MCRHC,Region,129,230,359,,,,10,775,1971,827,84,2746,316,107
4/29/2020,MCRHC,Region,140,219,359,,,,10,750,2033,827,84,2783,306,101
4/30/2020,MCRHC,Region,133,226,359,,,,10,800,1990,827,94,2790,368,39
5/1/2020,MCRHC,Region,136,223,359,,,,10,805,1985,827,99,2790,314,104
5/2/2020,MCRHC,Region,98,184,282,,,,7,614,1516,635,77,2130,252,82
5/3/2020,MCRHC,Region,134,187,321,,,,9,713,1697,794,80,2410,316,80
5/4/2020,MCRHC,Region,142,217,359,,,,10,781,1981,827,86,2762,343,82
5/5/2020,MCRHC,Region,136,223,359,,,,10,693,2070,827,72,2763,334,91
5/6/2020,MCRHC,Region,113,246,359,,,,10,770,1993,827,80,2763,324,101
5/7/2020,MCRHC,Region,124,235,359,,,,10,661,2102,823,88,2763,321,98
5/8/2020,MCRHC,Region,122,237,359,,,,10,667,2123,807,86,2790,330,95
5/9/2020,MCRHC,Region,74,208,282,,,,7,586,1573,614,68,2159,254,80
5/10/2020,MCRHC,Region,117,242,359,,,,10,727,2063,805,79,2790,333,92
5/11/2020,MCRHC,Region,81,189,270,,,,7,486,1498,569,61,1984,251,77
5/12/2020,MCRHC,Region,125,234,359,,,,10,650,2135,792,85,2785,331,94
5/13/2020,MCRHC,Region,115,244,359,,,,10,663,2086,792,87,2749,326,98
5/14/2020,MCRHC,Region,109,250,359,,,,10,649,2108,787,76,2757,331,94
5/15/2020,MCRHC,Region,117,230,347,,,,10,539,2095,752,75,2634,325,94
5/16/2020,MCRHC,Region,120,229,349,,,,10,585,2043,752,71,2628,322,97
5/17/2020,MCRHC,Region,134,225,359,,,,10,690,1992,792,76,2682,319,105
5/18/2020,MCRHC,Region,131,228,359,,,,10,731,2042,792,84,2773,322,103
5/19/2020,MCRHC,Region,111,210,321,,,,10,487,1947,792,70,2434,287,109
5/20/2020,MCRHC,Region,117,242,359,,,,10,389,2276,792,86,2665,319,100
5/21/2020,MCRHC,Region,115,244,359,,,,10,425,2240,792,89,2665,330,95
5/22/2020,MCRHC,Region,111,210,321,,,,10,397,1925,792,67,2322,311,85
5/23/2020,MCRHC,Region,115,244,359,,,,10,495,2201,796,80,2696,323,103
5/24/2020,MCRHC,Region,130,229,359,,,,9,591,2092,772,75,2683,320,103
5/25/2020,MCRHC,Region,144,215,359,,,,10,633,2061,792,67,2694,320,96
5/26/2020,MCRHC,Region,146,211,357,,,,10,586,2105,792,77,2691,324,101
5/27/2020,MCRHC,Region,126,233,359,,,,10,409,2365,792,75,2774,314,111
5/28/2020,MCRHC,Region,104,255,359,,,,10,372,2394,792,69,2766,315,109
5/29/2020,MCRHC,Region,103,253,356,,,,9,352,2381,772,76,2733,307,116
5/30/2020,MCRHC,Region,74,273,347,,,,10,363,2324,752,84,2687,303,114
5/31/2020,MCRHC,Region,53,225,278,,,,6,381,1713,584,62,2094,233,95
6/1/2020,MCRHC,Region,98,261,359,,,,10,438,2307,792,90,2745,312,113
6/2/2020,MCRHC,Region,87,272,359,,,,10,355,2419,792,85,2774,290,135
6/3/2020,MCRHC,Region,82,239,321,0,46,22,10,223,2211,792,61,2434,268,118
6/4/2020,MCRHC,Region,83,238,321,4,14,17,10,234,2200,792,62,2434,283,113
6/5/2020,MCRHC,Region,88,259,347,3,32,25,10,192,2515,752,72,2707,289,127
6/6/2020,MCRHC,Region,88,259,347,5,23,30,10,318,2389,755,83,2707,283,133
6/7/2020,MCRHC,Region,62,182,244,6,4,23,6,313,1449,580,50,1762,210,93
6/8/2020,MCRHC,Region,112,227,339,9,30,33,9,435,2178,745,89,2613,257,124
6/9/2020,MCRHC,Region,94,245,339,9,14,37,9,241,2298,792,99,2539,273,127
6/10/2020,MCRHC,Region,87,270,357,4,54,43,10,252,2517,792,96,2769,280,142
6/11/2020,MCRHC,Region,63,231,294,4,64,37,9,264,1981,616,76,2245,242,128
6/12/2020,MCRHC,Region,81,228,309,2,49,30,9,225,2141,732,74,2366,255,133
6/13/2020,MCRHC,Region,77,262,339,9,8,46,9,248,2290,795,96,2538,257,143
6/14/2020,MCRHC,Region,60,218,278,6,21,44,6,395,1722,584,85,2117,213,112
6/15/2020,MCRHC,Region,95,248,343,4,22,44,10,442,2228,752,100,2670,284,132
6/16/2020,MCRHC,Region,93,254,347,3,45,42,9,321,2357,736,95,2678,277,135
6/17/2020,MCRHC,Region,96,259,355,6,58,45,10,298,2440,792,98,2738,300,122
6/18/2020,MCRHC,Region,95,262,357,8,73,45,10,288,2450,792,95,2738,288,122
6/19/2020,MCRHC,Region,87,222,309,7,50,35,9,228,2142,752,80,2370,266,111
6/20/2020,MCRHC,Region,88,267,355,7,45,47,10,302,2466,792,103,2768,296,114
6/21/2020,MCRHC,Region,111,246,357,5,40,42,9,390,2366,772,103,2756,300,108
6/22/2020,MCRHC,Region,100,257,357,15,60,42,10,370,2365,792,105,2735,298,112
6/23/2020,MCRHC,Region,79,270,349,9,47,39,9,243,2459,736,105,2702,284,116
6/24/2020,MCRHC,Region,105,361,466,12,254,39,10,436,2113,327,107,2549,485,107
6/25/2020,MCRHC,Region,123,343,466,12,93,39,10,470,2078,328,106,2548,492,101
6/26/2020,MCRHC,Region,136,330,466,8,85,34,10,530,2023,328,111,2553,485,108
6/27/2020,MCRHC,Region,105,349,454,6,96,39,10,483,2013,289,118,2496,487,100
6/28/2020,MCRHC,Region,84,305,389,8,60,34,7,467,1456,136,86,1923,408,88
6/29/2020,MCRHC,Region,90,311,401,7,84,35,9,487,1542,152,85,2029,445,96
6/30/2020,MCRHC,Region,70,394,464,11,109,40,10,459,2105,338,110,2564,472,121
7/1/2020,MCRHC,Region,105,359,464,6,132,41,10,475,2087,340,110,2562,481,112
7/2/2020,MCRHC,Region,112,354,466,10,98,38,9,510,2036,290,121,2546,474,117
7/3/2020,MCRHC,Region,119,335,454,17,130,37,10,533,1967,303,119,2500,465,122
7/4/2020,MCRHC,Region,117,347,464,13,99,40,9,571,1967,290,123,2538,456,135
7/5/2020,MCRHC,Region,124,338,462,14,90,42,10,601,1950,343,132,2551,470,123
7/6/2020,MCRHC,Region,96,366,462,9,143,41,10,679,1956,292,124,2635,462,131
7/7/2020,MCRHC,Region,86,374,460,11,136,42,10,585,2069,292,123,2654,457,136
7/8/2020,MCRHC,Region,91,369,460,9,122,49,10,553,2081,287,123,2634,471,122
7/9/2020,MCRHC,Region,88,366,454,10,120,46,9,592,1986,230,119,2578,457,126
7/10/2020,MCRHC,Region,76,366,442,11,111,47,9,571,1956,192,133,2527,442,136
7/11/2020,MCRHC,Region,83,379,462,17,108,53,10,626,2048,286,144,2674,458,136
7/12/2020,MCRHC,Region,84,378,462,6,16,56,10,655,1982,280,147,2637,458,136
7/13/2020,MCRHC,Region,91,371,462,8,77,52,10,672,2032,288,130,2704,452,142
7/14/2020,MCRHC,Region,95,359,454,12,102,57,9,614,2018,232,134,2632,449,135
7/15/2020,MCRHC,Region,85,377,462,20,131,57,10,645,2056,288,132,2701,458,135
7/16/2020,MCRHC,Region,83,371,454,10,104,54,10,571,2095,264,139,2666,450,137
7/17/2020,MCRHC,Region,84,367,451,15,91,52,10,524,2122,261,136,2646,468,119
7/18/2020,MCRHC,Region,127,335,462,11,116,45,10,679,2020,302,129,2699,473,120
7/19/2020,MCRHC,Region,108,350,458,10,83,43,10,700,1995,304,123,2695,470,123
7/20/2020,MCRHC,Region,110,350,460,11,88,41,10,695,2013,304,131,2708,471,123
7/21/2020,MCRHC,Region,100,360,460,15,106,44,10,639,2075,325,134,2714,459,135
7/22/2020,MCRHC,Region,92,368,460,16,113,48,10,636,2079,324,150,2715,462,132
7/23/2020,MCRHC,Region,102,359,461,17,116,48,10,613,2109,324,146,2722,467,127
7/24/2020,MCRHC,Region,106,354,460,14,97,51,10,577,2126,324,137,2703,455,139
7/25/2020,MCRHC,Region,101,361,462,42,74,50,10,645,2053,327,149,2698,463,131
7/26/2020,MCRHC,Region,115,345,460,12,98,42,10,725,1970,322,137,2695,458,136
7/27/2020,MCRHC,Region,90,368,458,11,79,37,10,657,2012,322,147,2669,469,125
7/28/2020,MCRHC,Region,98,360,458,15,113,40,10,640,2067,324,157,2707,466,128
7/29/2020,MCRHC,Region,88,370,458,19,121,44,10,560,2137,323,157,2697,476,118
7/30/2020,MCRHC,Region,95,364,459,19,120,48,10,588,2115,324,156,2703,473,121
7/31/2020,MCRHC,Region,91,369,460,9,125,50,10,632,2074,322,153,2706,471,122
8/1/2020,MCRHC,Region,89,363,452,15,115,47,10,631,2058,323,163,2689,473,121
8/2/2020,MCRHC,Region,81,371,452,16,88,43,10,636,2036,340,155,2672,476,118
8/3/2020,MCRHC,Region,84,364,448,6,103,41,10,617,2061,339,164,2678,477,117
8/4/2020,MCRHC,Region,81,370,451,12,108,41,10,621,2073,339,147,2694,456,138
8/5/2020,MCRHC,Region,91,361,452,12,105,40,10,580,2110,338,146,2690,462,132
8/6/2020,MCRHC,Region,87,357,444,12,107,38,9,561,2072,283,132,2633,458,126
8/7/2020,MCRHC,Region,103,351,454,11,107,41,10,664,2015,291,140,2679,462,132
8/8/2020,MCRHC,Region,110,337,447,14,124,39,9,683,1935,235,137,2618,455,129
8/9/2020,MCRHC,Region,107,339,446,4,105,41,9,701,1917,236,145,2618,458,126
8/10/2020,MCRHC,Region,82,371,453,9,79,38,10,627,2040,235,137,2667,478,116
8/11/2020,MCRHC,Region,95,359,454,11,120,35,10,574,2059,290,136,2633,474,120
8/12/2020,MCRHC,Region,84,374,458,5,117,34,10,582,2097,290,136,2679,473,121
8/13/2020,MCRHC,Region,78,368,446,12,110,38,9,526,2092,236,137,2618,460,124
8/14/2020,MCRHC,Region,95,351,446,8,94,36,9,590,2025,236,128,2615,475,109
8/15/2020,MCRHC,Region,87,367,454,13,117,35,10,618,2051,292,118,2669,474,120
8/16/2020,MCRHC,Region,105,344,449,10,92,34,10,659,1982,291,124,2641,470,124
8/17/2020,MCRHC,Region,92,361,453,10,98,32,10,710,1969,291,130,2679,470,124
8/18/2020,MCRHC,Region,84,359,443,16,107,37,9,619,1999,234,136,2618,464,120
8/19/2020,MCRHC,Region,71,380,451,9,104,37,10,561,2103,290,133,2664,474,120
8/20/2020,MCRHC,Region,86,366,452,13,91,38,10,588,2077,299,132,2665,475,119
8/21/2020,MCRHC,Region,90,362,452,5,110,38,10,625,2042,316,127,2667,482,112
4/6/2020,MHPC,Region,253,317,570,,,,14,1957,2039,1411,128,3996,524,135
4/7/2020,MHPC,Region,207,370,577,,,,15,1766,2189,1377,135,3955,357,130
4/8/2020,MHPC,Region,148,258,406,,,,15,1696,2303,1562,121,3999,451,131
4/9/2020,MHPC,Region,231,338,569,,,,14,1618,2270,1450,132,3888,438,135
4/10/2020,MHPC,Region,243,332,575,,,,15,1603,2377,1495,128,3980,458,125
4/11/2020,MHPC,Region,275,316,591,,,,16,1911,2186,1540,117,4097,472,128
4/12/2020,MHPC,Region,219,317,536,,,,14,1471,1810,1428,81,3281,331,121
4/13/2020,MHPC,Region,254,337,591,,,,16,1833,2221,1330,121,4054,377,129
4/14/2020,MHPC,Region,220,371,591,,,,16,1699,2411,1731,123,4110,482,128
4/15/2020,MHPC,Region,240,343,583,,,,15,1474,2400,1622,116,3874,482,126
4/16/2020,MHPC,Region,228,351,579,,,,15,1473,2450,1625,113,3923,486,131
4/17/2020,MHPC,Region,200,379,579,,,,15,1430,2459,1632,105,3889,466,142
4/18/2020,MHPC,Region,214,369,583,,,,15,1551,2416,1665,125,3967,574,146
4/19/2020,MHPC,Region,248,339,587,,,,16,1674,2393,1746,111,4067,603,148
4/20/2020,MHPC,Region,241,350,591,,,,16,1536,2471,1749,127,4007,477,139
4/21/2020,MHPC,Region,224,359,583,,,,15,1485,2491,1735,125,3976,544,138
4/22/2020,MHPC,Region,236,347,583,,,,15,1452,2508,1649,124,3960,478,131
4/23/2020,MHPC,Region,184,278,462,,,,15,1414,2625,1770,133,4039,598,127
4/24/2020,MHPC,Region,221,364,585,,,,16,1501,2593,1754,129,4094,465,141
4/25/2020,MHPC,Region,198,379,577,,,,15,1471,2533,1622,128,4004,501,132
4/26/2020,MHPC,Region,222,343,565,,,,14,1374,2484,1538,123,3858,469,135
4/27/2020,MHPC,Region,144,228,372,,,,15,1323,2072,1623,99,3395,373,111
4/28/2020,MHPC,Region,167,282,449,,,,16,1424,2633,1890,132,4057,492,159
4/29/2020,MHPC,Region,170,255,425,,,,15,1485,2575,1955,128,4060,515,159
4/30/2020,MHPC,Region,189,260,449,,,,16,1419,2693,2037,127,4112,558,157
5/1/2020,MHPC,Region,232,355,587,,,,16,1430,2682,2035,126,4112,580,167
5/2/2020,MHPC,Region,215,372,587,,,,16,1493,2582,1982,118,4075,594,152
5/3/2020,MHPC,Region,221,366,587,,,,16,1389,2544,1984,115,3933,582,165
5/4/2020,MHPC,Region,223,364,587,,,,16,1496,2598,2035,113,4094,580,168
5/5/2020,MHPC,Region,145,304,449,,,,16,1295,2847,2031,110,4142,600,160
5/6/2020,MHPC,Region,122,303,425,,,,16,1250,2892,2030,107,4142,722,163
5/7/2020,MHPC,Region,147,302,449,,,,16,1206,2700,1911,112,3906,612,118
5/8/2020,MHPC,Region,117,423,540,,,,16,1226,2916,2020,93,4142,755,130
5/9/2020,MHPC,Region,138,404,542,,,,15,1366,2729,1938,87,4095,748,125
5/10/2020,MHPC,Region,164,393,557,,,,15,1456,2591,1927,85,4047,739,133
5/11/2020,MHPC,Region,143,424,567,,,,16,1344,2750,2035,87,4094,702,183
5/12/2020,MHPC,Region,85,344,429,,,,16,1255,2888,1976,86,4143,571,191
5/13/2020,MHPC,Region,140,290,430,,,,16,1173,2922,1973,87,4095,566,175
5/14/2020,MHPC,Region,134,295,429,,,,16,1112,2985,1835,82,4097,582,189
5/15/2020,MHPC,Region,124,416,540,,,,16,1031,3065,1837,74,4096,585,172
5/16/2020,MHPC,Region,128,413,541,,,,16,1248,2921,1885,77,4169,578,182
5/17/2020,MHPC,Region,194,374,568,,,,16,1330,2791,1929,90,4121,562,190
5/18/2020,MHPC,Region,166,402,568,,,,16,1240,2854,1974,93,4094,587,170
5/19/2020,MHPC,Region,106,343,449,,,,16,1016,3080,1964,95,4096,579,187
5/20/2020,MHPC,Region,98,351,449,,,,16,927,3170,1939,94,4097,567,193
5/21/2020,MHPC,Region,100,335,435,,,,15,948,3006,1893,87,3954,549,197
5/22/2020,MHPC,Region,102,458,560,,,,16,890,3206,2019,95,4096,561,200
5/23/2020,MHPC,Region,95,446,541,,,,16,1053,3106,1991,85,4159,555,209
5/24/2020,MHPC,Region,120,467,587,,,,16,1092,2971,1420,111,4063,510,207
5/25/2020,MHPC,Region,90,470,560,,,,16,1170,2957,1409,121,4127,513,205
5/26/2020,MHPC,Region,110,320,430,,,,16,1133,3005,2027,136,4138,565,204
5/27/2020,MHPC,Region,97,333,430,,,,16,1040,3118,2024,133,4158,552,221
5/28/2020,MHPC,Region,56,344,400,,,,16,907,3251,2017,138,4158,554,213
5/29/2020,MHPC,Region,59,480,539,,,,16,900,3258,1830,131,4158,588,174
5/30/2020,MHPC,Region,67,462,529,,,,15,911,3158,1924,135,4069,640,194
5/31/2020,MHPC,Region,122,434,556,,,,15,1069,2952,1922,135,4021,569,200
6/1/2020,MHPC,Region,126,442,568,,,,16,1057,3037,1884,141,4094,601,205
6/2/2020,MHPC,Region,47,513,560,,,,16,837,3305,1832,143,4142,638,222
6/3/2020,MHPC,Region,62,387,449,42,100,61,16,803,3339,1773,142,4142,501,218
6/4/2020,MHPC,Region,59,391,450,11,152,57,16,731,3411,1776,152,4142,503,236
6/5/2020,MHPC,Region,42,408,450,18,138,60,16,646,3496,1778,144,4142,508,228
6/6/2020,MHPC,Region,40,406,446,17,115,61,16,927,3152,1730,156,4079,517,220
6/7/2020,MHPC,Region,62,520,582,17,115,53,16,1009,3019,1732,165,4028,529,206
6/8/2020,MHPC,Region,76,360,436,11,82,56,15,1028,2864,1709,163,3892,544,176
6/9/2020,MHPC,Region,5,425,430,65,122,63,16,814,3240,1763,171,4054,504,231
6/10/2020,MHPC,Region,56,374,430,11,84,63,16,778,3319,1768,169,4097,499,225
6/11/2020,MHPC,Region,61,369,430,20,96,61,16,702,3392,1771,178,4094,499,226
6/12/2020,MHPC,Region,59,383,442,20,126,64,16,735,3335,1777,190,4070,456,280
6/13/2020,MHPC,Region,83,335,418,18,77,62,15,831,3146,1722,197,3977,489,227
6/14/2020,MHPC,Region,107,461,568,16,66,58,16,1085,3003,1783,214,4088,501,230
6/15/2020,MHPC,Region,103,458,561,7,106,53,16,879,2899,1716,192,3778,484,205
6/16/2020,MHPC,Region,77,372,449,21,153,53,16,818,3244,1821,197,4062,506,230
6/17/2020,MHPC,Region,88,361,449,14,72,58,16,792,3288,1812,211,4080,555,190
6/18/2020,MHPC,Region,61,388,449,24,119,67,16,821,3247,1714,202,4068,625,231
6/19/2020,MHPC,Region,82,391,473,15,106,79,16,733,3329,1829,211,4062,522,232
6/20/2020,MHPC,Region,82,370,452,16,116,73,15,804,3060,1771,205,3864,530,203
6/21/2020,MHPC,Region,88,499,587,10,109,62,16,983,3027,1838,222,4010,524,206
6/22/2020,MHPC,Region,93,494,587,18,82,63,16,1017,3056,1996,221,4073,505,237
6/23/2020,MHPC,Region,109,352,461,20,115,57,16,772,3298,1831,220,4070,547,210
6/24/2020,MHPC,Region,99,362,461,18,89,64,16,654,3417,1764,224,4071,512,210
6/25/2020,MHPC,Region,78,383,461,19,90,49,16,686,3376,1766,226,4062,541,208
6/26/2020,MHPC,Region,78,381,459,26,94,57,16,618,3449,1761,235,4067,540,201
6/27/2020,MHPC,Region,88,361,449,31,93,48,15,785,3187,1718,243,3972,523,205
6/28/2020,MHPC,Region,103,461,564,27,92,62,16,1128,2946,1778,240,4074,546,197
6/29/2020,MHPC,Region,127,460,587,25,104,62,16,1019,2980,1728,245,3999,558,196
6/30/2020,MHPC,Region,76,366,442,23,144,60,16,809,3264,1768,235,4073,530,162
7/1/2020,MHPC,Region,61,378,439,28,101,62,16,643,3413,1775,258,4056,548,211
7/2/2020,MHPC,Region,43,399,442,39,99,65,16,654,3419,1863,279,4073,569,177
7/3/2020,MHPC,Region,55,386,441,28,91,71,16,725,3344,1795,286,4069,563,183
7/4/2020,MHPC,Region,81,337,418,33,100,64,16,1057,3035,1793,285,4092,556,186
7/5/2020,MHPC,Region,125,443,568,27,64,64,16,1003,3030,1794,280,4033,525,223
7/6/2020,MHPC,Region,55,342,397,21,91,57,16,966,3077,1781,280,4043,518,225
7/7/2020,MHPC,Region,42,355,397,30,117,65,16,704,3366,1775,265,4070,521,226
7/8/2020,MHPC,Region,56,341,397,35,178,75,16,591,3466,1834,279,4057,530,227
7/9/2020,MHPC,Region,67,330,397,41,128,69,16,628,3423,1791,309,4051,549,210
7/10/2020,MHPC,Region,58,331,389,39,106,66,16,613,3431,1767,321,4044,548,209
7/11/2020,MHPC,Region,51,326,377,20,80,75,16,644,3198,1626,300,3842,524,201
7/12/2020,MHPC,Region,76,301,377,26,113,71,16,780,3020,1596,301,3800,532,193
7/13/2020,MHPC,Region,75,341,416,23,119,76,16,945,3063,1688,305,4008,548,216
7/14/2020,MHPC,Region,54,362,416,37,135,67,16,689,3368,1733,316,4057,547,218
7/15/2020,MHPC,Region,45,373,418,41,114,68,16,623,3441,1731,312,4064,549,220
7/16/2020,MHPC,Region,45,371,416,36,106,72,15,612,3400,1714,332,4012,546,214
7/17/2020,MHPC,Region,47,369,416,43,82,79,16,600,3482,1673,328,4082,548,219
7/18/2020,MHPC,Region,48,358,406,32,105,78,14,728,3193,1622,314,3921,516,212
7/19/2020,MHPC,Region,76,330,406,23,105,84,15,783,3182,1646,317,3965,513,237
7/20/2020,MHPC,Region,38,348,386,28,85,87,15,831,3172,1647,333,4003,519,234
7/21/2020,MHPC,Region,43,346,389,25,102,92,16,648,3394,1666,325,4042,540,230
7/22/2020,MHPC,Region,40,357,397,36,83,88,16,515,3529,1728,329,4044,527,228
7/23/2020,MHPC,Region,74,333,407,46,102,85,15,1023,3082,661,301,4105,575,204
7/24/2020,MHPC,Region,76,331,407,35,140,88,15,1009,3092,667,308,4101,565,216
7/25/2020,MHPC,Region,76,327,403,30,104,88,15,1161,2859,663,315,4020,562,215
7/26/2020,MHPC,Region,96,311,407,32,83,91,15,1228,2875,681,341,4103,557,216
7/27/2020,MHPC,Region,83,324,407,34,69,94,15,1179,2926,677,349,4105,550,223
7/28/2020,MHPC,Region,75,333,408,37,156,90,15,960,3147,664,349,4107,548,223
7/29/2020,MHPC,Region,69,338,407,40,156,93,15,779,3323,662,347,4102,558,214
7/30/2020,MHPC,Region,64,343,407,25,111,93,15,857,3245,672,315,4102,547,225
7/31/2020,MHPC,Region,82,325,407,30,121,92,15,1016,3090,664,302,4106,556,215
8/1/2020,MHPC,Region,72,323,395,29,158,95,14,1108,2901,626,302,4009,536,217
8/2/2020,MHPC,Region,86,321,407,25,133,100,15,1267,2845,677,312,4112,550,220
8/3/2020,MHPC,Region,65,345,410,24,149,93,15,1008,3106,673,330,4114,570,201
8/4/2020,MHPC,Region,75,332,407,37,136,91,15,1006,3097,677,315,4103,571,205
8/5/2020,MHPC,Region,88,325,413,28,104,83,15,996,3112,662,313,4108,566,208
8/6/2020,MHPC,Region,87,320,407,35,134,94,15,1012,3103,679,310,4115,552,222
8/7/2020,MHPC,Region,88,319,407,26,116,84,15,1010,3114,665,313,4124,554,219
8/8/2020,MHPC,Region,114,293,407,28,139,77,15,1195,2928,675,300,4123,551,218
8/9/2020,MHPC,Region,105,290,395,19,135,77,14,1205,2814,614,300,4019,556,196
8/10/2020,MHPC,Region,96,311,407,19,125,79,15,1208,2906,684,287,4114,556,214
8/11/2020,MHPC,Region,75,332,407,38,177,80,15,897,3222,694,295,4119,548,227
8/12/2020,MHPC,Region,102,324,426,22,112,89,16,1067,3139,740,286,4206,565,219
8/13/2020,MHPC,Region,82,344,426,32,111,81,16,956,3256,739,286,4212,569,213
8/14/2020,MHPC,Region,94,343,437,25,105,84,16,1119,3128,732,263,4247,567,215
8/15/2020,MHPC,Region,109,328,437,21,103,78,16,1303,2936,729,261,4239,575,208
8/16/2020,MHPC,Region,103,307,410,26,69,77,15,1179,2610,748,273,3789,552,194
8/17/2020,MHPC,Region,84,353,437,26,101,83,16,1386,3342,769,288,4728,572,208
8/18/2020,MHPC,Region,86,351,437,27,124,83,16,1161,3592,732,268,4753,570,212
8/19/2020,MHPC,Region,90,347,437,36,97,71,16,1210,3547,729,264,4757,571,212
8/20/2020,MHPC,Region,80,357,437,33,106,78,16,1233,3531,731,273,4764,568,214
8/21/2020,MHPC,Region,102,330,432,26,93,68,16,1234,3532,766,256,4766,577,205
4/6/2020,SHPR,Region,20,40,60,,,,5,304,539,309,12,843,171,30
4/7/2020,SHPR,Region,17,62,79,,,,6,353,605,309,13,958,179,34
4/8/2020,SHPR,Region,14,54,68,,,,5,242,601,458,13,843,174,29
4/9/2020,SHPR,Region,18,50,68,,,,6,256,608,468,14,864,190,13
4/10/2020,SHPR,Region,0,6,6,,,,4,50,73,65,0,123,23,2
4/11/2020,SHPR,Region,0,6,6,,,,3,44,69,58,3,113,21,2
4/12/2020,SHPR,Region,15,6,21,,,,3,110,82,27,3,192,25,3
4/13/2020,SHPR,Region,52,41,93,,,,6,376,600,458,18,976,183,32
4/14/2020,SHPR,Region,57,36,93,,,,5,328,625,208,17,953,182,29
4/15/2020,SHPR,Region,55,38,93,,,,6,413,594,555,21,1007,184,28
4/16/2020,SHPR,Region,24,36,60,,,,5,364,537,239,18,901,189,14
4/17/2020,SHPR,Region,23,36,59,,,,5,402,495,268,12,897,173,29
4/18/2020,SHPR,Region,0,6,6,,,,4,31,66,65,6,97,25,0
4/19/2020,SHPR,Region,0,6,6,,,,3,18,62,34,3,80,21,0
4/20/2020,SHPR,Region,24,41,65,,,,6,420,556,239,15,976,186,29
4/21/2020,SHPR,Region,30,35,65,,,,6,359,653,237,14,1012,187,28
4/22/2020,SHPR,Region,31,28,59,,,,5,273,633,226,8,906,182,21
4/23/2020,SHPR,Region,41,28,69,,,,6,300,681,207,10,981,191,25
4/24/2020,SHPR,Region,33,31,64,,,,5,255,650,207,15,905,183,19
4/25/2020,SHPR,Region,28,36,64,,,,5,292,613,207,15,905,182,20
4/26/2020,SHPR,Region,32,33,65,,,,5,305,600,207,14,905,191,11
4/27/2020,SHPR,Region,28,41,69,,,,6,334,646,203,17,980,187,27
4/28/2020,SHPR,Region,25,39,64,,,,5,263,642,205,17,905,173,29
4/29/2020,SHPR,Region,26,42,68,,,,6,285,677,219,17,962,171,47
4/30/2020,SHPR,Region,22,47,69,,,,6,288,677,218,16,965,143,27
5/1/2020,SHPR,Region,27,42,69,,,,5,335,612,208,15,947,136,28
5/2/2020,SHPR,Region,22,45,67,,,,5,277,663,224,10,940,137,30
5/3/2020,SHPR,Region,30,42,72,,,,6,315,650,220,15,965,137,33
5/4/2020,SHPR,Region,30,42,72,,,,6,274,691,220,14,965,139,31
5/5/2020,SHPR,Region,9,9,18,,,,5,71,125,44,8,196,45,1
5/6/2020,SHPR,Region,26,45,71,,,,6,191,774,220,15,965,137,33
5/7/2020,SHPR,Region,28,44,72,,,,6,221,744,215,16,965,138,32
5/8/2020,SHPR,Region,27,45,72,,,,5,240,707,208,16,947,137,27
5/9/2020,SHPR,Region,30,38,68,,,,5,307,633,215,11,940,138,29
5/10/2020,SHPR,Region,30,42,72,,,,6,334,631,215,14,965,147,23
5/11/2020,SHPR,Region,27,40,67,,,,4,264,658,208,10,922,138,23
5/12/2020,SHPR,Region,18,53,71,,,,6,187,778,215,14,965,67,103
5/13/2020,SHPR,Region,18,54,72,,,,6,155,810,215,15,965,142,28
5/14/2020,SHPR,Region,18,54,72,,,,6,120,845,215,14,965,147,24
5/15/2020,SHPR,Region,25,47,72,,,,6,175,790,215,20,965,148,22
5/16/2020,SHPR,Region,22,50,72,,,,6,247,718,215,19,965,144,26
5/17/2020,SHPR,Region,23,49,72,,,,6,277,688,215,19,965,144,26
5/18/2020,SHPR,Region,16,53,69,,,,5,220,727,208,22,947,133,31
5/19/2020,SHPR,Region,15,57,72,,,,6,138,827,215,23,965,133,37
5/20/2020,SHPR,Region,10,62,72,,,,5,123,824,208,22,947,128,36
5/21/2020,SHPR,Region,20,49,69,,,,5,161,786,208,21,947,132,32
5/22/2020,SHPR,Region,20,48,68,,,,6,193,772,215,20,965,140,30
5/23/2020,SHPR,Region,14,55,69,,,,5,242,705,208,13,947,429,35
5/24/2020,SHPR,Region,23,46,69,,,,6,269,695,215,22,964,138,31
5/25/2020,SHPR,Region,19,50,69,,,,6,250,715,215,24,965,134,36
5/26/2020,SHPR,Region,24,48,72,,,,6,222,743,215,27,965,139,31
5/27/2020,SHPR,Region,16,53,69,,,,6,140,825,215,26,965,139,31
5/28/2020,SHPR,Region,17,52,69,,,,5,137,810,208,28,947,131,33
5/29/2020,SHPR,Region,17,52,69,,,,6,112,853,215,26,965,142,28
5/30/2020,SHPR,Region,12,57,69,,,,6,167,798,215,27,965,138,32
5/31/2020,SHPR,Region,18,47,65,,,,5,207,733,215,26,940,135,32
6/1/2020,SHPR,Region,25,44,69,,,,6,229,736,215,25,965,134,36
6/2/2020,SHPR,Region,17,52,69,,,,6,183,782,215,25,965,138,35
6/3/2020,SHPR,Region,7,62,69,1,1,11,6,168,797,215,28,965,137,35
6/4/2020,SHPR,Region,19,51,70,3,3,11,6,138,827,215,27,965,136,34
6/5/2020,SHPR,Region,12,58,70,1,4,13,6,142,823,215,25,965,139,31
6/6/2020,SHPR,Region,14,56,70,3,3,13,6,193,772,215,25,965,140,30
6/7/2020,SHPR,Region,14,52,66,2,1,12,5,205,735,215,24,940,134,33
6/8/2020,SHPR,Region,21,48,69,7,2,15,6,199,766,215,27,965,141,29
6/9/2020,SHPR,Region,19,50,69,3,2,17,6,179,783,215,28,962,139,31
6/10/2020,SHPR,Region,16,53,69,4,2,17,6,111,854,215,33,965,137,33
6/11/2020,SHPR,Region,14,55,69,4,2,17,6,126,839,215,34,965,138,32
6/12/2020,SHPR,Region,11,58,69,1,7,19,6,92,873,215,36,965,129,41
6/13/2020,SHPR,Region,13,56,69,4,4,17,5,156,791,208,35,947,131,35
6/14/2020,SHPR,Region,15,44,59,2,0,12,3,147,705,196,28,852,113,37
6/15/2020,SHPR,Region,13,56,69,4,6,16,6,137,828,215,35,965,135,35
6/16/2020,SHPR,Region,14,55,69,2,3,18,6,95,870,215,35,965,133,37
6/17/2020,SHPR,Region,8,61,69,2,5,18,6,44,921,215,33,965,133,37
6/18/2020,SHPR,Region,14,55,69,3,3,17,6,94,871,215,36,965,122,44
6/19/2020,SHPR,Region,11,58,69,5,4,16,6,147,818,215,36,965,124,46
6/20/2020,SHPR,Region,9,54,63,3,1,14,4,148,730,194,29,878,110,43
6/21/2020,SHPR,Region,11,58,69,2,1,15,5,164,774,208,33,938,122,44
6/22/2020,SHPR,Region,22,47,69,1,3,15,6,152,813,215,32,965,124,46
6/23/2020,SHPR,Region,9,60,69,6,4,13,6,3,962,215,38,965,136,34
6/24/2020,SHPR,Region,4,65,69,6,4,14,6,39,926,215,41,965,132,38
6/25/2020,SHPR,Region,15,54,69,1,4,12,6,89,876,210,38,965,131,39
6/26/2020,SHPR,Region,14,55,69,5,3,11,6,117,848,210,36,965,135,35
6/27/2020,SHPR,Region,15,48,63,5,6,7,4,121,756,196,37,877,116,37
6/28/2020,SHPR,Region,15,50,65,6,2,7,3,161,733,201,41,894,121,40
6/29/2020,SHPR,Region,16,53,69,10,2,10,5,99,838,208,47,937,132,34
6/30/2020,SHPR,Region,9,60,69,8,1,10,5,96,841,208,52,937,129,37
7/1/2020,SHPR,Region,6,63,69,2,2,12,6,55,900,208,44,955,134,36
7/2/2020,SHPR,Region,13,56,69,4,1,11,6,85,870,208,42,955,128,42
7/3/2020,SHPR,Region,16,53,69,5,1,10,6,121,834,208,43,955,133,37
7/4/2020,SHPR,Region,14,55,69,7,1,12,5,157,780,208,43,937,133,33
7/5/2020,SHPR,Region,15,54,69,3,0,12,5,174,763,208,42,937,130,36
7/6/2020,SHPR,Region,18,51,69,5,2,13,6,127,830,208,45,957,136,34
7/7/2020,SHPR,Region,13,56,69,4,3,13,6,81,907,208,49,988,141,29
7/8/2020,SHPR,Region,13,56,69,6,3,15,6,63,925,208,50,988,132,36
7/9/2020,SHPR,Region,12,57,69,10,3,15,6,56,932,208,54,988,131,37
7/10/2020,SHPR,Region,12,57,69,6,1,13,6,52,936,208,57,988,124,40
7/11/2020,SHPR,Region,11,58,69,8,6,14,5,101,869,208,59,970,123,41
7/12/2020,SHPR,Region,11,58,69,7,3,16,5,151,819,208,56,970,129,37
7/13/2020,SHPR,Region,18,51,69,8,2,17,5,78,892,208,64,970,124,40
7/14/2020,SHPR,Region,9,60,69,5,3,17,5,88,882,208,62,970,124,40
7/15/2020,SHPR,Region,16,61,77,4,3,16,5,235,720,463,58,955,125,40
7/16/2020,SHPR,Region,18,59,77,8,5,16,6,244,729,470,57,973,123,44
7/17/2020,SHPR,Region,24,53,77,2,7,16,5,270,699,463,57,969,126,39
7/18/2020,SHPR,Region,25,52,77,7,3,16,6,300,677,470,60,977,130,38
7/19/2020,SHPR,Region,26,51,77,3,2,14,6,328,659,470,60,987,139,29
7/20/2020,SHPR,Region,31,46,77,7,2,14,6,329,658,470,63,987,136,32
7/21/2020,SHPR,Region,19,58,77,7,4,15,6,248,723,470,60,971,134,34
7/22/2020,SHPR,Region,6,9,15,0,2,16,6,23,157,34,59,180,42,2
7/23/2020,SHPR,Region,28,49,77,4,1,17,5,249,704,463,60,953,133,33
7/24/2020,SHPR,Region,21,56,77,5,1,18,6,311,676,470,50,987,134,34
7/25/2020,SHPR,Region,31,46,77,6,1,13,6,336,639,470,48,975,136,34
7/26/2020,SHPR,Region,19,58,77,9,1,13,6,333,642,470,46,975,135,35
7/27/2020,SHPR,Region,25,52,77,5,3,13,6,338,643,470,49,981,138,32
7/28/2020,SHPR,Region,22,55,77,2,6,15,6,295,686,470,48,981,135,35
7/29/2020,SHPR,Region,22,55,77,5,1,14,6,268,713,470,50,981,134,36
7/30/2020,SHPR,Region,26,52,78,4,1,13,6,261,714,470,46,975,133,37
7/31/2020,SHPR,Region,20,57,77,4,4,13,6,265,710,470,39,975,127,43
8/1/2020,SHPR,Region,24,53,77,3,3,11,6,284,691,470,34,975,133,37
8/2/2020,SHPR,Region,24,47,71,4,1,10,5,315,606,458,36,921,123,34
8/3/2020,SHPR,Region,23,54,77,1,2,11,6,332,649,470,37,981,132,38
8/4/2020,SHPR,Region,21,56,77,7,4,13,6,319,662,470,41,981,132,38
8/5/2020,SHPR,Region,23,54,77,2,5,12,6,312,669,470,43,981,137,33
8/6/2020,SHPR,Region,22,55,77,3,4,11,6,276,691,470,38,967,133,37
8/7/2020,SHPR,Region,24,53,77,3,2,10,6,268,705,470,40,973,135,35
8/8/2020,SHPR,Region,20,57,77,3,2,9,6,287,680,470,41,967,137,33
8/9/2020,SHPR,Region,18,53,71,2,0,10,5,293,614,458,38,907,122,35
8/10/2020,SHPR,Region,30,48,78,2,5,9,6,306,667,470,44,973,138,32
8/11/2020,SHPR,Region,24,53,77,4,33,9,6,257,709,470,43,966,144,26
8/12/2020,SHPR,Region,27,44,71,1,27,8,5,255,651,458,31,906,129,28
8/13/2020,SHPR,Region,29,48,77,2,26,10,6,272,699,470,35,971,140,30
8/14/2020,SHPR,Region,24,53,77,6,36,12,6,252,711,470,33,963,135,35
8/15/2020,SHPR,Region,29,48,77,1,21,9,6,272,680,470,29,952,135,35
8/16/2020,SHPR,Region,31,46,77,0,20,8,6,302,660,471,23,962,136,33
8/17/2020,SHPR,Region,34,43,77,2,24,9,6,320,691,484,26,1011,108,62
8/18/2020,SHPR,Region,33,44,77,3,24,9,6,264,736,484,28,1000,107,63
8/19/2020,SHPR,Region,34,43,77,5,22,8,6,270,735,484,30,1005,112,58
8/20/2020,SHPR,Region,43,34,77,1,22,6,6,281,719,484,31,1000,107,63
8/21/2020,SHPR,Region,33,44,77,2,27,9,6,270,725,484,32,995,102,68
4/6/2020,THPC,Region,270,318,588,,,,20,1981,2342,298,62,4323,426,203
4/7/2020,THPC,Region,165,403,568,,,,21,1597,2372,288,70,3969,350,170
4/8/2020,THPC,Region,198,388,586,,,,21,1615,2647,362,76,4262,407,162
4/9/2020,THPC,Region,213,352,565,,,,21,1737,2566,315,68,4303,376,181
4/10/2020,THPC,Region,207,270,477,,,,20,1301,1942,364,49,3243,371,103
4/11/2020,THPC,Region,155,259,414,,,,18,1501,1529,170,49,3030,323,105
4/12/2020,THPC,Region,223,318,541,,,,18,1546,2035,192,66,3581,450,118
4/13/2020,THPC,Region,176,280,456,,,,22,1154,2021,291,51,3175,356,124
4/14/2020,THPC,Region,233,395,628,,,,22,1845,2605,417,74,4450,448,165
4/15/2020,THPC,Region,208,389,597,,,,20,1596,2589,351,73,4185,426,159
4/16/2020,THPC,Region,209,351,560,,,,21,1694,2697,384,69,4391,459,153
4/17/2020,THPC,Region,242,352,594,,,,21,1395,2649,354,68,4044,474,156
4/18/2020,THPC,Region,265,330,595,,,,19,1626,2249,219,116,3875,420,177
4/19/2020,THPC,Region,261,320,581,,,,20,2029,2176,248,56,4205,428,160
4/20/2020,THPC,Region,267,316,583,,,,22,1864,2571,399,43,4435,476,157
4/21/2020,THPC,Region,241,291,532,,,,20,1626,2453,307,38,4079,465,121
4/22/2020,THPC,Region,262,310,572,,,,21,1316,2653,384,83,3969,466,165
4/23/2020,THPC,Region,241,331,572,,,,22,1339,2785,738,66,4124,488,148
4/24/2020,THPC,Region,147,296,443,,,,22,1167,2204,708,54,3371,365,132
4/25/2020,THPC,Region,212,360,572,,,,19,1623,2265,673,50,3888,445,149
4/26/2020,THPC,Region,235,373,608,,,,20,1879,2331,683,75,4210,471,147
4/27/2020,THPC,Region,249,339,588,,,,22,1676,2646,769,88,4322,502,146
4/28/2020,THPC,Region,242,348,590,,,,22,1362,2846,821,91,4208,509,168
4/29/2020,THPC,Region,217,362,579,,,,22,1504,2737,782,87,4241,532,176
4/30/2020,THPC,Region,213,372,585,,,,22,1614,2759,798,85,4373,520,190
5/1/2020,THPC,Region,217,372,589,,,,21,1707,2592,770,76,4299,584,176
5/2/2020,THPC,Region,268,365,633,,,,21,1680,2642,750,83,4322,598,169
5/3/2020,THPC,Region,265,340,605,,,,21,1566,2610,754,87,4176,606,172
5/4/2020,THPC,Region,241,351,592,,,,22,1451,2778,798,87,4229,594,179
5/5/2020,THPC,Region,209,381,590,,,,22,1148,3107,782,93,4255,645,129
5/6/2020,THPC,Region,224,359,583,,,,22,1175,3044,782,90,4219,609,165
5/7/2020,THPC,Region,229,382,611,,,,21,1205,2920,576,95,4125,601,166
5/8/2020,THPC,Region,220,375,595,,,,22,1483,2818,609,91,4301,592,175
5/9/2020,THPC,Region,207,394,601,,,,21,1648,2564,575,93,4212,582,174
5/10/2020,THPC,Region,316,388,704,,,,22,1827,2492,466,95,4319,599,168
5/11/2020,THPC,Region,202,382,584,,,,22,1449,2734,616,104,4183,468,182
5/12/2020,THPC,Region,242,384,626,,,,22,1335,2948,622,112,4283,568,155
5/13/2020,THPC,Region,231,408,639,,,,22,1510,2834,579,111,4344,511,180
5/14/2020,THPC,Region,193,409,602,,,,22,1579,2882,743,111,4461,598,179
5/15/2020,THPC,Region,196,398,594,,,,22,1483,2843,750,126,4326,588,184
5/16/2020,THPC,Region,196,393,589,,,,22,1526,2830,515,120,4356,613,188
5/17/2020,THPC,Region,179,409,588,,,,21,1659,2564,504,123,4223,581,197
5/18/2020,THPC,Region,156,414,570,,,,22,1327,2960,579,132,4287,604,188
5/19/2020,THPC,Region,170,419,589,,,,22,1372,2987,581,140,4359,586,192
5/20/2020,THPC,Region,159,433,592,,,,22,946,3313,567,147,4259,581,202
5/21/2020,THPC,Region,153,420,573,,,,22,1293,3312,577,160,4605,493,205
5/22/2020,THPC,Region,231,386,617,,,,22,1310,3104,577,171,4414,481,191
5/23/2020,THPC,Region,181,395,576,,,,20,1255,2806,504,169,4061,454,187
5/24/2020,THPC,Region,186,401,587,,,,20,1408,2720,494,168,4128,577,182
5/25/2020,THPC,Region,149,365,514,,,,19,1170,2656,544,159,3826,493,145
5/26/2020,THPC,Region,169,412,581,,,,22,1405,2940,567,187,4345,476,199
5/27/2020,THPC,Region,123,453,576,,,,21,1066,3207,550,188,4273,536,186
5/28/2020,THPC,Region,146,432,578,,,,22,1182,3119,565,194,4301,577,190
5/29/2020,THPC,Region,192,402,594,,,,22,1157,3319,535,171,4476,536,170
5/30/2020,THPC,Region,189,427,616,,,,21,1235,3143,698,170,4378,573,173
5/31/2020,THPC,Region,199,405,604,,,,21,1318,2955,693,184,4273,563,181
6/1/2020,THPC,Region,179,384,563,,,,22,1357,3024,712,212,4381,560,160
6/2/2020,THPC,Region,153,449,602,,,,23,1427,3078,602,187,4505,604,193
6/3/2020,THPC,Region,140,420,560,8,159,66,21,1029,3032,535,176,4061,475,161
6/4/2020,THPC,Region,153,413,566,21,44,66,21,1185,2916,529,184,4101,431,208
6/5/2020,THPC,Region,251,423,674,8,127,70,21,1043,3034,522,193,4077,443,192
6/6/2020,THPC,Region,131,457,588,5,62,74,21,1192,2815,519,185,4007,469,162
6/7/2020,THPC,Region,149,445,594,10,21,80,22,1193,2926,519,184,4119,492,172
6/8/2020,THPC,Region,152,301,453,11,167,52,22,1098,2481,390,147,3579,422,146
6/9/2020,THPC,Region,147,447,594,10,201,73,23,1224,3024,596,188,4248,454,213
6/10/2020,THPC,Region,122,452,574,15,109,67,22,1115,3016,560,189,4131,413,193
6/11/2020,THPC,Region,126,449,575,10,212,73,23,1329,2902,591,178,4231,419,224
6/12/2020,THPC,Region,132,436,568,13,153,73,23,1273,2939,589,192,4212,419,213
6/13/2020,THPC,Region,86,377,463,12,13,68,21,1038,2321,519,179,3359,420,151
6/14/2020,THPC,Region,121,453,574,9,80,69,21,1335,2730,538,184,4065,455,211
6/15/2020,THPC,Region,135,423,558,11,77,74,22,1304,2763,554,196,4067,445,213
6/16/2020,THPC,Region,148,442,590,12,170,72,23,1069,3109,618,199,4178,455,220
6/17/2020,THPC,Region,142,444,586,8,149,69,22,1020,3128,587,198,4148,468,211
6/18/2020,THPC,Region,124,467,591,13,187,76,23,1101,3186,593,203,4287,476,218
6/19/2020,THPC,Region,142,435,577,15,154,75,23,1262,2986,597,216,4248,468,221
6/20/2020,THPC,Region,137,418,555,17,135,76,19,1119,3007,520,215,4126,422,218
6/21/2020,THPC,Region,114,465,579,11,130,75,21,1185,2846,526,203,4031,446,206
6/22/2020,THPC,Region,145,441,586,7,174,79,23,1149,3138,599,197,4287,485,207
6/23/2020,THPC,Region,146,439,585,22,232,61,23,1257,3218,589,198,4475,466,205
6/24/2020,THPC,Region,161,473,634,19,65,63,23,1309,3273,543,193,4582,484,198
6/25/2020,THPC,Region,143,432,575,14,24,66,22,1416,3202,521,203,4618,472,199
6/26/2020,THPC,Region,209,429,638,8,18,64,23,1492,3211,545,194,4703,499,198
6/27/2020,THPC,Region,148,442,590,21,14,56,22,1530,3062,468,198,4592,496,187
6/28/2020,THPC,Region,137,437,574,11,17,56,21,1524,2884,478,194,4408,474,186
6/29/2020,THPC,Region,151,417,568,12,91,55,23,1581,2986,553,206,4567,503,194
6/30/2020,THPC,Region,145,432,577,16,97,55,22,1379,3156,515,189,4535,478,208
7/1/2020,THPC,Region,151,419,570,10,100,49,23,1370,3249,555,197,4619,481,209
7/2/2020,THPC,Region,142,422,564,15,128,56,23,1531,3146,555,196,4677,490,202
7/3/2020,THPC,Region,145,421,566,14,115,52,22,1451,3088,526,195,4539,466,202
7/4/2020,THPC,Region,127,375,502,16,72,51,19,1326,3103,465,196,4429,432,198
7/5/2020,THPC,Region,184,391,575,13,78,50,20,1431,3231,470,215,4662,457,204
7/6/2020,THPC,Region,183,391,574,12,196,55,22,1466,2996,517,215,4462,493,192
7/7/2020,THPC,Region,127,429,556,16,155,61,22,1276,3176,526,216,4452,498,183
7/8/2020,THPC,Region,153,421,574,25,133,61,23,1192,3331,545,225,4523,511,185
7/9/2020,THPC,Region,138,425,563,19,126,68,22,1051,3217,527,235,4268,490,188
7/10/2020,THPC,Region,164,414,578,19,89,73,23,1091,3229,553,249,4320,518,178
7/11/2020,THPC,Region,134,430,564,29,62,66,20,1299,3065,472,252,4364,480,181
7/12/2020,THPC,Region,153,421,574,18,45,67,18,1027,2861,462,231,3888,478,179
7/13/2020,THPC,Region,158,399,557,21,15,89,22,1525,3007,516,252,4532,485,189
7/14/2020,THPC,Region,114,452,566,31,19,94,23,1381,3284,544,283,4665,486,206
7/15/2020,THPC,Region,122,434,556,18,81,101,22,1249,3164,513,262,4413,480,189
7/16/2020,THPC,Region,110,432,542,14,55,85,21,1152,3197,514,256,4349,470,199
7/17/2020,THPC,Region,117,442,559,20,73,82,22,947,3228,543,244,4175,482,200
7/18/2020,THPC,Region,115,469,584,22,25,71,22,1134,3204,507,245,4338,477,202
7/19/2020,THPC,Region,134,433,567,19,15,79,22,1287,3049,499,258,4336,475,205
7/20/2020,THPC,Region,141,415,556,26,84,74,22,1602,2735,524,255,4337,459,206
7/21/2020,THPC,Region,158,423,581,37,65,89,23,1722,3235,550,286,4957,469,222
7/22/2020,THPC,Region,159,422,581,35,56,91,23,1625,3349,538,264,4974,465,224
7/23/2020,THPC,Region,157,410,567,25,51,87,22,1675,3305,531,261,4980,463,215
7/24/2020,THPC,Region,148,434,582,19,75,85,23,1680,3316,550,265,4996,484,208
7/25/2020,THPC,Region,161,397,558,24,54,74,21,1649,3099,492,249,4748,428,202
7/26/2020,THPC,Region,194,376,570,20,39,74,21,1936,2881,463,237,4817,475,193
7/27/2020,THPC,Region,194,384,578,21,57,83,23,1738,3235,550,240,4973,487,212
7/28/2020,THPC,Region,144,446,590,32,22,82,23,1485,3447,530,279,4932,464,229
7/29/2020,THPC,Region,138,421,559,28,69,80,20,1294,3287,498,275,4581,433,221
7/30/2020,THPC,Region,144,418,562,20,55,79,21,1364,3474,502,254,4838,469,201
7/31/2020,THPC,Region,142,438,580,22,40,76,22,1506,3350,509,260,4856,474,207
8/1/2020,THPC,Region,170,399,569,28,43,80,22,1653,3156,504,251,4809,493,188
8/2/2020,THPC,Region,156,362,518,12,26,62,21,1557,2913,469,174,4470,469,170
8/3/2020,THPC,Region,186,407,593,14,49,74,23,1676,3216,538,226,4892,500,194
8/4/2020,THPC,Region,169,410,579,33,47,82,22,1618,3228,509,235,4846,480,199
8/5/2020,THPC,Region,199,394,593,32,61,87,23,1529,3392,531,242,4921,492,204
8/6/2020,THPC,Region,177,390,567,23,46,89,21,1515,3258,502,259,4773,464,201
8/7/2020,THPC,Region,180,407,587,25,39,88,23,1776,3163,538,257,4939,499,192
8/8/2020,THPC,Region,173,397,570,33,39,84,21,1563,3108,442,251,4671,444,196
8/9/2020,THPC,Region,178,399,577,17,29,85,22,1833,2949,501,249,4782,470,205
8/10/2020,THPC,Region,162,413,575,22,30,93,23,1614,3200,530,260,4814,477,216
8/11/2020,THPC,Region,159,412,571,23,57,82,22,1531,3309,513,231,4840,455,225
8/12/2020,THPC,Region,153,427,580,40,38,80,23,1486,3397,522,233,4883,476,225
8/13/2020,THPC,Region,143,436,579,19,28,83,21,1436,3415,513,226,4851,462,220
8/14/2020,THPC,Region,145,431,576,28,27,84,22,1422,3377,523,239,4799,467,217
8/15/2020,THPC,Region,146,415,561,26,21,84,21,1423,3247,477,251,4670,443,228
8/16/2020,THPC,Region,160,391,551,27,12,79,20,1344,3079,455,235,4423,455,202
8/17/2020,THPC,Region,139,361,500,26,21,85,24,1685,2967,567,245,4652,457,234
8/18/2020,THPC,Region,152,420,572,21,29,78,23,1669,3601,538,248,5270,492,235
8/19/2020,THPC,Region,122,463,585,29,27,72,24,1667,3688,555,260,5355,492,246
8/20/2020,THPC,Region,141,429,570,21,22,71,23,1692,3620,530,250,5312,472,256
8/21/2020,THPC,Region,142,417,559,51,14,67,23,1737,3454,708,261,5191,467,263
