Total Cases That Were Reinfections,Total Cases by Date of Specimen collection,Total Antigen Cases by Date of Specimen Collection,Total Molecular Cases by Date of Specimen Collection,Death by Date of Death,County,Date
33,137,30,107,0,Forsyth,2023-01-06
10,42,8,34,1,Alamance,2023-01-06
10,33,9,24,1,Lenoir,2023-01-06
14,47,17,30,0,New Hanover,2023-01-06
1,4,1,3,0,Currituck,2023-01-06
7,26,3,23,0,Franklin,2023-01-06
6,29,3,26,0,Cleveland,2023-01-06
3,7,1,6,0,Richmond,2023-01-06
6,24,6,18,0,Stokes,2023-01-06
13,74,16,58,1,Johnston,2023-01-06
14,54,35,19,0,Catawba,2023-01-06
3,7,0,7,0,Chowan,2023-01-06
1,24,5,19,0,Chatham,2023-01-06
3,16,4,12,0,Hoke,2023-01-06
0,5,3,2,0,Macon,2023-01-06
0,1,0,1,0,Perquimans,2023-01-06
1,15,3,12,0,Columbus,2023-01-06
6,25,8,17,0,Surry,2023-01-06
10,51,11,40,1,Gaston,2023-01-06
5,11,6,5,0,Swain,2023-01-06
2,5,0,5,0,Cherokee,2023-01-07
3,20,7,13,0,Harnett,2023-01-07
4,18,6,12,1,Wayne,2023-01-07
3,19,4,15,0,Burke,2023-01-07
8,35,10,25,0,Cabarrus,2023-01-07
6,30,4,26,1,Johnston,2023-01-07
7,51,19,32,0,Cumberland,2023-01-07
3,12,2,10,0,Granville,2023-01-07
1,17,5,12,0,Nash,2023-01-07
4,14,8,6,1,Wilkes,2023-01-07
2,20,9,11,0,Wilson,2023-01-07
0,2,0,2,0,Washington,2023-01-07
2,14,2,12,1,Caldwell,2023-01-07
1,3,0,3,0,Hertford,2023-01-07
2,17,2,15,0,Craven,2023-01-07
1,5,1,4,0,Bladen,2023-01-07
3,15,3,12,0,Orange,2023-01-07
0,2,1,1,0,Camden,2023-01-07
1,8,1,7,0,Stanly,2023-01-07
76,311,90,221,0,Mecklenburg,2023-01-11
14,45,27,18,0,Robeson,2023-01-11
5,26,10,16,2,Moore,2023-01-11
3,10,5,5,1,Vance,2023-01-11
10,26,6,20,0,Franklin,2023-01-11
1,7,1,6,0,Chowan,2023-01-11
8,29,2,27,0,Orange,2023-01-11
1,7,0,7,0,Washington,2023-01-11
1,1,0,1,0,Jones,2023-01-11
9,32,11,21,1,Randolph,2023-01-11
15,49,31,18,1,Wayne,2023-01-11
3,14,5,9,0,Carteret,2023-01-11
1,10,5,5,1,Duplin,2023-01-11
4,22,11,11,0,Davie,2023-01-11
2,9,1,8,0,McDowell,2023-01-11
1,8,5,3,0,Hertford,2023-01-11
1,5,1,4,0,Transylvania,2023-01-11
10,50,13,37,0,Cabarrus,2023-01-11
4,19,4,15,0,Yadkin,2023-01-11
6,31,10,21,1,New Hanover,2023-01-11
2,9,4,5,0,Scotland,2023-01-11
1,6,1,5,0,Cherokee,2023-01-11
1,19,5,14,1,Craven,2023-01-11
1,4,3,1,0,Graham,2023-01-11
4,11,9,2,0,Swain,2023-01-11
1,4,0,4,0,Ashe,2023-01-11
7,58,26,32,1,Buncombe,2023-01-17
12,43,31,12,0,Wayne,2023-01-17
7,24,1,23,0,Bladen,2023-01-17
13,50,15,35,0,Cabarrus,2023-01-17
5,26,19,7,0,Sampson,2023-01-17
6,41,9,32,0,Caldwell,2023-01-17
7,20,4,16,0,McDowell,2023-01-17
8,24,16,8,0,Randolph,2023-01-17
4,21,12,9,0,Davie,2023-01-17
7,24,13,11,0,Duplin,2023-01-17
3,19,10,9,0,Henderson,2023-01-17
5,23,9,14,0,Wilson,2023-01-17
2,17,6,11,0,Burke,2023-01-17
6,25,11,14,0,Granville,2023-01-17
7,39,5,34,0,Orange,2023-01-17
0,1,1,0,0,Ashe,2023-01-17
3,16,2,14,0,Stanly,2023-01-17
0,7,2,5,0,Watauga,2023-01-17
1,11,1,10,0,Cherokee,2023-01-17
1,17,10,7,1,Craven,2023-01-17
0,1,1,0,1,Jones,2023-01-17
1,1,1,0,0,Graham,2023-01-17
8,25,10,15,0,Lincoln,2023-01-19
14,43,8,35,0,Union,2023-01-19
1,13,4,9,0,Hoke,2023-01-19
7,22,4,18,0,Surry,2023-01-19
6,26,13,13,0,Catawba,2023-01-19
27,104,24,80,1,Forsyth,2023-01-19
5,12,3,9,0,Franklin,2023-01-19
4,16,1,15,0,Cleveland,2023-01-19
3,9,2,7,0,Anson,2023-01-19
5,16,7,9,2,Craven,2023-01-19
1,7,4,3,0,Carteret,2023-01-19
3,14,4,10,0,Lenoir,2023-01-19
0,6,0,6,0,Chowan,2023-01-19
1,8,2,6,0,Vance,2023-01-19
2,31,8,23,0,New Hanover,2023-01-19
3,9,2,7,0,Transylvania,2023-01-19
0,1,1,0,0,Washington,2023-01-19
0,2,1,1,0,Camden,2023-01-19
1,2,1,1,0,Clay,2023-01-19
5,22,5,17,0,Davidson,2023-01-28
2,3,0,3,0,Beaufort,2023-01-28
5,16,0,16,0,Alamance,2023-01-28
6,23,8,15,0,Pitt,2023-01-28
5,8,3,5,0,Moore,2023-01-28
1,2,0,2,0,Clay,2023-01-28
1,5,1,4,1,Brunswick,2023-01-28
1,2,0,2,0,Madison,2023-01-28
3,9,3,6,0,Pender,2023-01-28
2,15,5,10,0,Surry,2023-01-28
0,6,3,3,0,Sampson,2023-01-28
2,5,1,4,0,Pasquotank,2023-01-28
2,9,6,3,0,Scotland,2023-01-28
2,15,5,10,0,Cleveland,2023-01-28
1,5,1,4,0,Burke,2023-01-28
1,10,0,10,0,Edgecombe,2023-01-28
0,6,0,6,0,Dare,2023-01-28
0,5,1,4,0,Alexander,2023-01-28
0,2,0,2,0,Jackson,2023-01-28
5,21,17,4,0,Rutherford,2023-01-28
1,5,3,2,0,Watauga,2023-01-28
49,198,30,168,1,Wake,2023-01-30
6,12,4,8,0,Cleveland,2023-01-30
8,23,7,16,0,Moore,2023-01-30
14,40,26,14,2,Catawba,2023-01-30
9,27,7,20,0,Columbus,2023-01-09
18,108,9,99,0,Durham,2023-01-09
12,61,30,31,0,Wayne,2023-01-09
6,32,8,24,0,Vance,2023-01-09
14,45,17,28,1,Gaston,2023-01-09
22,64,13,51,0,Pitt,2023-01-09
11,66,27,39,2,Buncombe,2023-01-09
5,18,14,4,0,Scotland,2023-01-09
10,23,2,21,0,Bladen,2023-01-09
4,11,3,8,0,Lee,2023-01-09
3,27,11,16,0,Harnett,2023-01-09
6,30,14,16,0,Randolph,2023-01-09
7,23,13,10,0,Wilson,2023-01-09
1,8,3,5,0,Pasquotank,2023-01-09
1,7,5,2,0,Transylvania,2023-01-09
1,4,0,4,0,Anson,2023-01-09
5,28,14,14,0,Carteret,2023-01-09
31,137,38,99,1,Guilford,2023-01-10
3,16,4,12,0,Halifax,2023-01-10
18,61,18,43,0,Cabarrus,2023-01-10
6,16,3,13,0,Rockingham,2023-01-10
4,26,12,14,0,Henderson,2023-01-10
12,38,18,20,1,Randolph,2023-01-10
15,106,35,71,0,Cumberland,2023-01-10
21,64,27,37,0,Robeson,2023-01-10
5,20,7,13,0,Columbus,2023-01-10
17,50,11,39,1,Pitt,2023-01-10
4,28,7,21,0,Harnett,2023-01-10
2,8,1,7,0,Granville,2023-01-10
3,18,6,12,1,Caldwell,2023-01-10
18,98,20,78,0,Forsyth,2023-01-10
4,15,2,13,0,Edgecombe,2023-01-10
0,9,1,8,0,Caswell,2023-01-10
1,16,6,10,0,Transylvania,2023-01-10
0,5,1,4,0,Pasquotank,2023-01-10
2,6,2,4,0,Northampton,2023-01-10
3,11,7,4,0,Jackson,2023-01-10
9,20,8,12,0,Wayne,2023-01-14
4,10,2,8,1,Burke,2023-01-14
9,26,7,19,0,Cabarrus,2023-01-14
5,24,9,15,1,Johnston,2023-01-14
2,8,0,8,0,Nash,2023-01-14
1,9,5,4,0,Wilkes,2023-01-14
6,33,12,21,0,Cumberland,2023-01-14
8,45,6,39,1,Durham,2023-01-14
4,9,3,6,0,Davie,2023-01-14
9,16,2,14,0,Stanly,2023-01-14
1,11,3,8,0,Craven,2023-01-14
1,5,1,4,0,Duplin,2023-01-14
1,18,3,15,0,Orange,2023-01-14
0,3,0,3,0,Bladen,2023-01-14
0,5,0,5,0,Cherokee,2023-01-14
10,51,12,39,0,Guilford,2023-01-21
5,17,1,16,0,Onslow,2023-01-21
3,15,3,12,2,Rockingham,2023-01-21
2,9,1,8,0,Stokes,2023-01-21
1,7,2,5,0,Currituck,2023-01-21
0,3,0,3,0,Warren,2023-01-21
2,18,3,15,0,Harnett,2023-01-21
3,7,1,6,0,Halifax,2023-01-21
1,2,0,2,0,Avery,2023-01-21
0,1,0,1,0,Bertie,2023-01-21
0,5,1,4,0,Yadkin,2023-01-21
2,10,4,6,0,Haywood,2023-01-21
0,2,0,2,0,Columbus,2023-01-21
0,2,2,0,0,Swain,2023-01-21
8,16,11,5,0,Henderson,2023-01-29
6,26,10,16,0,Cabarrus,2023-01-29
2,17,7,10,0,Randolph,2023-01-29
3,11,9,2,0,Sampson,2023-01-29
11,44,10,34,0,Durham,2023-01-29
3,16,10,6,1,Robeson,2023-01-29
0,8,1,7,0,Rockingham,2023-01-29
1,15,5,10,0,Wayne,2023-01-29
1,14,4,10,0,Onslow,2023-01-29
1,10,1,9,0,Pitt,2023-01-29
0,3,2,1,0,Davie,2023-01-29
0,2,0,2,0,Alleghany,2023-01-29
1,9,5,4,0,Haywood,2023-01-29
1,1,1,0,0,Gates,2023-01-29
3,17,8,9,0,Henderson,2023-02-04
15,36,2,34,0,Durham,2023-02-04
2,4,2,2,0,Davie,2023-02-04
6,11,5,6,0,Robeson,2023-02-04
1,13,3,10,0,Caldwell,2023-02-04
4,12,2,10,0,Burke,2023-02-04
4,24,3,21,0,Alamance,2023-02-04
0,2,1,1,0,Graham,2023-02-04
0,4,0,4,0,Chatham,2023-02-04
4,9,2,7,0,Halifax,2023-02-04
1,10,2,8,0,Randolph,2023-02-04
2,6,1,5,0,Stanly,2023-02-04
1,7,2,5,1,Rowan,2023-02-04
1,3,1,2,0,Montgomery,2023-02-04
2,13,4,9,0,Iredell,2023-02-04
2,3,2,1,0,Yancey,2023-02-04
1,9,2,7,0,Onslow,2023-02-04
2,3,0,3,0,Ashe,2023-02-04
4,18,4,14,0,Johnston,2023-02-04
2,2,2,0,0,Washington,2023-02-06
2,7,3,4,0,Davie,2023-02-06
46,229,66,163,1,Mecklenburg,2023-02-06
15,44,14,30,0,Cabarrus,2023-02-06
7,65,2,63,0,Durham,2023-02-06
5,26,3,23,0,Orange,2023-02-06
13,25,13,12,0,Wilkes,2023-02-06
8,38,10,28,0,Union,2023-02-06
4,10,1,9,0,Edgecombe,2023-02-06
6,29,8,21,1,Brunswick,2023-02-06
1,13,10,3,0,Scotland,2023-02-06
9,29,7,22,0,Granville,2023-02-06
2,4,0,4,0,Hertford,2023-02-06
4,16,2,14,0,Vance,2023-02-06
13,48,21,27,0,Pitt,2023-02-06
6,21,11,10,0,Nash,2023-02-06
6,24,10,14,0,Duplin,2023-02-06
0,3,1,2,0,Jones,2023-02-06
5,27,6,21,0,Craven,2023-02-06
0,5,2,3,0,Macon,2023-02-06
0,1,0,1,0,Camden,2023-02-06
0,4,0,4,0,Person,2023-02-06
1,5,3,2,0,Swain,2023-02-06
2,5,4,1,0,Ashe,2023-02-06
8,19,9,10,0,Wilson,2023-02-06
1,3,2,1,0,Madison,2023-01-09
0,1,1,0,0,Ashe,2023-01-09
1,8,2,6,0,Anson,2023-01-10
2,5,0,5,0,Dare,2023-01-10
1,7,1,6,0,Montgomery,2023-01-10
0,1,0,1,0,Mitchell,2023-01-10
0,2,1,1,0,Person,2023-01-14
1,1,1,0,0,Jones,2023-01-14
0,6,2,4,0,Transylvania,2023-01-14
0,2,0,2,0,Washington,2023-01-14
1,1,0,1,0,Hertford,2023-01-14
1,2,1,1,0,Mitchell,2023-01-21
3,11,1,10,0,Richmond,2023-01-21
1,3,1,2,0,Person,2023-01-21
1,3,1,2,0,Transylvania,2023-01-29
1,4,1,3,0,Person,2023-01-29
0,3,1,2,0,Pasquotank,2023-01-29
1,5,1,4,0,Lee,2023-02-04
2,6,1,5,0,Orange,2023-02-04
0,3,2,1,0,Polk,2023-02-06
3,7,5,2,0,Carteret,2023-02-06
10,29,5,24,0,Pitt,2023-02-09
27,176,44,132,2,Mecklenburg,2023-02-09
1,6,5,1,0,Carteret,2023-02-09
11,57,17,40,0,Cumberland,2023-02-09
2,25,3,22,0,Orange,2023-02-09
6,20,9,11,0,Robeson,2023-02-09
16,59,10,49,0,Durham,2023-02-09
1,19,4,15,0,Craven,2023-02-09
5,21,6,15,0,Moore,2023-02-09
3,7,4,3,0,Scotland,2023-02-09
0,4,2,2,0,Jones,2023-02-09
0,4,0,4,0,Alleghany,2023-02-09
1,5,1,4,0,Edgecombe,2023-02-09
1,13,7,6,0,Pasquotank,2023-02-09
3,19,9,10,0,Randolph,2023-02-09
1,8,0,8,1,Vance,2023-02-09
1,8,2,6,2,Granville,2023-02-09
1,8,6,2,1,Warren,2023-02-09
1,3,2,1,0,Madison,2023-02-09
7,27,6,21,0,Cumberland,2022-11-11
3,9,5,4,2,Randolph,2022-11-11
4,16,4,12,0,Johnston,2022-11-11
1,9,0,9,0,Chatham,2022-11-11
2,7,0,7,0,Henderson,2022-11-11
4,40,9,31,1,Forsyth,2022-11-11
1,11,4,7,0,Robeson,2022-11-11
2,5,0,5,0,Stanly,2022-11-11
1,24,2,22,0,Durham,2022-11-11
2,5,3,2,0,Stokes,2022-11-11
0,4,2,2,0,Rowan,2022-11-11
1,4,4,0,0,Ashe,2022-11-11
3,6,2,4,0,Rockingham,2022-11-11
3,7,1,6,0,Harnett,2022-11-11
2,7,3,4,0,Onslow,2022-11-11
2,4,2,2,0,Columbus,2022-11-11
0,4,1,3,1,Lee,2022-11-11
0,1,0,1,0,Person,2022-11-11
17,94,13,81,0,Wake,2022-11-15
7,25,8,17,0,Pitt,2022-11-15
3,6,1,5,0,Lincoln,2022-11-15
1,9,4,5,0,Craven,2022-11-15
2,18,7,11,0,Catawba,2022-11-15
1,4,3,1,0,Ashe,2023-02-13
0,4,2,2,0,Pasquotank,2022-11-15
4,29,2,27,0,Durham,2022-11-15
45,180,55,125,0,Mecklenburg,2023-02-13
9,25,15,10,0,Wilkes,2023-02-13
2,2,0,2,0,Pamlico,2023-02-13
22,45,22,23,0,Robeson,2023-02-13
0,1,0,1,0,Edgecombe,2022-11-15
21,77,18,59,0,Forsyth,2023-02-13
6,21,4,17,0,Granville,2023-02-13
6,20,3,17,0,Burke,2023-02-13
0,10,4,6,1,Burke,2022-11-15
2,16,4,12,0,Caldwell,2022-11-15
10,24,13,11,0,Randolph,2023-02-13
11,75,16,59,0,Cumberland,2023-02-13
1,5,3,2,0,Richmond,2022-11-15
0,11,4,7,0,Moore,2022-11-15
1,13,3,10,0,Onslow,2022-11-15
0,12,4,8,0,New Hanover,2022-11-15
1,6,3,3,0,Sampson,2022-11-15
1,2,0,2,0,Person,2022-11-15
1,13,7,6,2,Craven,2023-02-13
0,2,0,2,0,Duplin,2022-11-15
0,4,2,2,0,Wilkes,2022-11-15
2,7,4,3,0,Alexander,2022-11-15
0,6,2,4,0,McDowell,2022-11-15
0,5,0,5,0,Cherokee,2022-11-15
6,36,6,30,0,Cabarrus,2022-11-16
7,22,13,9,1,Harnett,2022-11-16
2,24,6,18,0,Durham,2022-11-16
2,21,9,12,0,Harnett,2023-02-13
1,11,4,7,0,Brunswick,2022-11-16
2,10,3,7,0,Cleveland,2023-02-13
1,11,9,2,0,Polk,2022-11-16
3,6,1,5,0,Rutherford,2023-02-13
6,46,8,38,0,Cumberland,2022-11-16
1,10,3,7,0,Caldwell,2022-11-16
0,3,1,2,0,Bladen,2022-11-16
0,2,0,2,0,Madison,2022-11-16
1,10,1,9,0,Orange,2022-11-16
0,3,2,1,0,Caswell,2023-02-13
2,5,2,3,0,Person,2023-02-13
1,8,1,7,0,Burke,2022-11-16
0,2,0,2,0,Davie,2022-11-16
4,15,4,11,0,Bladen,2023-02-13
2,8,3,5,0,Columbus,2023-02-13
1,5,1,4,0,Cherokee,2022-11-16
0,6,2,4,0,Watauga,2022-11-16
0,3,1,2,0,Greene,2022-11-16
1,8,3,5,0,Currituck,2023-02-13
0,2,0,2,0,Warren,2022-11-11
3,7,2,5,0,Warren,2023-02-13
0,6,1,5,0,Rockingham,2022-11-15
1,5,4,1,0,Alleghany,2023-02-13
0,1,0,1,0,Swain,2022-11-15
1,2,0,2,0,Vance,2022-11-15
0,1,0,1,0,Perquimans,2022-11-15
0,6,4,2,0,Pasquotank,2023-02-13
1,1,0,1,0,Camden,2022-11-16
3,27,4,23,1,Onslow,2023-02-13
1,7,3,4,0,Nash,2022-11-16
4,11,1,10,0,Stanly,2023-02-13
0,3,3,0,0,Duplin,2022-11-16
0,5,1,4,0,Wilson,2022-11-16
0,4,2,2,0,Madison,2023-02-13
1,1,0,1,0,Jones,2023-02-13
5,33,10,23,1,Cumberland,2022-11-25
10,60,13,47,0,Guilford,2022-11-25
3,10,1,9,0,Rockingham,2022-11-25
3,7,2,5,0,Stokes,2022-11-25
3,35,1,34,1,Durham,2022-11-25
4,16,6,10,0,Harnett,2022-11-25
1,11,1,10,0,Onslow,2022-11-25
0,6,3,3,0,Haywood,2022-11-25
17,43,6,37,0,Rowan,2023-01-30
7,39,3,36,0,Davidson,2023-01-30
6,24,3,21,0,Hoke,2023-01-30
4,17,2,15,0,Yadkin,2023-01-30
5,16,6,10,1,Chatham,2023-01-30
28,124,46,78,2,Guilford,2023-01-30
5,21,6,15,0,Lincoln,2023-01-30
12,32,4,28,0,Caldwell,2023-01-30
2,10,4,6,0,Beaufort,2023-01-30
1,7,6,1,0,Jackson,2023-01-30
2,6,1,5,0,Cherokee,2023-01-30
1,11,4,7,0,McDowell,2023-01-30
2,10,1,9,0,Dare,2023-01-30
2,15,2,13,0,Pender,2023-01-30
2,23,2,21,0,Surry,2023-01-30
1,3,1,2,0,Madison,2023-01-30
6,10,1,9,0,Chowan,2023-01-30
0,9,3,6,0,Alexander,2023-01-30
0,2,1,1,0,Graham,2023-01-30
1,4,2,2,0,Rutherford,2023-01-30
4,7,6,1,0,Clay,2023-01-30
6,33,7,26,0,Cabarrus,2023-02-02
43,171,42,129,0,Wake,2023-02-02
4,16,12,4,0,Scotland,2023-02-02
5,27,8,19,0,Gaston,2023-02-02
6,26,9,17,1,New Hanover,2023-02-02
6,22,11,11,1,Nash,2023-02-02
10,46,7,39,1,Durham,2023-02-02
5,12,8,4,0,Richmond,2023-02-02
2,13,6,7,0,Moore,2023-02-02
11,28,16,12,0,Catawba,2023-02-02
7,19,5,14,0,Franklin,2023-02-02
2,8,1,7,0,Chatham,2023-02-02
7,17,1,16,0,Brunswick,2023-02-02
3,10,3,7,0,Carteret,2023-02-02
11,40,15,25,0,Union,2023-02-02
0,3,3,0,0,Polk,2023-02-02
3,29,1,28,0,Orange,2023-02-02
8,35,9,26,1,Rowan,2023-02-02
2,8,2,6,0,Stokes,2023-02-02
1,5,1,4,0,Washington,2023-02-02
2,6,4,2,0,Hertford,2023-02-02
0,5,3,2,0,Clay,2023-02-02
1,2,1,1,0,Graham,2023-02-02
0,2,1,1,0,Ashe,2023-02-02
2,14,1,13,0,Lenoir,2023-02-02
1,3,2,1,0,Washington,2023-01-06
0,3,2,1,0,Yancey,2023-01-06
2,4,0,4,0,Davie,2023-01-07
0,3,0,3,0,Macon,2023-01-07
2,6,5,1,0,Pasquotank,2023-01-11
0,2,0,2,0,Macon,2023-01-19
3,7,1,6,0,Franklin,2023-01-28
1,2,0,2,0,Chowan,2023-01-28
0,3,0,3,0,Cherokee,2023-01-28
0,1,0,1,0,Anson,2023-01-28
1,3,1,2,0,Martin,2023-01-30
1,3,2,1,0,Mitchell,2023-01-30
0,2,2,0,0,Cherokee,2023-02-02
18,86,6,80,1,Wake,2022-11-10
2,14,10,4,0,Henderson,2022-11-10
3,13,1,12,1,Caldwell,2022-11-10
2,5,2,3,0,Anson,2022-11-10
5,38,5,33,0,Durham,2022-11-10
3,15,0,15,0,Orange,2022-11-10
1,3,0,3,0,Macon,2022-11-10
3,24,6,18,0,Brunswick,2022-11-10
1,6,3,3,0,Bladen,2022-11-10
0,3,1,2,0,Craven,2022-11-10
3,24,1,23,0,Union,2022-11-10
12,86,13,73,0,Mecklenburg,2022-11-10
2,17,3,14,0,Burke,2022-11-10
1,3,0,3,0,Edgecombe,2022-11-10
1,4,1,3,0,Franklin,2022-11-10
2,5,1,4,0,Rutherford,2022-11-10
1,2,0,2,0,Davie,2022-11-10
2,5,2,3,0,Alexander,2022-11-10
4,8,5,3,0,Moore,2022-11-10
0,7,1,6,0,Watauga,2022-11-10
0,1,0,1,0,Washington,2022-11-10
0,1,1,0,0,Ashe,2022-11-10
6,55,5,50,0,Wake,2022-11-19
3,12,4,8,0,Cumberland,2022-11-19
4,15,5,10,0,Cabarrus,2022-11-19
0,2,0,2,0,Duplin,2022-11-19
0,6,2,4,0,Caldwell,2022-11-19
1,3,1,2,0,Harnett,2022-11-19
1,2,0,2,0,Pender,2022-11-19
1,4,2,2,0,Craven,2022-11-19
0,5,0,5,0,Orange,2022-11-19
0,7,5,2,0,Polk,2022-11-19
1,8,1,7,0,Brunswick,2022-11-19
2,4,2,2,0,Wilkes,2022-11-19
2,5,1,4,0,Wilson,2022-11-19
48,268,54,214,0,Mecklenburg,2022-11-29
4,12,2,10,1,Moore,2022-11-29
4,39,20,19,0,Buncombe,2022-11-29
1,4,0,4,0,Chowan,2022-11-29
8,65,16,49,0,Cabarrus,2022-11-29
2,5,0,5,0,Transylvania,2022-11-29
16,78,7,71,0,Durham,2022-11-29
9,19,1,18,0,Franklin,2022-11-29
5,20,5,15,1,Burke,2022-11-29
9,31,16,15,0,Wayne,2022-11-29
3,13,4,9,0,Wilson,2022-11-29
6,23,6,17,0,Henderson,2022-11-29
5,17,3,14,0,Caldwell,2022-11-29
1,6,0,6,0,Stanly,2022-11-29
1,9,1,8,0,Watauga,2022-11-29
1,5,2,3,0,Hertford,2022-11-29
4,9,6,3,0,Columbus,2022-11-29
1,8,0,8,0,Alexander,2022-11-29
0,2,1,1,0,Alleghany,2022-11-29
3,9,5,4,0,Davie,2023-02-21
6,21,2,19,0,Onslow,2023-02-21
3,5,1,4,0,Rutherford,2023-02-21
8,28,8,20,1,Pitt,2023-02-21
2,11,6,5,0,Sampson,2023-02-21
21,134,33,101,0,Mecklenburg,2023-02-21
14,33,20,13,1,Robeson,2023-02-21
3,23,6,17,0,Cabarrus,2023-02-21
3,5,2,3,0,Alexander,2023-02-21
2,4,1,3,0,Pasquotank,2023-02-21
4,13,2,11,0,Edgecombe,2023-02-21
1,9,3,6,1,Randolph,2023-02-21
2,18,4,14,0,Craven,2023-02-21
1,15,2,13,0,Orange,2023-02-21
1,2,1,1,0,Camden,2023-02-21
0,2,0,2,0,Warren,2023-02-21
0,6,2,4,0,Perquimans,2023-02-21
1,11,3,8,1,Lenoir,2023-02-21
1,5,2,3,0,Duplin,2023-02-21
1,10,2,8,0,Granville,2023-02-21
0,7,1,6,0,Transylvania,2023-02-21
4,9,4,5,0,Scotland,2023-02-21
1,3,1,2,0,Alleghany,2023-02-21
0,2,0,2,0,Clay,2023-02-21
30,148,33,115,1,Mecklenburg,2023-02-22
7,33,8,25,0,Pitt,2023-02-22
6,19,13,6,1,Robeson,2023-02-22
2,4,2,2,0,Person,2023-02-22
3,10,2,8,2,Craven,2023-02-22
1,3,1,2,0,Vance,2023-02-22
1,2,0,2,0,Madison,2023-02-22
8,44,7,37,2,Durham,2023-02-22
1,2,1,1,0,Scotland,2023-02-22
0,3,2,1,0,Pasquotank,2023-02-22
0,21,2,19,0,Orange,2023-02-22
0,5,1,4,0,Carteret,2023-02-22
4,16,2,14,0,Granville,2023-02-22
1,2,0,2,0,Alleghany,2023-02-22
3,10,4,6,0,Moore,2023-02-22
1,3,0,3,0,Edgecombe,2023-02-22
5,15,10,5,0,Wilkes,2023-02-23
6,21,2,19,0,Orange,2023-02-23
5,35,12,23,0,Buncombe,2023-02-23
8,22,8,14,0,Johnston,2023-02-23
8,29,8,21,0,Cabarrus,2023-02-23
17,45,20,25,0,Wayne,2023-02-23
9,30,9,21,0,Pitt,2023-02-23
3,11,4,7,0,Granville,2023-02-23
1,9,6,3,1,Duplin,2023-02-23
1,2,0,2,1,Hertford,2023-02-23
0,6,1,5,0,Vance,2023-02-23
2,3,0,3,0,Jones,2023-02-23
1,5,2,3,0,Scotland,2023-02-23
2,5,0,5,0,Macon,2023-02-23
14,91,15,76,1,Wake,2022-12-03
2,10,7,3,0,Halifax,2022-12-03
18,135,31,104,1,Mecklenburg,2022-12-03
3,7,6,1,0,Burke,2022-12-03
6,21,12,9,0,Buncombe,2022-12-03
3,26,10,16,0,Rowan,2022-12-03
2,6,0,6,0,Edgecombe,2023-02-23
2,8,0,8,0,Caldwell,2022-12-03
5,37,3,34,2,Durham,2022-12-03
0,5,1,4,0,Wayne,2022-12-03
2,7,0,7,0,Harnett,2022-12-03
3,19,5,14,0,Cabarrus,2022-12-03
0,13,4,9,0,Chatham,2022-12-03
1,9,2,7,0,Henderson,2022-12-03
3,7,1,6,0,Vance,2023-02-24
19,53,2,51,0,Lenoir,2023-02-24
11,23,11,12,0,Pitt,2023-02-24
3,8,2,6,0,Cleveland,2023-02-24
3,13,2,11,0,New Hanover,2023-02-24
5,18,5,13,0,Gaston,2023-02-24
3,8,7,1,0,Beaufort,2023-02-24
0,8,1,7,0,Rockingham,2023-02-24
1,5,4,1,0,Scotland,2023-02-24
0,1,0,1,0,Martin,2023-02-24
3,17,6,11,0,Catawba,2023-02-24
0,4,2,2,0,Richmond,2023-02-24
2,13,6,7,0,Davidson,2023-02-24
1,4,2,2,0,Watauga,2022-12-03
3,17,6,11,0,Union,2023-02-24
1,9,0,9,0,Orange,2023-02-24
10,56,21,35,0,Guilford,2023-02-24
0,4,0,4,0,Franklin,2023-02-24
0,6,6,0,0,Sampson,2023-02-24
4,11,7,4,0,Lincoln,2023-02-24
0,5,3,2,0,Pasquotank,2023-02-24
1,3,0,3,0,Chowan,2023-02-24
1,3,1,2,0,Craven,2023-02-24
0,5,1,4,0,Person,2023-02-24
2,15,6,9,0,Buncombe,2023-02-24
0,4,3,1,0,Swain,2023-02-24
0,5,0,5,0,Macon,2023-02-24
1,5,5,0,0,Lee,2023-02-25
8,29,3,26,0,Randolph,2023-02-25
2,7,1,6,1,Davie,2023-02-25
17,72,16,56,1,Mecklenburg,2023-02-25
2,8,5,3,0,Robeson,2023-02-25
3,14,5,9,0,Cumberland,2023-02-25
2,7,0,7,0,Onslow,2023-02-25
1,5,1,4,0,Orange,2023-02-25
6,19,3,16,0,Durham,2023-02-25
0,5,1,4,0,Craven,2023-02-25
0,5,1,4,0,Carteret,2023-02-25
1,2,0,2,0,Madison,2022-11-19
0,3,1,2,0,Nash,2022-11-19
0,1,0,1,0,Cherokee,2022-11-19
0,4,2,2,0,Hertford,2022-11-19
1,4,1,3,0,Hoke,2023-03-05
2,8,3,5,0,Cabarrus,2023-03-05
12,56,9,47,0,Mecklenburg,2023-03-05
8,41,5,36,1,Wake,2023-03-05
2,5,0,5,0,Carteret,2023-03-05
0,8,1,7,0,New Hanover,2023-03-05
0,3,0,3,0,Pasquotank,2023-03-05
0,1,0,1,0,Duplin,2023-03-05
1,5,1,4,0,Orange,2023-03-05
0,1,1,0,0,Perquimans,2023-03-05
0,5,2,3,0,Craven,2023-03-05
1,8,3,5,0,Catawba,2023-03-05
1,8,4,4,0,Union,2023-03-05
0,5,4,1,0,Wayne,2023-03-05
0,7,1,6,0,Moore,2023-03-05
1,3,0,3,0,Transylvania,2023-03-05
33,235,52,183,0,Wake,2022-12-08
8,18,4,14,0,Rutherford,2022-12-08
11,30,3,27,0,Brunswick,2022-12-08
5,21,13,8,0,Wilson,2022-12-08
3,6,1,5,0,Chowan,2022-12-08
5,8,1,7,0,Edgecombe,2022-12-08
5,16,5,11,0,Burke,2022-12-08
7,37,3,34,0,Orange,2022-12-08
2,18,8,10,0,Granville,2022-12-08
11,37,11,26,0,Pitt,2022-12-08
2,19,3,16,0,Caldwell,2022-12-08
4,40,24,16,1,Buncombe,2022-12-08
4,17,9,8,0,Johnston,2023-03-07
1,1,0,1,0,Transylvania,2023-03-07
3,8,3,5,0,Craven,2023-03-07
2,5,0,5,0,Granville,2023-03-07
0,3,1,2,1,Anson,2022-12-08
3,4,3,1,0,Hertford,2023-03-07
0,4,0,4,0,Dare,2022-12-08
5,31,13,18,0,Wilkes,2022-12-08
0,2,0,2,0,Caldwell,2023-03-07
4,24,14,10,0,Moore,2022-12-08
4,16,4,12,0,Cabarrus,2023-03-07
0,4,2,2,0,Sampson,2022-11-25
0,10,5,5,1,Randolph,2022-11-25
2,9,5,4,0,Lee,2022-11-25
0,2,0,2,0,Warren,2022-11-25
0,1,0,1,0,Avery,2022-11-25
0,7,5,2,0,Columbus,2022-11-25
5,11,0,11,0,Rowan,2023-02-18
5,16,2,14,0,Johnston,2023-02-18
3,12,9,3,0,Chatham,2023-02-18
3,11,2,9,0,Harnett,2023-02-18
1,1,0,1,0,Avery,2023-02-18
2,8,2,6,0,Wayne,2023-02-18
1,15,6,9,0,Cabarrus,2023-02-18
0,5,0,5,0,Stanly,2023-02-18
0,3,2,1,0,Person,2023-02-18
2,18,6,12,0,Randolph,2023-02-18
0,8,1,7,0,Onslow,2023-02-18
0,1,0,1,0,Northampton,2023-02-18
0,2,0,2,0,Mitchell,2023-02-18
1,3,3,0,0,Columbus,2023-02-18
1,5,1,4,0,Wilson,2023-02-18
2,5,2,3,0,Person,2023-02-20
5,7,4,3,0,Halifax,2023-02-20
12,72,26,46,1,Guilford,2023-02-20
4,30,20,10,0,Catawba,2023-02-20
14,44,8,36,0,Alamance,2023-02-20
10,30,10,20,0,Davidson,2023-02-20
4,10,6,4,0,Chatham,2023-02-20
3,14,3,11,0,Stokes,2023-02-20
7,14,1,13,0,Yadkin,2023-02-20
1,3,0,3,0,Beaufort,2023-02-20
2,2,0,2,0,Gates,2023-02-20
1,8,0,8,0,Richmond,2023-02-20
0,1,0,1,0,Mitchell,2023-02-20
2,15,1,14,1,New Hanover,2023-02-20
2,6,1,5,0,Montgomery,2023-02-20
0,7,5,2,0,Haywood,2023-02-20
5,17,3,14,0,Rockingham,2022-12-07
2,3,1,2,0,Person,2022-12-07
7,19,5,14,1,Brunswick,2022-12-07
19,89,32,57,0,Guilford,2022-12-07
10,73,5,68,0,Durham,2022-12-07
2,17,8,9,0,Burke,2022-12-07
11,29,5,24,0,Pitt,2022-12-07
5,38,22,16,0,Catawba,2022-12-07
3,12,6,6,0,Haywood,2022-12-07
5,10,8,2,0,Sampson,2022-12-07
7,47,16,31,0,New Hanover,2022-12-07
2,9,6,3,0,Lee,2022-12-07
3,12,6,6,0,Vance,2022-12-07
5,12,4,8,0,Bladen,2022-12-07
3,27,6,21,0,Harnett,2022-12-07
13,84,24,60,0,Cumberland,2022-12-07
1,10,4,6,0,Columbus,2022-12-07
3,13,3,10,0,Davie,2022-12-07
2,24,9,15,0,Randolph,2022-12-07
0,3,0,3,0,Currituck,2022-12-07
7,23,4,19,0,Caldwell,2022-12-07
0,12,5,7,0,Watauga,2022-12-07
5,28,2,26,0,Onslow,2022-12-07
0,2,1,1,0,Jones,2022-12-07
1,8,3,5,0,Warren,2022-12-07
1,3,2,1,0,Cherokee,2022-12-07
1,1,1,0,0,Bladen,2023-03-06
1,12,1,11,0,Burke,2023-03-06
7,17,11,6,0,Catawba,2023-03-06
8,28,3,25,1,Durham,2023-03-06
5,13,4,9,0,Pitt,2023-03-06
2,9,4,5,0,Robeson,2023-03-06
2,6,2,4,0,Davie,2023-03-06
5,20,5,15,0,Cabarrus,2023-03-06
1,8,3,5,0,Randolph,2023-03-06
1,10,3,7,0,Caldwell,2023-03-06
0,1,0,1,0,Currituck,2023-03-06
0,2,0,2,0,Columbus,2023-03-06
0,3,2,1,1,Sampson,2023-03-06
1,3,0,3,0,Vance,2023-03-06
2,9,2,7,0,Brunswick,2023-03-06
0,2,0,2,1,Warren,2023-03-06
5,15,1,14,0,Onslow,2023-03-06
2,3,2,1,0,Transylvania,2023-03-06
0,5,0,5,0,Burke,2023-03-10
2,32,9,23,1,Guilford,2023-03-10
0,2,1,1,0,Davie,2022-11-25
2,3,1,2,0,Person,2022-11-25
1,7,6,1,0,Madison,2022-11-25
1,7,4,3,0,Sampson,2023-03-10
4,16,1,15,0,Durham,2023-03-10
2,14,3,11,0,Brunswick,2023-03-10
0,2,1,1,0,Hertford,2023-03-10
0,4,1,3,0,Person,2023-03-10
1,7,3,4,0,Harnett,2023-03-10
1,5,1,4,0,Caldwell,2023-03-10
1,6,1,5,0,Onslow,2023-03-10
2,5,2,3,0,Currituck,2023-03-10
1,3,1,2,0,Haywood,2023-03-10
1,6,4,2,0,Columbus,2023-03-10
1,1,1,0,0,Scotland,2023-03-12
1,1,0,1,0,McDowell,2023-03-12
7,34,4,30,1,Mecklenburg,2023-03-12
1,3,2,1,1,Catawba,2023-03-12
0,3,1,2,0,Robeson,2023-03-12
0,13,0,13,0,Durham,2023-03-12
0,2,0,2,0,Pitt,2023-03-12
0,11,4,7,0,Cumberland,2023-03-12
1,3,0,3,0,Brunswick,2023-03-12
1,4,4,0,0,Person,2023-03-12
2,6,4,2,0,Carteret,2023-03-12
0,2,0,2,0,Ashe,2023-03-12
4,7,4,3,0,Chatham,2023-03-14
7,34,15,19,0,Guilford,2023-03-14
1,1,1,0,0,Haywood,2023-03-14
6,14,11,3,0,Catawba,2023-03-14
4,12,7,5,0,New Hanover,2023-03-14
7,15,6,9,1,Davidson,2023-03-14
2,2,1,1,0,Currituck,2023-03-14
2,11,1,10,0,Union,2023-03-14
2,4,0,4,0,Rockingham,2023-03-14
2,7,0,7,0,Stokes,2023-03-14
5,31,2,29,0,Durham,2023-03-14
8,34,9,25,0,Forsyth,2023-03-14
0,7,5,2,0,Scotland,2023-03-14
1,2,0,2,0,Yadkin,2023-03-14
1,11,3,8,0,Rowan,2023-03-14
7,21,4,17,0,Durham,2023-03-16
9,34,12,22,1,Guilford,2023-03-16
5,15,15,0,0,Currituck,2023-03-16
4,13,2,11,0,New Hanover,2023-03-16
2,5,2,3,0,Rockingham,2023-03-16
1,4,3,1,0,Madison,2023-03-16
7,13,8,5,0,Catawba,2023-03-16
0,7,2,5,0,Burke,2023-03-16
2,17,5,12,1,Johnston,2023-03-16
4,10,6,4,0,Caldwell,2023-03-16
1,6,2,4,0,Stokes,2023-03-16
3,8,2,6,2,Onslow,2023-03-16
2,5,3,2,0,Haywood,2023-03-16
0,1,1,0,0,Sampson,2023-03-16
2,6,2,4,1,Iredell,2023-03-19
1,7,2,5,0,Durham,2023-03-19
6,15,4,11,0,Rowan,2023-03-19
3,7,0,7,0,Johnston,2023-03-19
2,9,0,9,0,Robeson,2023-03-19
1,5,3,2,0,Henderson,2023-03-19
1,10,3,7,0,Orange,2023-03-19
2,4,4,0,1,Montgomery,2023-03-19
1,5,1,4,0,Onslow,2023-03-19
2,6,1,5,1,Union,2023-03-25
1,4,2,2,0,Pitt,2023-03-25
1,2,0,2,0,Edgecombe,2023-03-25
1,2,0,2,0,Granville,2023-02-18
1,2,1,1,0,Montgomery,2023-02-18
1,2,0,2,0,Halifax,2023-02-18
2,6,3,3,0,Rockingham,2023-02-20
1,3,0,3,0,Northampton,2023-02-20
2,5,2,3,0,Jackson,2023-02-20
2,2,0,2,0,New Hanover,2023-03-25
0,3,3,0,0,Catawba,2023-03-25
0,14,4,10,0,Durham,2023-03-25
1,4,1,3,0,Lincoln,2023-03-25
1,2,1,1,0,Surry,2023-03-25
0,6,4,2,0,Richmond,2023-03-25
4,11,3,8,0,Brunswick,2023-03-25
0,3,0,3,0,Duplin,2023-03-25
5,16,0,16,0,Onslow,2023-03-29
5,20,4,16,0,Cumberland,2023-03-29
2,6,1,5,0,Harnett,2023-03-29
4,21,2,19,0,Durham,2023-03-29
2,8,1,7,0,Wayne,2023-03-29
2,16,3,13,0,Brunswick,2023-03-29
1,3,1,2,1,Burke,2023-03-29
0,3,2,1,0,Caldwell,2023-03-29
1,5,4,1,0,Sampson,2023-03-29
0,1,0,1,0,Bladen,2023-03-29
0,12,6,6,0,Cabarrus,2023-03-29
1,1,0,1,0,Stanly,2023-03-30
1,2,0,2,0,Warren,2023-03-30
7,23,8,15,0,Cumberland,2023-03-30
1,4,0,4,0,Burke,2023-03-30
0,2,0,2,0,Halifax,2023-03-30
0,5,3,2,0,Johnston,2023-03-30
1,10,6,4,0,Cabarrus,2023-03-30
0,5,2,3,0,Henderson,2023-03-30
2,6,2,4,0,Davidson,2023-03-30
1,6,2,4,0,Alamance,2023-03-30
0,1,0,1,0,Columbus,2023-03-30
5,16,1,15,0,Stanly,2022-12-15
14,44,19,25,0,Wayne,2022-12-15
12,28,7,21,0,Rockingham,2022-12-15
14,54,12,42,0,Cabarrus,2022-12-15
5,15,6,9,0,Davie,2022-12-15
6,20,6,14,0,Henderson,2022-12-15
12,69,9,60,1,Durham,2022-12-15
15,43,24,19,0,Robeson,2022-12-15
1,8,3,5,0,Halifax,2022-12-15
4,28,3,25,0,Onslow,2022-12-15
1,3,1,2,0,Person,2023-04-03
13,52,21,31,0,Mecklenburg,2023-04-03
3,13,4,9,0,Davidson,2023-04-03
11,36,6,30,0,Durham,2023-04-03
1,5,0,5,0,Orange,2023-04-03
1,6,2,4,0,Wilkes,2023-04-03
2,18,8,10,0,Buncombe,2023-04-03
3,6,2,4,0,Lincoln,2023-04-03
3,9,5,4,0,Craven,2023-04-03
1,3,3,0,0,Madison,2023-04-03
2,5,3,2,0,Alleghany,2022-12-15
1,5,2,3,0,Vance,2023-04-03
0,3,3,0,0,Scotland,2023-04-03
0,2,1,1,0,McDowell,2023-04-03
2,6,2,4,0,Warren,2022-12-15
1,11,3,8,0,Craven,2022-12-15
0,1,1,0,0,Jones,2022-12-15
21,80,7,73,0,Durham,2022-12-16
1,2,0,2,0,Warren,2022-12-16
15,37,26,11,0,Robeson,2022-12-16
49,309,61,248,1,Mecklenburg,2022-12-16
10,35,20,15,0,Randolph,2022-12-16
18,114,31,83,0,Cumberland,2022-12-16
15,56,11,45,0,Johnston,2022-12-16
1,6,2,4,0,Pasquotank,2022-12-16
1,2,2,0,0,Alleghany,2022-12-16
5,21,14,7,0,Carteret,2022-12-16
5,31,8,23,0,Pitt,2022-12-16
2,6,3,3,1,Bladen,2022-12-16
2,13,2,11,0,Lee,2022-12-16
1,10,4,6,0,Person,2022-12-16
3,11,3,8,0,Vance,2022-12-16
1,4,2,2,0,Ashe,2022-12-16
1,9,2,7,0,Granville,2022-12-16
3,14,0,14,0,Edgecombe,2022-12-16
4,24,6,18,0,Harnett,2022-12-16
0,7,5,2,0,Columbus,2022-12-16
3,9,6,3,0,Scotland,2022-12-16
1,3,1,2,0,Madison,2022-12-16
3,5,3,2,0,Haywood,2023-04-14
7,21,6,15,0,Guilford,2023-04-14
1,4,2,2,0,Chatham,2023-04-14
4,8,5,3,0,Gaston,2023-04-14
0,2,1,1,0,Rockingham,2023-04-14
0,9,1,8,0,Rowan,2023-04-14
0,4,1,3,0,Robeson,2023-04-14
1,6,1,5,0,Iredell,2023-04-14
0,1,1,0,0,Avery,2023-04-14
0,2,0,2,0,Onslow,2023-04-14
0,8,7,1,0,Craven,2023-04-14
1,2,0,2,0,Hyde,2023-04-14
3,4,0,4,0,Lee,2023-04-17
2,9,5,4,0,Rockingham,2023-04-17
0,4,1,3,0,Sampson,2023-04-17
1,6,1,5,0,Robeson,2023-04-17
1,8,0,8,0,Caldwell,2023-04-17
1,6,4,2,0,Randolph,2023-04-17
1,4,0,4,0,Harnett,2023-04-17
3,16,1,15,0,Cumberland,2023-04-17
2,8,0,8,0,Brunswick,2023-04-17
1,5,0,5,0,Onslow,2023-04-17
3,12,2,10,0,Caldwell,2022-12-18
1,2,1,1,0,Halifax,2022-12-18
24,84,18,66,0,Forsyth,2022-12-18
2,9,3,6,0,Pitt,2022-12-18
2,4,0,4,0,Cherokee,2022-12-18
14,72,30,42,1,Cumberland,2022-12-18
2,5,0,5,0,Currituck,2022-12-18
5,30,14,16,0,Randolph,2022-12-18
2,14,1,13,0,Rockingham,2022-12-18
4,15,10,5,0,Wilkes,2022-12-18
2,9,2,7,0,Bladen,2022-12-18
2,17,7,10,0,Craven,2022-12-18
1,4,1,3,0,Anson,2022-12-18
6,28,12,16,0,Robeson,2022-12-18
2,22,7,15,2,Nash,2022-12-18
8,54,1,53,0,Durham,2022-12-18
9,30,8,22,0,Cabarrus,2022-12-18
2,12,4,8,0,Granville,2022-12-18
0,8,5,3,0,Transylvania,2022-12-18
2,14,5,9,0,Henderson,2022-12-18
0,2,0,2,0,Jones,2022-12-18
0,3,1,2,0,Pasquotank,2022-12-18
58,250,37,213,1,Wake,2023-01-09
8,16,8,8,1,Alexander,2023-01-09
7,36,8,28,1,Brunswick,2023-01-09
7,32,8,24,0,Moore,2023-01-09
8,19,5,14,0,McDowell,2023-01-09
7,23,8,15,0,Nash,2023-01-09
12,30,20,10,0,Wilkes,2023-01-09
7,21,6,15,0,Davie,2023-01-09
6,19,9,10,0,Rutherford,2023-01-09
4,35,11,24,0,Orange,2023-01-09
18,85,33,52,0,Cabarrus,2023-01-09
13,40,31,9,0,Catawba,2023-01-09
13,60,22,38,0,Davidson,2023-01-09
11,45,12,33,0,New Hanover,2023-01-09
6,8,5,3,0,Hertford,2023-01-09
8,25,3,22,0,Franklin,2023-01-09
4,22,6,16,0,Pender,2023-01-09
24,68,10,58,0,Union,2023-01-09
4,14,2,12,0,Richmond,2023-01-09
3,18,6,12,0,Yadkin,2023-01-09
1,9,7,2,0,Polk,2023-01-09
3,6,3,3,0,Yancey,2023-01-09
2,9,8,1,0,Swain,2023-01-09
2,12,0,12,0,Chowan,2023-01-09
0,1,0,1,0,Martin,2023-01-09
7,38,12,26,0,Craven,2023-01-09
5,11,2,9,0,Hoke,2023-01-09
1,8,2,6,0,Macon,2023-01-09
5,21,11,10,0,Duplin,2023-01-09
1,3,2,1,0,Cherokee,2023-01-09
53,250,57,193,0,Mecklenburg,2023-01-10
10,57,9,48,0,Onslow,2023-01-10
20,91,8,83,1,Durham,2023-01-10
3,25,18,7,0,Sampson,2023-01-10
9,59,28,31,1,Buncombe,2023-01-10
9,34,14,20,0,Catawba,2023-01-10
7,16,5,11,0,Burke,2023-01-10
7,27,15,12,0,Davie,2023-01-10
3,14,0,14,0,Bladen,2023-01-10
8,39,7,32,0,Moore,2023-01-10
2,11,3,8,2,Vance,2023-01-10
7,41,9,32,0,New Hanover,2023-01-10
5,13,7,6,1,Haywood,2023-01-10
2,7,3,4,0,Hertford,2023-01-10
0,13,3,10,0,Rutherford,2023-01-10
0,1,1,0,1,Ashe,2023-01-10
1,8,1,7,0,Warren,2023-01-10
6,20,5,15,1,Pitt,2023-01-14
21,152,26,126,0,Wake,2023-01-14
7,13,2,11,0,Cleveland,2023-01-14
6,16,2,14,0,Brunswick,2023-01-14
3,8,3,5,0,Hoke,2023-01-14
2,9,3,6,1,Franklin,2023-01-14
8,13,6,7,0,Wilson,2023-01-14
2,15,3,12,0,Surry,2023-01-14
2,15,3,12,0,Caldwell,2023-01-14
1,4,2,2,0,Pasquotank,2023-01-14
4,19,8,11,1,Buncombe,2023-01-14
0,8,0,8,1,Edgecombe,2023-01-14
0,6,1,5,0,Jackson,2023-01-14
5,12,4,8,3,Rutherford,2023-01-14
0,7,3,4,0,Sampson,2023-01-14
3,7,0,7,0,Stanly,2023-01-21
4,12,1,11,0,Chatham,2023-01-21
6,16,3,13,0,Orange,2023-01-21
7,23,13,10,0,Robeson,2023-01-21
12,44,7,37,0,Durham,2023-01-21
,0,0,0,0,Alexander,2022-11-12
,0,0,0,0,Alexander,2022-11-13
,0,0,0,0,Alexander,2023-02-03
,0,0,0,0,Alexander,2023-02-26
,0,0,0,0,Alexander,2023-03-12
,0,0,0,0,Alexander,2023-03-24
,0,0,0,0,Alexander,2023-03-25
,0,0,0,0,Alexander,2023-03-29
,0,0,0,0,Alexander,2023-03-31
,0,0,0,0,Alexander,2023-04-01
,0,0,0,0,Alexander,2023-04-02
,0,0,0,0,Alexander,2023-04-03
,0,0,0,0,Alexander,2023-04-09
,0,0,0,0,Alexander,2023-04-12
,0,0,0,0,Alexander,2023-04-13
,0,0,0,0,Alexander,2023-04-15
,0,0,0,0,Alexander,2023-04-16
,0,0,0,0,Alexander,2023-04-18
,0,0,0,0,Alexander,2023-04-22
,0,0,0,0,Alexander,2023-04-23
,0,0,0,0,Alexander,2023-04-24
,0,0,0,0,Alexander,2023-04-25
,0,0,0,0,Alexander,2023-04-26
,0,0,0,0,Alexander,2023-04-29
,0,0,0,0,Alexander,2023-05-03
,0,0,0,0,Alexander,2023-05-05
,0,0,0,0,Alexander,2023-05-06
,0,0,0,0,Alleghany,2022-11-15
,0,0,0,0,Alleghany,2022-11-19
,0,0,0,0,Alleghany,2022-11-20
,0,0,0,0,Alleghany,2022-11-21
,0,0,0,0,Alleghany,2022-12-05
,0,0,0,0,Alleghany,2022-12-07
,0,0,0,0,Alleghany,2022-12-11
,0,0,0,0,Alleghany,2022-12-31
,0,0,0,0,Alleghany,2023-01-11
,0,0,0,0,Alleghany,2023-01-15
,0,0,0,0,Alleghany,2023-01-21
,0,0,0,0,Alleghany,2023-01-24
,0,0,0,0,Alleghany,2023-02-04
,0,0,0,0,Alleghany,2023-02-07
,0,0,0,0,Alleghany,2023-02-17
,0,0,0,0,Alleghany,2023-02-20
,0,0,0,0,Alleghany,2023-02-23
,0,0,0,0,Alleghany,2023-02-25
,0,0,0,0,Alleghany,2023-02-26
,0,0,0,0,Alleghany,2023-03-01
,0,0,0,0,Alleghany,2023-03-05
,0,0,0,0,Alleghany,2023-03-08
,0,0,0,0,Alleghany,2023-03-09
,0,0,0,0,Alleghany,2023-03-10
,0,0,0,0,Alleghany,2023-03-11
,0,0,0,0,Alleghany,2023-03-12
,0,0,0,0,Alleghany,2023-03-14
,0,0,0,0,Alleghany,2023-03-15
,0,0,0,0,Alleghany,2023-03-16
,0,0,0,0,Alleghany,2023-03-18
,0,0,0,0,Alleghany,2023-03-19
,0,0,0,0,Alleghany,2023-03-25
,0,0,0,0,Alleghany,2023-03-27
,0,0,0,0,Alleghany,2023-03-31
,0,0,0,0,Alleghany,2023-04-01
,0,0,0,0,Alleghany,2023-04-02
,0,0,0,0,Alleghany,2023-04-08
,0,0,0,0,Alleghany,2023-04-09
,0,0,0,0,Alleghany,2023-04-10
,0,0,0,0,Alleghany,2023-04-11
,0,0,0,0,Alleghany,2023-04-13
,0,0,0,0,Alleghany,2023-04-14
,0,0,0,0,Alleghany,2023-04-15
,0,0,0,0,Alleghany,2023-04-16
,0,0,0,0,Alleghany,2023-04-17
,0,0,0,0,Alleghany,2023-04-18
,0,0,0,0,Alleghany,2023-04-19
,0,0,0,0,Alleghany,2023-04-20
,0,0,0,0,Alleghany,2023-04-21
,0,0,0,0,Alleghany,2023-04-22
,0,0,0,0,Alleghany,2023-04-23
,0,0,0,0,Alleghany,2023-04-24
,0,0,0,0,Alleghany,2023-04-25
,0,0,0,0,Alleghany,2023-04-26
,0,0,0,0,Alleghany,2023-04-27
,0,0,0,0,Alleghany,2023-04-28
,0,0,0,0,Alleghany,2023-04-29
,0,0,0,0,Alleghany,2023-04-30
,0,0,0,0,Alleghany,2023-05-01
,0,0,0,0,Alleghany,2023-05-02
,0,0,0,0,Alleghany,2023-05-03
,0,0,0,0,Alleghany,2023-05-04
,0,0,0,0,Alleghany,2023-05-05
,0,0,0,0,Alleghany,2023-05-06
,0,0,0,0,Anson,2022-11-12
,0,0,0,0,Anson,2022-11-20
,0,0,0,0,Anson,2022-11-22
,0,0,0,0,Anson,2022-11-26
,0,0,0,0,Anson,2022-11-28
,0,0,0,0,Anson,2023-01-08
,0,0,0,0,Anson,2023-02-23
,0,0,0,0,Anson,2023-02-25
,0,0,0,0,Anson,2023-02-27
,0,0,0,0,Anson,2023-03-01
,0,0,0,0,Anson,2023-03-05
,0,0,0,0,Anson,2023-03-15
,0,0,0,0,Anson,2023-03-17
,0,0,0,0,Anson,2023-03-22
,0,0,0,0,Anson,2023-03-24
,0,0,0,0,Anson,2023-03-25
,0,0,0,0,Anson,2023-03-26
,0,0,0,0,Anson,2023-03-27
,0,0,0,0,Anson,2023-03-28
,0,0,0,0,Anson,2023-03-30
,0,0,0,0,Anson,2023-04-05
,0,0,0,0,Anson,2023-04-13
,0,0,0,0,Anson,2023-04-15
,0,0,0,0,Anson,2023-04-18
,0,0,0,0,Anson,2023-04-21
,0,0,0,0,Anson,2023-04-22
,0,0,0,0,Anson,2023-04-23
,0,0,0,0,Anson,2023-04-24
,0,0,0,0,Anson,2023-04-26
,0,0,0,0,Anson,2023-04-29
,0,0,0,0,Anson,2023-04-30
,0,0,0,0,Anson,2023-05-03
,0,0,0,0,Anson,2023-05-04
,0,0,0,0,Anson,2023-05-06
,0,0,0,0,Ashe,2022-11-23
,0,0,0,0,Ashe,2022-11-26
,0,0,0,0,Ashe,2022-12-25
,0,0,0,0,Ashe,2023-01-27
,0,0,0,0,Ashe,2023-02-17
,0,0,0,0,Ashe,2023-02-22
,0,0,0,0,Ashe,2023-02-27
,0,0,0,0,Ashe,2023-03-05
,0,0,0,0,Ashe,2023-03-16
,0,0,0,0,Ashe,2023-03-23
,0,0,0,0,Ashe,2023-03-24
,0,0,0,0,Ashe,2023-03-26
,0,0,0,0,Ashe,2023-03-28
,0,0,0,0,Ashe,2023-03-31
,0,0,0,0,Ashe,2023-04-01
,0,0,0,0,Ashe,2023-04-02
,0,0,0,0,Ashe,2023-04-03
,0,0,0,0,Ashe,2023-04-04
,0,0,0,0,Ashe,2023-04-06
,0,0,0,0,Ashe,2023-04-07
,0,0,0,0,Ashe,2023-04-08
,0,0,0,0,Ashe,2023-04-10
,0,0,0,0,Ashe,2023-04-11
,0,0,0,0,Ashe,2023-04-12
,0,0,0,0,Ashe,2023-04-14
,0,0,0,0,Ashe,2023-04-15
,0,0,0,0,Ashe,2023-04-18
,0,0,0,0,Ashe,2023-04-19
,0,0,0,0,Ashe,2023-04-21
,0,0,0,0,Ashe,2023-04-22
,0,0,0,0,Ashe,2023-04-23
,0,0,0,0,Ashe,2023-04-26
,0,0,0,0,Ashe,2023-04-27
,0,0,0,0,Ashe,2023-04-30
,0,0,0,0,Ashe,2023-05-01
,0,0,0,0,Ashe,2023-05-03
,0,0,0,0,Ashe,2023-05-05
,0,0,0,0,Ashe,2023-05-06
,0,0,0,0,Avery,2022-11-11
,0,0,0,0,Avery,2022-11-15
,0,0,0,0,Avery,2022-11-17
,0,0,0,0,Avery,2022-11-19
,0,0,0,0,Avery,2022-11-20
,0,0,0,0,Avery,2022-11-24
,0,0,0,0,Avery,2022-11-27
,0,0,0,0,Avery,2022-11-28
,0,0,0,0,Avery,2022-11-30
,0,0,0,0,Avery,2022-12-02
,0,0,0,0,Avery,2022-12-04
,0,0,0,0,Avery,2022-12-16
,0,0,0,0,Avery,2023-01-03
,0,0,0,0,Avery,2023-01-06
,0,0,0,0,Avery,2023-01-11
,0,0,0,0,Avery,2023-01-14
,0,0,0,0,Avery,2023-01-16
,0,0,0,0,Avery,2023-01-29
,0,0,0,0,Avery,2023-01-31
,0,0,0,0,Avery,2023-02-03
,0,0,0,0,Avery,2023-02-04
,0,0,0,0,Avery,2023-02-06
,0,0,0,0,Avery,2023-02-07
,0,0,0,0,Avery,2023-02-08
,0,0,0,0,Avery,2023-02-12
,0,0,0,0,Avery,2023-02-13
,0,0,0,0,Avery,2023-02-14
,0,0,0,0,Avery,2023-02-16
,0,0,0,0,Avery,2023-02-19
,0,0,0,0,Avery,2023-02-23
,0,0,0,0,Avery,2023-02-25
,0,0,0,0,Avery,2023-02-26
,0,0,0,0,Avery,2023-02-27
,0,0,0,0,Avery,2023-02-28
,0,0,0,0,Avery,2023-03-02
,0,0,0,0,Avery,2023-03-03
,0,0,0,0,Avery,2023-03-04
,0,0,0,0,Avery,2023-03-08
,0,0,0,0,Avery,2023-03-09
,0,0,0,0,Avery,2023-03-10
,0,0,0,0,Avery,2023-03-11
,0,0,0,0,Avery,2023-03-13
,0,0,0,0,Avery,2023-03-14
,0,0,0,0,Avery,2023-03-18
,0,0,0,0,Avery,2023-03-19
,0,0,0,0,Avery,2023-03-20
,0,0,0,0,Avery,2023-03-23
,0,0,0,0,Avery,2023-03-25
,0,0,0,0,Avery,2023-03-26
,0,0,0,0,Avery,2023-03-27
,0,0,0,0,Avery,2023-03-28
,0,0,0,0,Avery,2023-03-30
,0,0,0,0,Avery,2023-04-01
,0,0,0,0,Avery,2023-04-02
,0,0,0,0,Avery,2023-04-03
,0,0,0,0,Avery,2023-04-06
,0,0,0,0,Avery,2023-04-07
,0,0,0,0,Avery,2023-04-08
,0,0,0,0,Avery,2023-04-11
,0,0,0,0,Avery,2023-04-15
,0,0,0,0,Avery,2023-04-16
,0,0,0,0,Avery,2023-04-17
,0,0,0,0,Avery,2023-04-19
,0,0,0,0,Avery,2023-04-20
,0,0,0,0,Avery,2023-04-21
,0,0,0,0,Avery,2023-04-22
,0,0,0,0,Avery,2023-04-24
,0,0,0,0,Avery,2023-04-25
,0,0,0,0,Avery,2023-04-27
,0,0,0,0,Avery,2023-04-29
,0,0,0,0,Avery,2023-04-30
,0,0,0,0,Avery,2023-05-01
,0,0,0,0,Avery,2023-05-02
,0,0,0,0,Avery,2023-05-03
,0,0,0,0,Avery,2023-05-04
,0,0,0,0,Avery,2023-05-05
,0,0,0,0,Avery,2023-05-06
,0,0,0,0,Beaufort,2022-11-15
,0,0,0,0,Beaufort,2022-11-24
,0,0,0,0,Beaufort,2023-02-11
,0,0,0,0,Beaufort,2023-03-11
,0,0,0,0,Beaufort,2023-03-14
,0,0,0,0,Beaufort,2023-03-18
,0,0,0,0,Beaufort,2023-03-19
,0,0,0,0,Beaufort,2023-03-31
,0,0,0,0,Beaufort,2023-04-01
,0,0,0,0,Beaufort,2023-04-08
,0,0,0,0,Beaufort,2023-04-09
,0,0,0,0,Beaufort,2023-04-12
,0,0,0,0,Beaufort,2023-04-14
,0,0,0,0,Beaufort,2023-04-16
,0,0,0,0,Beaufort,2023-04-21
,0,0,0,0,Beaufort,2023-04-22
,0,0,0,0,Beaufort,2023-04-23
,0,0,0,0,Beaufort,2023-04-24
,0,0,0,0,Beaufort,2023-04-26
,0,0,0,0,Beaufort,2023-04-29
,0,0,0,0,Beaufort,2023-05-02
,0,0,0,0,Beaufort,2023-05-04
,0,0,0,0,Beaufort,2023-05-05
,0,0,0,0,Beaufort,2023-05-06
,0,0,0,0,Bertie,2022-11-11
,0,0,0,0,Bertie,2022-11-13
,0,0,0,0,Bertie,2022-11-18
,0,0,0,0,Bertie,2022-11-19
,0,0,0,0,Bertie,2022-11-20
,0,0,0,0,Bertie,2022-11-24
,0,0,0,0,Bertie,2022-11-25
,0,0,0,0,Bertie,2022-11-30
,0,0,0,0,Bertie,2023-01-14
,0,0,0,0,Bertie,2023-02-18
,0,0,0,0,Bertie,2023-02-20
,0,0,0,0,Bertie,2023-02-23
,0,0,0,0,Bertie,2023-03-02
,0,0,0,0,Bertie,2023-03-03
,0,0,0,0,Bertie,2023-03-14
,0,0,0,0,Bertie,2023-03-15
,0,0,0,0,Bertie,2023-03-16
,0,0,0,0,Bertie,2023-03-17
,0,0,0,0,Bertie,2023-03-19
,0,0,0,0,Bertie,2023-03-20
,0,0,0,0,Bertie,2023-03-22
,0,0,0,0,Bertie,2023-03-25
,0,0,0,0,Bertie,2023-03-28
,0,0,0,0,Bertie,2023-03-31
,0,0,0,0,Bertie,2023-04-01
,0,0,0,0,Bertie,2023-04-04
,0,0,0,0,Bertie,2023-04-05
,0,0,0,0,Bertie,2023-04-06
,0,0,0,0,Bertie,2023-04-07
,0,0,0,0,Bertie,2023-04-08
,0,0,0,0,Bertie,2023-04-09
,0,0,0,0,Bertie,2023-04-13
,0,0,0,0,Bertie,2023-04-14
,0,0,0,0,Bertie,2023-04-15
,0,0,0,0,Bertie,2023-04-16
,0,0,0,0,Bertie,2023-04-17
,0,0,0,0,Bertie,2023-04-18
,0,0,0,0,Bertie,2023-04-19
,0,0,0,0,Bertie,2023-04-20
,0,0,0,0,Bertie,2023-04-22
,0,0,0,0,Bertie,2023-04-23
,0,0,0,0,Bertie,2023-04-24
,0,0,0,0,Bertie,2023-04-26
,0,0,0,0,Bertie,2023-04-28
,0,0,0,0,Bertie,2023-04-30
,0,0,0,0,Bertie,2023-05-02
,0,0,0,0,Bertie,2023-05-03
,0,0,0,0,Bertie,2023-05-04
,0,0,0,0,Bertie,2023-05-05
,0,0,0,0,Bertie,2023-05-06
,0,0,0,0,Bladen,2022-11-13
,0,0,0,0,Bladen,2022-11-18
,0,0,0,0,Bladen,2022-11-20
,0,0,0,0,Bladen,2023-02-25
,0,0,0,0,Bladen,2023-03-10
,0,0,0,0,Bladen,2023-03-11
,0,0,0,0,Bladen,2023-03-18
,0,0,0,0,Bladen,2023-03-20
,0,0,0,0,Bladen,2023-03-26
,0,0,0,0,Bladen,2023-03-27
,0,0,0,0,Bladen,2023-03-31
,0,0,0,0,Bladen,2023-04-01
,0,0,0,0,Bladen,2023-04-02
,0,0,0,0,Bladen,2023-04-04
,0,0,0,0,Bladen,2023-04-07
,0,0,0,0,Bladen,2023-04-08
,0,0,0,0,Bladen,2023-04-09
,0,0,0,0,Bladen,2023-04-10
,0,0,0,0,Bladen,2023-04-12
,0,0,0,0,Bladen,2023-04-13
,0,0,0,0,Bladen,2023-04-14
,0,0,0,0,Bladen,2023-04-15
,0,0,0,0,Bladen,2023-04-17
,0,0,0,0,Bladen,2023-04-21
,0,0,0,0,Bladen,2023-04-22
,0,0,0,0,Bladen,2023-04-23
,0,0,0,0,Bladen,2023-04-28
,0,0,0,0,Bladen,2023-05-02
,0,0,0,0,Bladen,2023-05-03
,0,0,0,0,Bladen,2023-05-04
,0,0,0,0,Burke,2023-03-11
,0,0,0,0,Burke,2023-04-09
,0,0,0,0,Burke,2023-04-18
,0,0,0,0,Burke,2023-04-29
,0,0,0,0,Caldwell,2023-05-06
,0,0,0,0,Camden,2022-11-09
,0,0,0,0,Camden,2022-11-11
,0,0,0,0,Camden,2022-11-14
,0,0,0,0,Camden,2022-11-17
,0,0,0,0,Camden,2022-11-19
,0,0,0,0,Camden,2022-11-20
,0,0,0,0,Camden,2022-11-22
,0,0,0,0,Camden,2022-11-23
,0,0,0,0,Camden,2022-11-24
,0,0,0,0,Camden,2022-11-26
,0,0,0,0,Camden,2022-11-27
,0,0,0,0,Camden,2022-11-28
,0,0,0,0,Camden,2022-12-02
,0,0,0,0,Camden,2022-12-03
,0,0,0,0,Camden,2022-12-08
,0,0,0,0,Camden,2022-12-10
,0,0,0,0,Camden,2022-12-13
,0,0,0,0,Camden,2022-12-15
,0,0,0,0,Camden,2022-12-16
,0,0,0,0,Camden,2022-12-19
,0,0,0,0,Camden,2022-12-20
,0,0,0,0,Camden,2022-12-21
,0,0,0,0,Camden,2022-12-23
,0,0,0,0,Camden,2022-12-29
,0,0,0,0,Camden,2022-12-31
,0,0,0,0,Camden,2023-01-08
,0,0,0,0,Camden,2023-01-09
,0,0,0,0,Camden,2023-01-10
,0,0,0,0,Camden,2023-01-12
,0,0,0,0,Camden,2023-01-14
,0,0,0,0,Camden,2023-01-15
,0,0,0,0,Camden,2023-01-16
,0,0,0,0,Camden,2023-01-21
,0,0,0,0,Camden,2023-01-24
,0,0,0,0,Camden,2023-01-25
,0,0,0,0,Camden,2023-01-29
,0,0,0,0,Camden,2023-01-30
,0,0,0,0,Camden,2023-02-05
,0,0,0,0,Camden,2023-02-07
,0,0,0,0,Camden,2023-02-08
,0,0,0,0,Camden,2023-02-09
,0,0,0,0,Camden,2023-02-10
,0,0,0,0,Camden,2023-02-12
,0,0,0,0,Camden,2023-02-13
,0,0,0,0,Camden,2023-02-18
,0,0,0,0,Camden,2023-02-19
,0,0,0,0,Camden,2023-02-22
,0,0,0,0,Camden,2023-02-24
,0,0,0,0,Camden,2023-02-25
,0,0,0,0,Camden,2023-02-26
,0,0,0,0,Camden,2023-03-01
,0,0,0,0,Camden,2023-03-02
,0,0,0,0,Camden,2023-03-05
,0,0,0,0,Camden,2023-03-06
,0,0,0,0,Camden,2023-03-08
,0,0,0,0,Camden,2023-03-10
,0,0,0,0,Camden,2023-03-14
,0,0,0,0,Camden,2023-03-15
,0,0,0,0,Camden,2023-03-18
,0,0,0,0,Camden,2023-03-19
,0,0,0,0,Camden,2023-03-21
,0,0,0,0,Camden,2023-03-25
,0,0,0,0,Camden,2023-03-29
,0,0,0,0,Camden,2023-03-31
,0,0,0,0,Camden,2023-04-01
,0,0,0,0,Camden,2023-04-03
,0,0,0,0,Camden,2023-04-05
,0,0,0,0,Camden,2023-04-07
,0,0,0,0,Camden,2023-04-10
,0,0,0,0,Camden,2023-04-12
,0,0,0,0,Camden,2023-04-13
,0,0,0,0,Camden,2023-04-14
,0,0,0,0,Camden,2023-04-15
,0,0,0,0,Camden,2023-04-16
,0,0,0,0,Camden,2023-04-17
,0,0,0,0,Camden,2023-04-18
,0,0,0,0,Camden,2023-04-19
,0,0,0,0,Camden,2023-04-20
,0,0,0,0,Camden,2023-04-21
,0,0,0,0,Camden,2023-04-22
,0,0,0,0,Camden,2023-04-23
,0,0,0,0,Camden,2023-04-24
,0,0,0,0,Camden,2023-04-25
,0,0,0,0,Camden,2023-04-26
,0,0,0,0,Camden,2023-04-28
,0,0,0,0,Camden,2023-04-29
,0,0,0,0,Camden,2023-05-01
,0,0,0,0,Camden,2023-05-02
,0,0,0,0,Camden,2023-05-03
,0,0,0,0,Camden,2023-05-04
,0,0,0,0,Camden,2023-05-05
,0,0,0,0,Camden,2023-05-06
,0,0,0,0,Carteret,2022-11-13
,0,0,0,0,Carteret,2023-02-19
,0,0,0,0,Carteret,2023-03-18
,0,0,0,0,Carteret,2023-03-25
,0,0,0,0,Carteret,2023-04-02
,0,0,0,0,Carteret,2023-04-09
,0,0,0,0,Carteret,2023-04-10
,0,0,0,0,Carteret,2023-04-14
,0,0,0,0,Carteret,2023-04-16
,0,0,0,0,Carteret,2023-04-17
,0,0,0,0,Carteret,2023-04-19
,0,0,0,0,Carteret,2023-05-02
,0,0,0,0,Carteret,2023-05-03
,0,0,0,0,Carteret,2023-05-04
,0,0,0,0,Carteret,2023-05-05
,0,0,0,0,Carteret,2023-05-06
,0,0,0,0,Caswell,2022-11-10
,0,0,0,0,Caswell,2022-11-16
,0,0,0,0,Caswell,2022-11-18
,0,0,0,0,Caswell,2022-11-20
,0,0,0,0,Caswell,2022-11-22
,0,0,0,0,Caswell,2022-11-24
,0,0,0,0,Caswell,2022-11-25
,0,0,0,0,Caswell,2022-12-02
,0,0,0,0,Caswell,2022-12-25
,0,0,0,0,Caswell,2023-02-12
,0,0,0,0,Caswell,2023-02-19
,0,0,0,0,Caswell,2023-02-24
,0,0,0,0,Caswell,2023-02-25
,0,0,0,0,Caswell,2023-02-28
,0,0,0,0,Caswell,2023-03-01
,0,0,0,0,Caswell,2023-03-04
,0,0,0,0,Caswell,2023-03-06
,0,0,0,0,Caswell,2023-03-07
,0,0,0,0,Caswell,2023-03-08
,0,0,0,0,Caswell,2023-03-09
,0,0,0,0,Caswell,2023-03-11
,0,0,0,0,Caswell,2023-03-12
,0,0,0,0,Caswell,2023-03-18
,0,0,0,0,Caswell,2023-03-19
,0,0,0,0,Caswell,2023-03-25
,0,0,0,0,Caswell,2023-03-28
,0,0,0,0,Caswell,2023-03-29
,0,0,0,0,Caswell,2023-03-30
,0,0,0,0,Caswell,2023-04-01
,0,0,0,0,Caswell,2023-04-03
,0,0,0,0,Caswell,2023-04-06
,0,0,0,0,Caswell,2023-04-07
,0,0,0,0,Caswell,2023-04-08
,0,0,0,0,Caswell,2023-04-09
,0,0,0,0,Caswell,2023-04-11
,0,0,0,0,Caswell,2023-04-12
,0,0,0,0,Caswell,2023-04-14
,0,0,0,0,Caswell,2023-04-16
,0,0,0,0,Caswell,2023-04-17
,0,0,0,0,Caswell,2023-04-19
,0,0,0,0,Caswell,2023-04-21
,0,0,0,0,Caswell,2023-04-22
,0,0,0,0,Caswell,2023-04-23
,0,0,0,0,Caswell,2023-04-24
,0,0,0,0,Caswell,2023-04-29
,0,0,0,0,Caswell,2023-04-30
,0,0,0,0,Caswell,2023-05-03
,0,0,0,0,Caswell,2023-05-04
,0,0,0,0,Caswell,2023-05-05
,0,0,0,0,Catawba,2023-05-03
,0,0,0,0,Catawba,2023-05-06
,0,0,0,0,Chatham,2023-04-09
,0,0,0,0,Chatham,2023-04-21
,0,0,0,0,Chatham,2023-04-22
,0,0,0,0,Chatham,2023-04-27
,0,0,0,0,Chatham,2023-04-30
,0,0,0,0,Chatham,2023-05-02
,0,0,0,0,Chatham,2023-05-06
,0,0,0,0,Cherokee,2022-11-09
,0,0,0,0,Cherokee,2022-11-13
,0,0,0,0,Cherokee,2022-12-24
,0,0,0,0,Cherokee,2023-01-01
,0,0,0,0,Cherokee,2023-02-15
,0,0,0,0,Cherokee,2023-02-25
,0,0,0,0,Cherokee,2023-03-04
,0,0,0,0,Cherokee,2023-03-06
,0,0,0,0,Cherokee,2023-03-07
,0,0,0,0,Cherokee,2023-03-10
,0,0,0,0,Cherokee,2023-03-11
,0,0,0,0,Cherokee,2023-03-13
,0,0,0,0,Cherokee,2023-03-22
,0,0,0,0,Cherokee,2023-03-24
,0,0,0,0,Cherokee,2023-03-25
,0,0,0,0,Cherokee,2023-03-26
,0,0,0,0,Cherokee,2023-04-01
,0,0,0,0,Cherokee,2023-04-08
,0,0,0,0,Cherokee,2023-04-09
,0,0,0,0,Cherokee,2023-04-12
,0,0,0,0,Cherokee,2023-04-16
,0,0,0,0,Cherokee,2023-04-17
,0,0,0,0,Cherokee,2023-04-20
,0,0,0,0,Cherokee,2023-04-21
,0,0,0,0,Cherokee,2023-04-22
,0,0,0,0,Cherokee,2023-04-23
,0,0,0,0,Cherokee,2023-04-26
,0,0,0,0,Cherokee,2023-04-27
,0,0,0,0,Cherokee,2023-04-28
,0,0,0,0,Cherokee,2023-04-30
,0,0,0,0,Cherokee,2023-05-02
,0,0,0,0,Cherokee,2023-05-04
,0,0,0,0,Cherokee,2023-05-05
,0,0,0,0,Cherokee,2023-05-06
,0,0,0,0,Chowan,2022-11-08
,0,0,0,0,Chowan,2022-11-10
,0,0,0,0,Chowan,2022-11-12
,0,0,0,0,Chowan,2022-11-13
,0,0,0,0,Chowan,2022-11-15
,0,0,0,0,Chowan,2022-11-17
,0,0,0,0,Chowan,2022-11-18
,0,0,0,0,Chowan,2022-11-22
,0,0,0,0,Chowan,2022-11-24
,0,0,0,0,Chowan,2022-12-04
,0,0,0,0,Chowan,2022-12-11
,0,0,0,0,Chowan,2022-12-24
,0,0,0,0,Chowan,2023-01-07
,0,0,0,0,Chowan,2023-02-19
,0,0,0,0,Chowan,2023-02-21
,0,0,0,0,Chowan,2023-02-28
,0,0,0,0,Chowan,2023-03-05
,0,0,0,0,Chowan,2023-03-07
,0,0,0,0,Chowan,2023-03-08
,0,0,0,0,Chowan,2023-03-11
,0,0,0,0,Chowan,2023-03-12
,0,0,0,0,Chowan,2023-03-14
,0,0,0,0,Chowan,2023-03-15
,0,0,0,0,Chowan,2023-03-16
,0,0,0,0,Chowan,2023-03-18
,0,0,0,0,Chowan,2023-03-19
,0,0,0,0,Chowan,2023-03-24
,0,0,0,0,Chowan,2023-03-28
,0,0,0,0,Chowan,2023-03-30
,0,0,0,0,Chowan,2023-03-31
,0,0,0,0,Chowan,2023-04-02
,0,0,0,0,Chowan,2023-04-03
,0,0,0,0,Chowan,2023-04-05
,0,0,0,0,Chowan,2023-04-07
,0,0,0,0,Chowan,2023-04-08
,0,0,0,0,Chowan,2023-04-09
,0,0,0,0,Chowan,2023-04-11
,0,0,0,0,Chowan,2023-04-13
,0,0,0,0,Chowan,2023-04-14
,0,0,0,0,Chowan,2023-04-15
,0,0,0,0,Chowan,2023-04-18
,0,0,0,0,Chowan,2023-04-19
,0,0,0,0,Chowan,2023-04-21
,0,0,0,0,Chowan,2023-04-23
,0,0,0,0,Chowan,2023-04-24
,0,0,0,0,Chowan,2023-04-25
,0,0,0,0,Chowan,2023-04-26
,0,0,0,0,Chowan,2023-04-30
,0,0,0,0,Chowan,2023-05-04
,0,0,0,0,Chowan,2023-05-05
,0,0,0,0,Chowan,2023-05-06
,0,0,0,0,Clay,2022-11-08
,0,0,0,0,Clay,2022-11-13
,0,0,0,0,Clay,2022-11-15
,0,0,0,0,Clay,2022-11-17
,0,0,0,0,Clay,2022-11-18
,0,0,0,0,Clay,2022-11-19
,0,0,0,0,Clay,2022-11-20
,0,0,0,0,Clay,2022-11-24
,0,0,0,0,Clay,2022-11-25
,0,0,0,0,Clay,2022-11-26
,0,0,0,0,Clay,2022-11-29
,0,0,0,0,Clay,2022-11-30
,0,0,0,0,Clay,2022-12-04
,0,0,0,0,Clay,2022-12-08
,0,0,0,0,Clay,2022-12-11
,0,0,0,0,Clay,2022-12-18
,0,0,0,0,Clay,2022-12-24
,0,0,0,0,Clay,2023-01-14
,0,0,0,0,Clay,2023-01-29
,0,0,0,0,Clay,2023-02-03
,0,0,0,0,Clay,2023-02-04
,0,0,0,0,Clay,2023-02-08
,0,0,0,0,Clay,2023-02-13
,0,0,0,0,Clay,2023-02-18
,0,0,0,0,Clay,2023-02-19
,0,0,0,0,Clay,2023-02-20
,0,0,0,0,Clay,2023-02-23
,0,0,0,0,Clay,2023-03-02
,0,0,0,0,Clay,2023-03-03
,0,0,0,0,Clay,2023-03-05
,0,0,0,0,Clay,2023-03-06
,0,0,0,0,Clay,2023-03-07
,0,0,0,0,Clay,2023-03-08
,0,0,0,0,Clay,2023-03-09
,0,0,0,0,Clay,2023-03-10
,0,0,0,0,Clay,2023-03-11
,0,0,0,0,Clay,2023-03-12
,0,0,0,0,Clay,2023-03-18
,0,0,0,0,Clay,2023-03-19
,0,0,0,0,Clay,2023-03-20
,0,0,0,0,Clay,2023-03-24
,0,0,0,0,Clay,2023-03-25
,0,0,0,0,Clay,2023-03-28
,0,0,0,0,Clay,2023-03-29
,0,0,0,0,Clay,2023-03-30
,0,0,0,0,Clay,2023-04-01
,0,0,0,0,Clay,2023-04-03
,0,0,0,0,Clay,2023-04-04
,0,0,0,0,Clay,2023-04-05
,0,0,0,0,Clay,2023-04-06
,0,0,0,0,Clay,2023-04-07
,0,0,0,0,Clay,2023-04-09
,0,0,0,0,Clay,2023-04-10
,0,0,0,0,Clay,2023-04-11
,0,0,0,0,Clay,2023-04-12
,0,0,0,0,Clay,2023-04-14
,0,0,0,0,Clay,2023-04-16
,0,0,0,0,Clay,2023-04-18
,0,0,0,0,Clay,2023-04-19
,0,0,0,0,Clay,2023-04-21
,0,0,0,0,Clay,2023-04-22
,0,0,0,0,Clay,2023-04-24
,0,0,0,0,Clay,2023-04-25
,0,0,0,0,Clay,2023-04-26
,0,0,0,0,Clay,2023-04-27
,0,0,0,0,Clay,2023-04-28
,0,0,0,0,Clay,2023-04-29
,0,0,0,0,Clay,2023-05-01
,0,0,0,0,Clay,2023-05-02
,0,0,0,0,Clay,2023-05-03
,0,0,0,0,Clay,2023-05-05
,0,0,0,0,Clay,2023-05-06
,0,0,0,0,Cleveland,2023-03-26
,0,0,0,0,Cleveland,2023-04-16
,0,0,0,0,Cleveland,2023-04-23
,0,0,0,0,Cleveland,2023-04-26
,0,0,0,0,Cleveland,2023-04-29
,0,0,0,0,Cleveland,2023-04-30
,0,0,0,0,Columbus,2022-12-03
,0,0,0,0,Columbus,2023-02-19
,0,0,0,0,Columbus,2023-02-26
,0,0,0,0,Columbus,2023-02-27
,0,0,0,0,Columbus,2023-02-28
,0,0,0,0,Columbus,2023-03-14
,0,0,0,0,Columbus,2023-03-16
,0,0,0,0,Columbus,2023-03-22
,0,0,0,0,Columbus,2023-03-23
,0,0,0,0,Columbus,2023-03-25
,0,0,0,0,Columbus,2023-03-31
,0,0,0,0,Columbus,2023-04-15
,0,0,0,0,Columbus,2023-04-22
,0,0,0,0,Columbus,2023-04-24
,0,0,0,0,Columbus,2023-04-28
,0,0,0,0,Columbus,2023-04-29
,0,0,0,0,Columbus,2023-05-01
,0,0,0,0,Columbus,2023-05-05
,0,0,0,0,Columbus,2023-05-06
,0,0,0,0,Craven,2023-04-01
,0,0,0,0,Craven,2023-04-15
,0,0,0,0,Craven,2023-04-22
,0,0,0,0,Currituck,2022-11-08
,0,0,0,0,Currituck,2022-11-11
,0,0,0,0,Currituck,2022-11-16
,0,0,0,0,Currituck,2022-11-24
,0,0,0,0,Currituck,2022-11-25
,0,0,0,0,Currituck,2022-11-29
,0,0,0,0,Currituck,2023-01-29
,0,0,0,0,Currituck,2023-02-08
,0,0,0,0,Currituck,2023-02-16
,0,0,0,0,Currituck,2023-02-20
,0,0,0,0,Currituck,2023-03-07
,0,0,0,0,Currituck,2023-03-08
,0,0,0,0,Currituck,2023-03-09
,0,0,0,0,Currituck,2023-03-21
,0,0,0,0,Currituck,2023-03-22
,0,0,0,0,Currituck,2023-03-27
,0,0,0,0,Currituck,2023-03-29
,0,0,0,0,Currituck,2023-03-31
,0,0,0,0,Currituck,2023-04-01
,0,0,0,0,Currituck,2023-04-03
,0,0,0,0,Currituck,2023-04-06
,0,0,0,0,Currituck,2023-04-07
,0,0,0,0,Currituck,2023-04-10
,0,0,0,0,Currituck,2023-04-11
,0,0,0,0,Currituck,2023-04-15
,0,0,0,0,Currituck,2023-04-18
,0,0,0,0,Currituck,2023-04-20
,0,0,0,0,Currituck,2023-04-21
,0,0,0,0,Currituck,2023-04-22
,0,0,0,0,Currituck,2023-04-24
,0,0,0,0,Currituck,2023-04-25
,0,0,0,0,Currituck,2023-04-26
,0,0,0,0,Currituck,2023-04-27
,0,0,0,0,Currituck,2023-04-28
,0,0,0,0,Currituck,2023-04-29
,0,0,0,0,Currituck,2023-04-30
,0,0,0,0,Currituck,2023-05-01
,0,0,0,0,Currituck,2023-05-02
,0,0,0,0,Currituck,2023-05-03
,0,0,0,0,Currituck,2023-05-04
,0,0,0,0,Currituck,2023-05-05
,0,0,0,0,Currituck,2023-05-06
,0,0,0,0,Dare,2022-11-24
,0,0,0,0,Dare,2022-12-03
,0,0,0,0,Dare,2022-12-07
,0,0,0,0,Dare,2023-02-20
,0,0,0,0,Dare,2023-03-05
,0,0,0,0,Dare,2023-03-10
,0,0,0,0,Dare,2023-03-16
,0,0,0,0,Dare,2023-03-24
,0,0,0,0,Dare,2023-03-26
,0,0,0,0,Dare,2023-03-30
,0,0,0,0,Dare,2023-04-01
,0,0,0,0,Dare,2023-04-02
,0,0,0,0,Dare,2023-04-03
,0,0,0,0,Dare,2023-04-06
,0,0,0,0,Dare,2023-04-07
,0,0,0,0,Dare,2023-04-11
,0,0,0,0,Dare,2023-04-12
,0,0,0,0,Dare,2023-04-13
,0,0,0,0,Dare,2023-04-14
,0,0,0,0,Dare,2023-04-16
,0,0,0,0,Dare,2023-04-17
,0,0,0,0,Dare,2023-04-21
,0,0,0,0,Dare,2023-04-22
,0,0,0,0,Dare,2023-04-28
,0,0,0,0,Dare,2023-04-30
,0,0,0,0,Dare,2023-05-03
,0,0,0,0,Dare,2023-05-06
,0,0,0,0,Davie,2022-11-13
,0,0,0,0,Davie,2022-11-19
,0,0,0,0,Davie,2022-11-20
,0,0,0,0,Davie,2023-03-19
,0,0,0,0,Davie,2023-03-22
,0,0,0,0,Davie,2023-03-24
,0,0,0,0,Davie,2023-03-25
,0,0,0,0,Davie,2023-04-01
,0,0,0,0,Davie,2023-04-10
,0,0,0,0,Davie,2023-04-15
,0,0,0,0,Davie,2023-04-16
,0,0,0,0,Davie,2023-04-19
,0,0,0,0,Davie,2023-04-23
,0,0,0,0,Davie,2023-04-27
,0,0,0,0,Davie,2023-04-28
,0,0,0,0,Davie,2023-05-02
,0,0,0,0,Davie,2023-05-06
,0,0,0,0,Duplin,2022-11-12
,0,0,0,0,Duplin,2022-11-23
,0,0,0,0,Duplin,2023-03-11
,0,0,0,0,Duplin,2023-03-12
,0,0,0,0,Duplin,2023-03-26
,0,0,0,0,Duplin,2023-03-30
,0,0,0,0,Duplin,2023-03-31
,0,0,0,0,Duplin,2023-04-01
,0,0,0,0,Duplin,2023-04-06
,0,0,0,0,Duplin,2023-04-08
,0,0,0,0,Duplin,2023-04-12
,0,0,0,0,Duplin,2023-04-13
,0,0,0,0,Duplin,2023-04-14
,0,0,0,0,Duplin,2023-04-17
,0,0,0,0,Duplin,2023-04-19
,0,0,0,0,Duplin,2023-04-21
,0,0,0,0,Duplin,2023-04-22
,0,0,0,0,Duplin,2023-04-23
,0,0,0,0,Duplin,2023-04-24
,0,0,0,0,Duplin,2023-04-28
,0,0,0,0,Duplin,2023-04-29
,0,0,0,0,Duplin,2023-04-30
,0,0,0,0,Duplin,2023-05-02
,0,0,0,0,Duplin,2023-05-03
,0,0,0,0,Duplin,2023-05-06
,0,0,0,0,Durham,2023-04-29
,0,0,0,0,Edgecombe,2022-11-19
,0,0,0,0,Edgecombe,2023-03-16
,0,0,0,0,Edgecombe,2023-04-02
,0,0,0,0,Edgecombe,2023-04-06
,0,0,0,0,Edgecombe,2023-04-08
,0,0,0,0,Edgecombe,2023-04-10
,0,0,0,0,Edgecombe,2023-04-12
,0,0,0,0,Edgecombe,2023-04-13
,0,0,0,0,Edgecombe,2023-04-18
,0,0,0,0,Edgecombe,2023-04-22
,0,0,0,0,Edgecombe,2023-04-23
,0,0,0,0,Edgecombe,2023-04-25
,0,0,0,0,Edgecombe,2023-05-03
,0,0,0,0,Edgecombe,2023-05-05
,0,0,0,0,Edgecombe,2023-05-06
,0,0,0,0,Franklin,2023-02-26
,0,0,0,0,Franklin,2023-03-18
,0,0,0,0,Franklin,2023-03-23
,0,0,0,0,Franklin,2023-03-25
,0,0,0,0,Franklin,2023-04-06
,0,0,0,0,Franklin,2023-04-08
,0,0,0,0,Franklin,2023-04-09
,0,0,0,0,Franklin,2023-04-13
,0,0,0,0,Franklin,2023-04-15
,0,0,0,0,Franklin,2023-04-20
,0,0,0,0,Franklin,2023-04-23
,0,0,0,0,Franklin,2023-04-25
,0,0,0,0,Franklin,2023-04-27
,0,0,0,0,Gates,2022-11-09
,0,0,0,0,Gates,2022-11-10
,0,0,0,0,Gates,2022-11-11
,0,0,0,0,Gates,2022-11-12
,0,0,0,0,Gates,2022-11-14
,0,0,0,0,Gates,2022-11-16
,0,0,0,0,Gates,2022-11-18
,0,0,0,0,Gates,2022-11-19
,0,0,0,0,Gates,2022-11-22
,0,0,0,0,Gates,2022-11-23
,0,0,0,0,Gates,2022-11-24
,0,0,0,0,Gates,2022-11-25
,0,0,0,0,Gates,2022-11-27
,0,0,0,0,Gates,2022-11-29
,0,0,0,0,Gates,2022-11-30
,0,0,0,0,Gates,2022-12-01
,0,0,0,0,Gates,2022-12-02
,0,0,0,0,Gates,2022-12-03
,0,0,0,0,Gates,2022-12-08
,0,0,0,0,Gates,2022-12-10
,0,0,0,0,Gates,2022-12-13
,0,0,0,0,Gates,2022-12-14
,0,0,0,0,Gates,2022-12-17
,0,0,0,0,Gates,2022-12-20
,0,0,0,0,Gates,2022-12-21
,0,0,0,0,Gates,2022-12-25
,0,0,0,0,Gates,2022-12-30
,0,0,0,0,Gates,2023-01-01
,0,0,0,0,Gates,2023-01-08
,0,0,0,0,Gates,2023-01-19
,0,0,0,0,Gates,2023-01-21
,0,0,0,0,Gates,2023-01-22
,0,0,0,0,Gates,2023-01-28
,0,0,0,0,Gates,2023-02-05
,0,0,0,0,Gates,2023-02-07
,0,0,0,0,Gates,2023-02-09
,0,0,0,0,Gates,2023-02-16
,0,0,0,0,Gates,2023-02-17
,0,0,0,0,Gates,2023-02-19
,0,0,0,0,Gates,2023-02-21
,0,0,0,0,Gates,2023-02-23
,0,0,0,0,Gates,2023-02-24
,0,0,0,0,Gates,2023-02-26
,0,0,0,0,Gates,2023-02-27
,0,0,0,0,Gates,2023-03-02
,0,0,0,0,Gates,2023-03-03
,0,0,0,0,Gates,2023-03-04
,0,0,0,0,Gates,2023-03-05
,0,0,0,0,Gates,2023-03-08
,0,0,0,0,Gates,2023-03-11
,0,0,0,0,Gates,2023-03-12
,0,0,0,0,Gates,2023-03-14
,0,0,0,0,Gates,2023-03-16
,0,0,0,0,Gates,2023-03-21
,0,0,0,0,Gates,2023-03-24
,0,0,0,0,Gates,2023-03-25
,0,0,0,0,Gates,2023-03-26
,0,0,0,0,Gates,2023-03-27
,0,0,0,0,Gates,2023-03-28
,0,0,0,0,Gates,2023-03-30
,0,0,0,0,Gates,2023-03-31
,0,0,0,0,Gates,2023-04-01
,0,0,0,0,Gates,2023-04-02
,0,0,0,0,Gates,2023-04-03
,0,0,0,0,Gates,2023-04-04
,0,0,0,0,Gates,2023-04-07
,0,0,0,0,Gates,2023-04-08
,0,0,0,0,Gates,2023-04-09
,0,0,0,0,Gates,2023-04-10
,0,0,0,0,Gates,2023-04-11
,0,0,0,0,Gates,2023-04-12
,0,0,0,0,Gates,2023-04-13
,0,0,0,0,Gates,2023-04-14
,0,0,0,0,Gates,2023-04-15
,0,0,0,0,Gates,2023-04-16
,0,0,0,0,Gates,2023-04-17
,0,0,0,0,Gates,2023-04-18
,0,0,0,0,Gates,2023-04-19
,0,0,0,0,Gates,2023-04-20
,0,0,0,0,Gates,2023-04-21
,0,0,0,0,Gates,2023-04-22
,0,0,0,0,Gates,2023-04-23
,0,0,0,0,Gates,2023-04-24
,0,0,0,0,Gates,2023-04-25
,0,0,0,0,Gates,2023-04-27
,0,0,0,0,Gates,2023-04-28
,0,0,0,0,Gates,2023-04-29
,0,0,0,0,Gates,2023-04-30
,0,0,0,0,Gates,2023-05-01
,0,0,0,0,Gates,2023-05-02
,0,0,0,0,Gates,2023-05-03
,0,0,0,0,Gates,2023-05-04
,0,0,0,0,Gates,2023-05-06
,0,0,0,0,Graham,2022-11-09
,0,0,0,0,Graham,2022-11-11
,0,0,0,0,Graham,2022-11-12
,0,0,0,0,Graham,2022-11-14
,0,0,0,0,Graham,2022-11-19
,0,0,0,0,Graham,2022-11-20
,0,0,0,0,Graham,2022-11-21
,0,0,0,0,Graham,2022-11-24
,0,0,0,0,Graham,2022-11-25
,0,0,0,0,Graham,2022-11-26
,0,0,0,0,Graham,2022-12-01
,0,0,0,0,Graham,2022-12-03
,0,0,0,0,Graham,2022-12-04
,0,0,0,0,Graham,2022-12-05
,0,0,0,0,Graham,2022-12-08
,0,0,0,0,Graham,2022-12-10
,0,0,0,0,Graham,2022-12-13
,0,0,0,0,Graham,2022-12-15
,0,0,0,0,Graham,2022-12-16
,0,0,0,0,Graham,2022-12-17
,0,0,0,0,Graham,2022-12-18
,0,0,0,0,Graham,2022-12-22
,0,0,0,0,Graham,2022-12-23
,0,0,0,0,Graham,2023-01-06
,0,0,0,0,Graham,2023-01-08
,0,0,0,0,Graham,2023-01-13
,0,0,0,0,Graham,2023-01-14
,0,0,0,0,Graham,2023-01-15
,0,0,0,0,Graham,2023-01-19
,0,0,0,0,Graham,2023-01-24
,0,0,0,0,Graham,2023-01-28
,0,0,0,0,Graham,2023-01-29
,0,0,0,0,Graham,2023-02-09
,0,0,0,0,Graham,2023-02-11
,0,0,0,0,Graham,2023-02-12
,0,0,0,0,Graham,2023-02-16
,0,0,0,0,Graham,2023-02-17
,0,0,0,0,Graham,2023-02-18
,0,0,0,0,Graham,2023-02-19
,0,0,0,0,Graham,2023-02-22
,0,0,0,0,Graham,2023-02-24
,0,0,0,0,Graham,2023-02-25
,0,0,0,0,Graham,2023-02-26
,0,0,0,0,Graham,2023-02-27
,0,0,0,0,Graham,2023-03-02
,0,0,0,0,Graham,2023-03-03
,0,0,0,0,Graham,2023-03-04
,0,0,0,0,Graham,2023-03-06
,0,0,0,0,Graham,2023-03-07
,0,0,0,0,Graham,2023-03-08
,0,0,0,0,Graham,2023-03-09
,0,0,0,0,Graham,2023-03-12
,0,0,0,0,Graham,2023-03-17
,0,0,0,0,Graham,2023-03-18
,0,0,0,0,Graham,2023-03-19
,0,0,0,0,Graham,2023-03-20
,0,0,0,0,Graham,2023-03-22
,0,0,0,0,Graham,2023-03-23
,0,0,0,0,Graham,2023-03-25
,0,0,0,0,Graham,2023-03-26
,0,0,0,0,Graham,2023-03-27
,0,0,0,0,Graham,2023-03-29
,0,0,0,0,Graham,2023-03-30
,0,0,0,0,Graham,2023-03-31
,0,0,0,0,Graham,2023-04-01
,0,0,0,0,Graham,2023-04-02
,0,0,0,0,Graham,2023-04-04
,0,0,0,0,Graham,2023-04-05
,0,0,0,0,Graham,2023-04-08
,0,0,0,0,Graham,2023-04-09
,0,0,0,0,Graham,2023-04-10
,0,0,0,0,Graham,2023-04-12
,0,0,0,0,Graham,2023-04-13
,0,0,0,0,Graham,2023-04-15
,0,0,0,0,Graham,2023-04-16
,0,0,0,0,Graham,2023-04-17
,0,0,0,0,Graham,2023-04-18
,0,0,0,0,Graham,2023-04-19
,0,0,0,0,Graham,2023-04-20
,0,0,0,0,Graham,2023-04-21
,0,0,0,0,Graham,2023-04-23
,0,0,0,0,Graham,2023-04-24
,0,0,0,0,Graham,2023-04-25
,0,0,0,0,Graham,2023-04-26
,0,0,0,0,Graham,2023-04-27
,0,0,0,0,Graham,2023-04-28
,0,0,0,0,Graham,2023-04-29
,0,0,0,0,Graham,2023-04-30
,0,0,0,0,Graham,2023-05-01
,0,0,0,0,Graham,2023-05-02
,0,0,0,0,Graham,2023-05-03
,0,0,0,0,Graham,2023-05-04
,0,0,0,0,Graham,2023-05-06
,0,0,0,0,Granville,2023-02-12
,0,0,0,0,Granville,2023-03-31
,0,0,0,0,Granville,2023-04-14
,0,0,0,0,Granville,2023-04-15
,0,0,0,0,Granville,2023-04-22
,0,0,0,0,Granville,2023-04-23
,0,0,0,0,Granville,2023-04-29
,0,0,0,0,Granville,2023-04-30
,0,0,0,0,Granville,2023-05-03
,0,0,0,0,Granville,2023-05-04
,0,0,0,0,Granville,2023-05-05
,0,0,0,0,Granville,2023-05-06
,0,0,0,0,Greene,2022-11-12
,0,0,0,0,Greene,2022-11-15
,0,0,0,0,Greene,2022-11-19
,0,0,0,0,Greene,2022-11-20
,0,0,0,0,Greene,2022-11-23
,0,0,0,0,Greene,2022-11-24
,0,0,0,0,Greene,2022-11-25
,0,0,0,0,Greene,2022-11-26
,0,0,0,0,Greene,2022-11-27
,0,0,0,0,Greene,2022-12-01
,0,0,0,0,Greene,2022-12-04
,0,0,0,0,Greene,2022-12-17
,0,0,0,0,Greene,2022-12-18
,0,0,0,0,Greene,2023-01-08
,0,0,0,0,Greene,2023-01-28
,0,0,0,0,Greene,2023-01-29
,0,0,0,0,Greene,2023-02-03
,0,0,0,0,Greene,2023-02-04
,0,0,0,0,Greene,2023-02-17
,0,0,0,0,Greene,2023-02-18
,0,0,0,0,Greene,2023-02-19
,0,0,0,0,Greene,2023-02-21
,0,0,0,0,Greene,2023-02-26
,0,0,0,0,Greene,2023-03-04
,0,0,0,0,Greene,2023-03-05
,0,0,0,0,Greene,2023-03-08
,0,0,0,0,Greene,2023-03-10
,0,0,0,0,Greene,2023-03-11
,0,0,0,0,Greene,2023-03-12
,0,0,0,0,Greene,2023-03-14
,0,0,0,0,Greene,2023-03-15
,0,0,0,0,Greene,2023-03-16
,0,0,0,0,Greene,2023-03-22
,0,0,0,0,Greene,2023-03-26
,0,0,0,0,Greene,2023-03-27
,0,0,0,0,Greene,2023-03-29
,0,0,0,0,Greene,2023-03-30
,0,0,0,0,Greene,2023-04-01
,0,0,0,0,Greene,2023-04-02
,0,0,0,0,Greene,2023-04-03
,0,0,0,0,Greene,2023-04-04
,0,0,0,0,Greene,2023-04-05
,0,0,0,0,Greene,2023-04-07
,0,0,0,0,Greene,2023-04-08
,0,0,0,0,Greene,2023-04-09
,0,0,0,0,Greene,2023-04-10
,0,0,0,0,Greene,2023-04-14
,0,0,0,0,Greene,2023-04-15
,0,0,0,0,Greene,2023-04-16
,0,0,0,0,Greene,2023-04-18
,0,0,0,0,Greene,2023-04-19
,0,0,0,0,Greene,2023-04-21
,0,0,0,0,Greene,2023-04-22
,0,0,0,0,Greene,2023-04-24
,0,0,0,0,Greene,2023-04-25
,0,0,0,0,Greene,2023-04-26
,0,0,0,0,Greene,2023-04-27
,0,0,0,0,Greene,2023-04-28
,0,0,0,0,Greene,2023-04-29
,0,0,0,0,Greene,2023-04-30
,0,0,0,0,Greene,2023-05-01
,0,0,0,0,Greene,2023-05-03
,0,0,0,0,Greene,2023-05-05
,0,0,0,0,Greene,2023-05-06
,0,0,0,0,Halifax,2023-02-25
,0,0,0,0,Halifax,2023-03-12
,0,0,0,0,Halifax,2023-04-02
,0,0,0,0,Halifax,2023-04-09
,0,0,0,0,Halifax,2023-04-12
,0,0,0,0,Halifax,2023-04-28
,0,0,0,0,Halifax,2023-04-30
,0,0,0,0,Halifax,2023-05-01
,0,0,0,0,Halifax,2023-05-06
,0,0,0,0,Harnett,2023-04-08
,0,0,0,0,Harnett,2023-04-22
,0,0,0,0,Harnett,2023-05-06
,0,0,0,0,Haywood,2023-03-04
,0,0,0,0,Haywood,2023-03-07
,0,0,0,0,Haywood,2023-03-18
,0,0,0,0,Haywood,2023-03-30
,0,0,0,0,Haywood,2023-04-13
,0,0,0,0,Haywood,2023-05-02
,0,0,0,0,Haywood,2023-05-06
,0,0,0,0,Henderson,2023-05-04
,0,0,0,0,Hertford,2022-11-13
,0,0,0,0,Hertford,2022-11-15
,0,0,0,0,Hertford,2022-11-17
,0,0,0,0,Hertford,2022-11-24
,0,0,0,0,Hertford,2022-11-26
,0,0,0,0,Hertford,2023-01-08
,0,0,0,0,Hertford,2023-01-16
,0,0,0,0,Hertford,2023-01-29
,0,0,0,0,Hertford,2023-02-04
,0,0,0,0,Hertford,2023-02-12
,0,0,0,0,Hertford,2023-02-19
,0,0,0,0,Hertford,2023-02-25
,0,0,0,0,Hertford,2023-03-04
,0,0,0,0,Hertford,2023-03-05
,0,0,0,0,Hertford,2023-03-06
,0,0,0,0,Hertford,2023-03-13
,0,0,0,0,Hertford,2023-03-17
,0,0,0,0,Hertford,2023-03-18
,0,0,0,0,Hertford,2023-03-24
,0,0,0,0,Hertford,2023-03-25
,0,0,0,0,Hertford,2023-03-26
,0,0,0,0,Hertford,2023-03-28
,0,0,0,0,Hertford,2023-03-29
,0,0,0,0,Hertford,2023-03-30
,0,0,0,0,Hertford,2023-04-01
,0,0,0,0,Hertford,2023-04-02
,0,0,0,0,Hertford,2023-04-06
,0,0,0,0,Hertford,2023-04-07
,0,0,0,0,Hertford,2023-04-08
,0,0,0,0,Hertford,2023-04-09
,0,0,0,0,Hertford,2023-04-10
,0,0,0,0,Hertford,2023-04-11
,0,0,0,0,Hertford,2023-04-12
,0,0,0,0,Hertford,2023-04-13
,0,0,0,0,Hertford,2023-04-15
,0,0,0,0,Hertford,2023-04-16
,0,0,0,0,Hertford,2023-04-17
,0,0,0,0,Hertford,2023-04-19
,0,0,0,0,Hertford,2023-04-20
,0,0,0,0,Hertford,2023-04-21
,0,0,0,0,Hertford,2023-04-22
,0,0,0,0,Hertford,2023-04-23
,0,0,0,0,Hertford,2023-04-25
,0,0,0,0,Hertford,2023-04-26
,0,0,0,0,Hertford,2023-04-27
,0,0,0,0,Hertford,2023-04-29
,0,0,0,0,Hertford,2023-04-30
,0,0,0,0,Hertford,2023-05-01
,0,0,0,0,Hertford,2023-05-02
,0,0,0,0,Hertford,2023-05-03
,0,0,0,0,Hertford,2023-05-04
,0,0,0,0,Hoke,2022-11-25
,0,0,0,0,Hoke,2023-02-28
,0,0,0,0,Hoke,2023-03-14
,0,0,0,0,Hoke,2023-03-18
,0,0,0,0,Hoke,2023-03-20
,0,0,0,0,Hoke,2023-03-26
,0,0,0,0,Hoke,2023-04-01
,0,0,0,0,Hoke,2023-04-04
,0,0,0,0,Hoke,2023-04-09
,0,0,0,0,Hoke,2023-04-14
,0,0,0,0,Hoke,2023-04-15
,0,0,0,0,Hoke,2023-04-16
,0,0,0,0,Hoke,2023-04-29
,0,0,0,0,Hoke,2023-04-30
,0,0,0,0,Hoke,2023-05-03
,0,0,0,0,Hoke,2023-05-06
,0,0,0,0,Hyde,2022-11-08
,0,0,0,0,Hyde,2022-11-09
,0,0,0,0,Hyde,2022-11-10
,0,0,0,0,Hyde,2022-11-11
,0,0,0,0,Hyde,2022-11-12
,0,0,0,0,Hyde,2022-11-13
,0,0,0,0,Hyde,2022-11-14
,0,0,0,0,Hyde,2022-11-15
,0,0,0,0,Hyde,2022-11-16
,0,0,0,0,Hyde,2022-11-17
,0,0,0,0,Hyde,2022-11-18
,0,0,0,0,Hyde,2022-11-19
,0,0,0,0,Hyde,2022-11-20
,0,0,0,0,Hyde,2022-11-22
,0,0,0,0,Hyde,2022-11-23
,0,0,0,0,Hyde,2022-11-25
,0,0,0,0,Hyde,2022-11-26
,0,0,0,0,Hyde,2022-11-27
,0,0,0,0,Hyde,2022-11-28
,0,0,0,0,Hyde,2022-11-29
,0,0,0,0,Hyde,2022-11-30
,0,0,0,0,Hyde,2022-12-01
,0,0,0,0,Hyde,2022-12-03
,0,0,0,0,Hyde,2022-12-04
,0,0,0,0,Hyde,2022-12-05
,0,0,0,0,Hyde,2022-12-07
,0,0,0,0,Hyde,2022-12-08
,0,0,0,0,Hyde,2022-12-10
,0,0,0,0,Hyde,2022-12-11
,0,0,0,0,Hyde,2022-12-13
,0,0,0,0,Hyde,2022-12-14
,0,0,0,0,Hyde,2022-12-16
,0,0,0,0,Hyde,2022-12-17
,0,0,0,0,Hyde,2022-12-18
,0,0,0,0,Hyde,2022-12-21
,0,0,0,0,Hyde,2022-12-22
,0,0,0,0,Hyde,2022-12-23
,0,0,0,0,Hyde,2022-12-25
,0,0,0,0,Hyde,2022-12-26
,0,0,0,0,Hyde,2022-12-27
,0,0,0,0,Hyde,2022-12-28
,0,0,0,0,Hyde,2023-01-01
,0,0,0,0,Hyde,2023-01-02
,0,0,0,0,Hyde,2023-01-12
,0,0,0,0,Hyde,2023-01-15
,0,0,0,0,Hyde,2023-01-20
,0,0,0,0,Hyde,2023-01-21
,0,0,0,0,Hyde,2023-01-26
,0,0,0,0,Hyde,2023-01-28
,0,0,0,0,Hyde,2023-02-03
,0,0,0,0,Hyde,2023-02-04
,0,0,0,0,Hyde,2023-02-06
,0,0,0,0,Hyde,2023-02-07
,0,0,0,0,Hyde,2023-02-09
,0,0,0,0,Hyde,2023-02-10
,0,0,0,0,Hyde,2023-02-11
,0,0,0,0,Hyde,2023-02-12
,0,0,0,0,Hyde,2023-02-13
,0,0,0,0,Hyde,2023-02-16
,0,0,0,0,Hyde,2023-02-18
,0,0,0,0,Hyde,2023-02-19
,0,0,0,0,Hyde,2023-02-20
,0,0,0,0,Hyde,2023-02-21
,0,0,0,0,Hyde,2023-02-22
,0,0,0,0,Hyde,2023-02-23
,0,0,0,0,Hyde,2023-02-24
,0,0,0,0,Hyde,2023-02-27
,0,0,0,0,Hyde,2023-02-28
,0,0,0,0,Hyde,2023-03-01
,0,0,0,0,Hyde,2023-03-02
,0,0,0,0,Hyde,2023-03-03
,0,0,0,0,Hyde,2023-03-05
,0,0,0,0,Hyde,2023-03-06
,0,0,0,0,Hyde,2023-03-07
,0,0,0,0,Hyde,2023-03-08
,0,0,0,0,Hyde,2023-03-09
,0,0,0,0,Hyde,2023-03-10
,0,0,0,0,Hyde,2023-03-11
,0,0,0,0,Hyde,2023-03-12
,0,0,0,0,Hyde,2023-03-13
,0,0,0,0,Hyde,2023-03-15
,0,0,0,0,Hyde,2023-03-16
,0,0,0,0,Hyde,2023-03-17
,0,0,0,0,Hyde,2023-03-18
,0,0,0,0,Hyde,2023-03-19
,0,0,0,0,Hyde,2023-03-20
,0,0,0,0,Hyde,2023-03-21
,0,0,0,0,Hyde,2023-03-22
,0,0,0,0,Hyde,2023-03-24
,0,0,0,0,Hyde,2023-03-25
,0,0,0,0,Hyde,2023-03-26
,0,0,0,0,Hyde,2023-03-27
,0,0,0,0,Hyde,2023-03-28
,0,0,0,0,Hyde,2023-03-29
,0,0,0,0,Hyde,2023-03-30
,0,0,0,0,Hyde,2023-03-31
,0,0,0,0,Hyde,2023-04-01
,0,0,0,0,Hyde,2023-04-02
,0,0,0,0,Hyde,2023-04-03
,0,0,0,0,Hyde,2023-04-04
,0,0,0,0,Hyde,2023-04-05
,0,0,0,0,Hyde,2023-04-07
,0,0,0,0,Hyde,2023-04-08
,0,0,0,0,Hyde,2023-04-09
,0,0,0,0,Hyde,2023-04-10
,0,0,0,0,Hyde,2023-04-11
,0,0,0,0,Hyde,2023-04-15
,0,0,0,0,Hyde,2023-04-16
,0,0,0,0,Hyde,2023-04-17
,0,0,0,0,Hyde,2023-04-18
,0,0,0,0,Hyde,2023-04-19
,0,0,0,0,Hyde,2023-04-20
,0,0,0,0,Hyde,2023-04-21
,0,0,0,0,Hyde,2023-04-22
,0,0,0,0,Hyde,2023-04-23
,0,0,0,0,Hyde,2023-04-24
,0,0,0,0,Hyde,2023-04-25
,0,0,0,0,Hyde,2023-04-28
,0,0,0,0,Hyde,2023-04-29
,0,0,0,0,Hyde,2023-04-30
,0,0,0,0,Hyde,2023-05-01
,0,0,0,0,Hyde,2023-05-02
,0,0,0,0,Hyde,2023-05-03
,0,0,0,0,Hyde,2023-05-04
,0,0,0,0,Hyde,2023-05-05
,0,0,0,0,Hyde,2023-05-06
,0,0,0,0,Iredell,2023-04-22
,0,0,0,0,Jackson,2023-01-21
,0,0,0,0,Jackson,2023-02-26
,0,0,0,0,Jackson,2023-03-09
,0,0,0,0,Jackson,2023-03-11
,0,0,0,0,Jackson,2023-03-12
,0,0,0,0,Jackson,2023-03-19
,0,0,0,0,Jackson,2023-03-26
,0,0,0,0,Jackson,2023-04-06
,0,0,0,0,Jackson,2023-04-08
,0,0,0,0,Jackson,2023-04-28
,0,0,0,0,Jackson,2023-04-29
,0,0,0,0,Jackson,2023-05-04
,0,0,0,0,Jackson,2023-05-06
,0,0,0,0,Jones,2022-11-10
,0,0,0,0,Jones,2022-11-13
,0,0,0,0,Jones,2022-11-14
,0,0,0,0,Jones,2022-11-15
,0,0,0,0,Jones,2022-11-16
,0,0,0,0,Jones,2022-11-17
,0,0,0,0,Jones,2022-11-19
,0,0,0,0,Jones,2022-11-20
,0,0,0,0,Jones,2022-11-23
,0,0,0,0,Jones,2022-11-24
,0,0,0,0,Jones,2022-11-25
,0,0,0,0,Jones,2022-11-26
,0,0,0,0,Jones,2022-11-27
,0,0,0,0,Jones,2022-11-28
,0,0,0,0,Jones,2022-11-29
,0,0,0,0,Jones,2022-12-02
,0,0,0,0,Jones,2022-12-03
,0,0,0,0,Jones,2022-12-04
,0,0,0,0,Jones,2022-12-09
,0,0,0,0,Jones,2022-12-13
,0,0,0,0,Jones,2022-12-23
,0,0,0,0,Jones,2023-01-08
,0,0,0,0,Jones,2023-01-15
,0,0,0,0,Jones,2023-01-22
,0,0,0,0,Jones,2023-01-26
,0,0,0,0,Jones,2023-01-27
,0,0,0,0,Jones,2023-02-01
,0,0,0,0,Jones,2023-02-07
,0,0,0,0,Jones,2023-02-12
,0,0,0,0,Jones,2023-02-14
,0,0,0,0,Jones,2023-02-18
,0,0,0,0,Jones,2023-02-19
,0,0,0,0,Jones,2023-02-20
,0,0,0,0,Jones,2023-02-21
,0,0,0,0,Jones,2023-02-25
,0,0,0,0,Jones,2023-02-26
,0,0,0,0,Jones,2023-02-27
,0,0,0,0,Jones,2023-02-28
,0,0,0,0,Jones,2023-03-02
,0,0,0,0,Jones,2023-03-03
,0,0,0,0,Jones,2023-03-04
,0,0,0,0,Jones,2023-03-05
,0,0,0,0,Jones,2023-03-09
,0,0,0,0,Jones,2023-03-10
,0,0,0,0,Jones,2023-03-11
,0,0,0,0,Jones,2023-03-12
,0,0,0,0,Jones,2023-03-15
,0,0,0,0,Jones,2023-03-18
,0,0,0,0,Jones,2023-03-19
,0,0,0,0,Jones,2023-03-20
,0,0,0,0,Jones,2023-03-21
,0,0,0,0,Jones,2023-03-23
,0,0,0,0,Jones,2023-03-25
,0,0,0,0,Jones,2023-03-26
,0,0,0,0,Jones,2023-03-27
,0,0,0,0,Jones,2023-03-28
,0,0,0,0,Jones,2023-03-30
,0,0,0,0,Jones,2023-04-01
,0,0,0,0,Jones,2023-04-03
,0,0,0,0,Jones,2023-04-04
,0,0,0,0,Jones,2023-04-05
,0,0,0,0,Jones,2023-04-08
,0,0,0,0,Jones,2023-04-09
,0,0,0,0,Jones,2023-04-10
,0,0,0,0,Jones,2023-04-11
,0,0,0,0,Jones,2023-04-12
,0,0,0,0,Jones,2023-04-13
,0,0,0,0,Jones,2023-04-14
,0,0,0,0,Jones,2023-04-15
,0,0,0,0,Jones,2023-04-16
,0,0,0,0,Jones,2023-04-17
,0,0,0,0,Jones,2023-04-19
,0,0,0,0,Jones,2023-04-22
,0,0,0,0,Jones,2023-04-23
,0,0,0,0,Jones,2023-04-24
,0,0,0,0,Jones,2023-04-25
,0,0,0,0,Jones,2023-04-26
,0,0,0,0,Jones,2023-04-27
,0,0,0,0,Jones,2023-04-28
,0,0,0,0,Jones,2023-04-29
,0,0,0,0,Jones,2023-04-30
,0,0,0,0,Jones,2023-05-02
,0,0,0,0,Jones,2023-05-03
,0,0,0,0,Jones,2023-05-04
,0,0,0,0,Jones,2023-05-05
,0,0,0,0,Jones,2023-05-06
,0,0,0,0,Lee,2023-03-04
,0,0,0,0,Lee,2023-03-06
,0,0,0,0,Lee,2023-03-11
,0,0,0,0,Lee,2023-03-19
,0,0,0,0,Lee,2023-04-03
,0,0,0,0,Lee,2023-04-16
,0,0,0,0,Lee,2023-04-19
,0,0,0,0,Lee,2023-04-25
,0,0,0,0,Lee,2023-04-27
,0,0,0,0,Lee,2023-04-28
,0,0,0,0,Lee,2023-04-29
,0,0,0,0,Lee,2023-04-30
,0,0,0,0,Lee,2023-05-02
,0,0,0,0,Lee,2023-05-03
,0,0,0,0,Lee,2023-05-04
,0,0,0,0,Lee,2023-05-06
,0,0,0,0,Lenoir,2022-11-20
,0,0,0,0,Lenoir,2023-02-25
,0,0,0,0,Lenoir,2023-03-05
,0,0,0,0,Lenoir,2023-04-15
,0,0,0,0,Lenoir,2023-04-16
,0,0,0,0,Lenoir,2023-04-20
,0,0,0,0,Lenoir,2023-04-23
,0,0,0,0,Lenoir,2023-04-24
,0,0,0,0,Lenoir,2023-04-26
,0,0,0,0,Lenoir,2023-05-02
,0,0,0,0,Lenoir,2023-05-03
,0,0,0,0,Lenoir,2023-05-04
,0,0,0,0,Lenoir,2023-05-05
,0,0,0,0,Lenoir,2023-05-06
,0,0,0,0,Lincoln,2022-11-13
,0,0,0,0,Lincoln,2023-04-08
,0,0,0,0,Lincoln,2023-04-22
,0,0,0,0,Lincoln,2023-05-02
,0,0,0,0,Lincoln,2023-05-06
,0,0,0,0,Macon,2022-11-11
,0,0,0,0,Macon,2022-11-20
,0,0,0,0,Macon,2022-11-21
,0,0,0,0,Macon,2022-11-25
,0,0,0,0,Macon,2022-12-17
,0,0,0,0,Macon,2023-02-05
,0,0,0,0,Macon,2023-02-17
,0,0,0,0,Macon,2023-02-18
,0,0,0,0,Macon,2023-02-19
,0,0,0,0,Macon,2023-02-20
,0,0,0,0,Macon,2023-02-22
,0,0,0,0,Macon,2023-03-06
,0,0,0,0,Macon,2023-03-11
,0,0,0,0,Macon,2023-03-12
,0,0,0,0,Macon,2023-03-16
,0,0,0,0,Macon,2023-03-20
,0,0,0,0,Macon,2023-03-23
,0,0,0,0,Macon,2023-03-24
,0,0,0,0,Macon,2023-03-25
,0,0,0,0,Macon,2023-03-26
,0,0,0,0,Macon,2023-03-29
,0,0,0,0,Macon,2023-03-31
,0,0,0,0,Macon,2023-04-01
,0,0,0,0,Macon,2023-04-04
,0,0,0,0,Macon,2023-04-05
,0,0,0,0,Macon,2023-04-06
,0,0,0,0,Macon,2023-04-07
,0,0,0,0,Macon,2023-04-09
,0,0,0,0,Macon,2023-04-10
,0,0,0,0,Macon,2023-04-12
,0,0,0,0,Macon,2023-04-14
,0,0,0,0,Macon,2023-04-16
,0,0,0,0,Macon,2023-04-20
,0,0,0,0,Macon,2023-04-22
,0,0,0,0,Macon,2023-04-24
,0,0,0,0,Macon,2023-04-25
,0,0,0,0,Macon,2023-04-26
,0,0,0,0,Macon,2023-04-28
,0,0,0,0,Macon,2023-04-29
,0,0,0,0,Macon,2023-05-02
,0,0,0,0,Macon,2023-05-04
,0,0,0,0,Macon,2023-05-05
,0,0,0,0,Madison,2022-11-08
,0,0,0,0,Madison,2022-11-10
,0,0,0,0,Madison,2022-11-11
,0,0,0,0,Madison,2022-11-12
,0,0,0,0,Madison,2022-11-13
,0,0,0,0,Madison,2022-11-14
,0,0,0,0,Madison,2022-11-22
,0,0,0,0,Madison,2022-11-24
,0,0,0,0,Madison,2022-12-07
,0,0,0,0,Madison,2022-12-10
,0,0,0,0,Madison,2022-12-25
,0,0,0,0,Madison,2023-01-07
,0,0,0,0,Madison,2023-01-15
,0,0,0,0,Madison,2023-01-18
,0,0,0,0,Madison,2023-01-20
,0,0,0,0,Madison,2023-01-21
,0,0,0,0,Madison,2023-02-04
,0,0,0,0,Madison,2023-02-06
,0,0,0,0,Madison,2023-02-24
,0,0,0,0,Madison,2023-02-25
,0,0,0,0,Madison,2023-02-26
,0,0,0,0,Madison,2023-03-01
,0,0,0,0,Madison,2023-03-03
,0,0,0,0,Madison,2023-03-05
,0,0,0,0,Madison,2023-03-10
,0,0,0,0,Madison,2023-03-11
,0,0,0,0,Madison,2023-03-15
,0,0,0,0,Madison,2023-03-17
,0,0,0,0,Madison,2023-03-18
,0,0,0,0,Madison,2023-03-19
,0,0,0,0,Madison,2023-03-24
,0,0,0,0,Madison,2023-03-25
,0,0,0,0,Madison,2023-03-26
,0,0,0,0,Madison,2023-03-27
,0,0,0,0,Madison,2023-04-01
,0,0,0,0,Madison,2023-04-06
,0,0,0,0,Madison,2023-04-07
,0,0,0,0,Madison,2023-04-08
,0,0,0,0,Madison,2023-04-10
,0,0,0,0,Madison,2023-04-12
,0,0,0,0,Madison,2023-04-13
,0,0,0,0,Madison,2023-04-14
,0,0,0,0,Madison,2023-04-15
,0,0,0,0,Madison,2023-04-16
,0,0,0,0,Madison,2023-04-20
,0,0,0,0,Madison,2023-04-22
,0,0,0,0,Madison,2023-04-23
,0,0,0,0,Madison,2023-04-26
,0,0,0,0,Madison,2023-04-28
,0,0,0,0,Madison,2023-04-29
,0,0,0,0,Madison,2023-05-02
,0,0,0,0,Madison,2023-05-04
,0,0,0,0,Madison,2023-05-05
,0,0,0,0,Madison,2023-05-06
,0,0,0,0,Martin,2022-11-11
,0,0,0,0,Martin,2022-11-12
,0,0,0,0,Martin,2022-11-13
,0,0,0,0,Martin,2022-11-16
,0,0,0,0,Martin,2022-11-20
,0,0,0,0,Martin,2022-11-22
,0,0,0,0,Martin,2022-11-24
,0,0,0,0,Martin,2022-11-26
,0,0,0,0,Martin,2022-11-27
,0,0,0,0,Martin,2022-11-30
,0,0,0,0,Martin,2022-12-01
,0,0,0,0,Martin,2022-12-11
,0,0,0,0,Martin,2022-12-25
,0,0,0,0,Martin,2022-12-28
,0,0,0,0,Martin,2023-01-21
,0,0,0,0,Martin,2023-02-11
,0,0,0,0,Martin,2023-02-12
,0,0,0,0,Martin,2023-02-14
,0,0,0,0,Martin,2023-02-21
,0,0,0,0,Martin,2023-02-25
,0,0,0,0,Martin,2023-02-26
,0,0,0,0,Martin,2023-03-01
,0,0,0,0,Martin,2023-03-03
,0,0,0,0,Martin,2023-03-04
,0,0,0,0,Martin,2023-03-08
,0,0,0,0,Martin,2023-03-09
,0,0,0,0,Martin,2023-03-10
,0,0,0,0,Martin,2023-03-11
,0,0,0,0,Martin,2023-03-12
,0,0,0,0,Martin,2023-03-13
,0,0,0,0,Martin,2023-03-14
,0,0,0,0,Martin,2023-03-17
,0,0,0,0,Martin,2023-03-18
,0,0,0,0,Martin,2023-03-19
,0,0,0,0,Martin,2023-03-20
,0,0,0,0,Martin,2023-03-21
,0,0,0,0,Martin,2023-03-24
,0,0,0,0,Martin,2023-03-25
,0,0,0,0,Martin,2023-03-26
,0,0,0,0,Martin,2023-03-27
,0,0,0,0,Martin,2023-03-30
,0,0,0,0,Martin,2023-04-01
,0,0,0,0,Martin,2023-04-02
,0,0,0,0,Martin,2023-04-04
,0,0,0,0,Martin,2023-04-05
,0,0,0,0,Martin,2023-04-07
,0,0,0,0,Martin,2023-04-08
,0,0,0,0,Martin,2023-04-09
,0,0,0,0,Martin,2023-04-10
,0,0,0,0,Martin,2023-04-11
,0,0,0,0,Martin,2023-04-12
,0,0,0,0,Martin,2023-04-13
,0,0,0,0,Martin,2023-04-15
,0,0,0,0,Martin,2023-04-16
,0,0,0,0,Martin,2023-04-17
,0,0,0,0,Martin,2023-04-18
,0,0,0,0,Martin,2023-04-19
,0,0,0,0,Martin,2023-04-20
,0,0,0,0,Martin,2023-04-21
,0,0,0,0,Martin,2023-04-22
,0,0,0,0,Martin,2023-04-23
,0,0,0,0,Martin,2023-04-24
,0,0,0,0,Martin,2023-04-25
,0,0,0,0,Martin,2023-04-26
,0,0,0,0,Martin,2023-04-27
,0,0,0,0,Martin,2023-04-28
,0,0,0,0,Martin,2023-04-30
,0,0,0,0,Martin,2023-05-02
,0,0,0,0,Martin,2023-05-03
,0,0,0,0,Martin,2023-05-04
,0,0,0,0,Martin,2023-05-05
,0,0,0,0,Martin,2023-05-06
,0,0,0,0,McDowell,2022-11-24
,0,0,0,0,McDowell,2023-02-26
,0,0,0,0,McDowell,2023-03-04
,0,0,0,0,McDowell,2023-03-11
,0,0,0,0,McDowell,2023-03-14
,0,0,0,0,McDowell,2023-03-25
,0,0,0,0,McDowell,2023-03-26
,0,0,0,0,McDowell,2023-03-27
,0,0,0,0,McDowell,2023-03-28
,0,0,0,0,McDowell,2023-04-02
,0,0,0,0,McDowell,2023-04-08
,0,0,0,0,McDowell,2023-04-09
,0,0,0,0,McDowell,2023-05-06
,0,0,0,0,Mitchell,2022-11-13
,0,0,0,0,Mitchell,2022-11-19
,0,0,0,0,Mitchell,2022-11-24
,0,0,0,0,Mitchell,2022-11-27
,0,0,0,0,Mitchell,2022-12-07
,0,0,0,0,Mitchell,2022-12-11
,0,0,0,0,Mitchell,2022-12-12
,0,0,0,0,Mitchell,2023-01-18
,0,0,0,0,Mitchell,2023-01-29
,0,0,0,0,Mitchell,2023-02-03
,0,0,0,0,Mitchell,2023-02-04
,0,0,0,0,Mitchell,2023-02-10
,0,0,0,0,Mitchell,2023-02-11
,0,0,0,0,Mitchell,2023-02-12
,0,0,0,0,Mitchell,2023-02-17
,0,0,0,0,Mitchell,2023-02-19
,0,0,0,0,Mitchell,2023-02-25
,0,0,0,0,Mitchell,2023-02-26
,0,0,0,0,Mitchell,2023-03-04
,0,0,0,0,Mitchell,2023-03-07
,0,0,0,0,Mitchell,2023-03-08
,0,0,0,0,Mitchell,2023-03-10
,0,0,0,0,Mitchell,2023-03-11
,0,0,0,0,Mitchell,2023-03-12
,0,0,0,0,Mitchell,2023-03-13
,0,0,0,0,Mitchell,2023-03-14
,0,0,0,0,Mitchell,2023-03-15
,0,0,0,0,Mitchell,2023-03-19
,0,0,0,0,Mitchell,2023-03-23
,0,0,0,0,Mitchell,2023-03-26
,0,0,0,0,Mitchell,2023-03-27
,0,0,0,0,Mitchell,2023-03-28
,0,0,0,0,Mitchell,2023-03-29
,0,0,0,0,Mitchell,2023-03-30
,0,0,0,0,Mitchell,2023-04-01
,0,0,0,0,Mitchell,2023-04-03
,0,0,0,0,Mitchell,2023-04-05
,0,0,0,0,Mitchell,2023-04-07
,0,0,0,0,Mitchell,2023-04-08
,0,0,0,0,Mitchell,2023-04-10
,0,0,0,0,Mitchell,2023-04-12
,0,0,0,0,Mitchell,2023-04-14
,0,0,0,0,Mitchell,2023-04-15
,0,0,0,0,Mitchell,2023-04-16
,0,0,0,0,Mitchell,2023-04-19
,0,0,0,0,Mitchell,2023-04-21
,0,0,0,0,Mitchell,2023-04-25
,0,0,0,0,Mitchell,2023-04-26
,0,0,0,0,Mitchell,2023-04-27
,0,0,0,0,Mitchell,2023-04-29
,0,0,0,0,Mitchell,2023-04-30
,0,0,0,0,Mitchell,2023-05-02
,0,0,0,0,Mitchell,2023-05-05
,0,0,0,0,Montgomery,2022-11-12
,0,0,0,0,Montgomery,2022-11-19
,0,0,0,0,Montgomery,2022-11-21
,0,0,0,0,Montgomery,2022-11-24
,0,0,0,0,Montgomery,2022-11-25
,0,0,0,0,Montgomery,2022-11-27
,0,0,0,0,Montgomery,2022-12-03
,0,0,0,0,Montgomery,2022-12-04
,0,0,0,0,Montgomery,2023-03-04
,0,0,0,0,Montgomery,2023-03-08
,0,0,0,0,Montgomery,2023-03-10
,0,0,0,0,Montgomery,2023-03-11
,0,0,0,0,Montgomery,2023-03-12
,0,0,0,0,Montgomery,2023-03-25
,0,0,0,0,Montgomery,2023-03-29
,0,0,0,0,Montgomery,2023-04-02
,0,0,0,0,Montgomery,2023-04-03
,0,0,0,0,Montgomery,2023-04-04
,0,0,0,0,Montgomery,2023-04-05
,0,0,0,0,Montgomery,2023-04-08
,0,0,0,0,Montgomery,2023-04-09
,0,0,0,0,Montgomery,2023-04-10
,0,0,0,0,Montgomery,2023-04-14
,0,0,0,0,Montgomery,2023-04-15
,0,0,0,0,Montgomery,2023-04-16
,0,0,0,0,Montgomery,2023-04-18
,0,0,0,0,Montgomery,2023-04-19
,0,0,0,0,Montgomery,2023-04-26
,0,0,0,0,Montgomery,2023-04-30
,0,0,0,0,Montgomery,2023-05-01
,0,0,0,0,Montgomery,2023-05-02
,0,0,0,0,Montgomery,2023-05-05
,0,0,0,0,Montgomery,2023-05-06
,0,0,0,0,Moore,2023-04-02
,0,0,0,0,Moore,2023-04-14
,0,0,0,0,Moore,2023-05-06
,0,0,0,0,Nash,2022-11-11
,0,0,0,0,Nash,2023-04-02
,0,0,0,0,Nash,2023-04-09
,0,0,0,0,Nash,2023-04-14
,0,0,0,0,Nash,2023-04-20
,0,0,0,0,Nash,2023-04-21
,0,0,0,0,Nash,2023-04-23
,0,0,0,0,Nash,2023-04-25
,0,0,0,0,Nash,2023-04-26
,0,0,0,0,Nash,2023-04-27
,0,0,0,0,Nash,2023-04-28
,0,0,0,0,Nash,2023-05-05
,0,0,0,0,Northampton,2022-11-11
,0,0,0,0,Northampton,2022-11-13
,0,0,0,0,Northampton,2022-11-20
,0,0,0,0,Northampton,2022-11-24
,0,0,0,0,Northampton,2022-12-03
,0,0,0,0,Northampton,2022-12-04
,0,0,0,0,Northampton,2022-12-10
,0,0,0,0,Northampton,2022-12-18
,0,0,0,0,Northampton,2022-12-25
,0,0,0,0,Northampton,2023-01-14
,0,0,0,0,Northampton,2023-02-04
,0,0,0,0,Northampton,2023-02-25
,0,0,0,0,Northampton,2023-03-05
,0,0,0,0,Northampton,2023-03-06
,0,0,0,0,Northampton,2023-03-12
,0,0,0,0,Northampton,2023-03-18
,0,0,0,0,Northampton,2023-03-19
,0,0,0,0,Northampton,2023-03-20
,0,0,0,0,Northampton,2023-03-23
,0,0,0,0,Northampton,2023-03-24
,0,0,0,0,Northampton,2023-03-25
,0,0,0,0,Northampton,2023-03-26
,0,0,0,0,Northampton,2023-03-28
,0,0,0,0,Northampton,2023-03-29
,0,0,0,0,Northampton,2023-03-31
,0,0,0,0,Northampton,2023-04-01
,0,0,0,0,Northampton,2023-04-02
,0,0,0,0,Northampton,2023-04-03
,0,0,0,0,Northampton,2023-04-04
,0,0,0,0,Northampton,2023-04-07
,0,0,0,0,Northampton,2023-04-08
,0,0,0,0,Northampton,2023-04-09
,0,0,0,0,Northampton,2023-04-10
,0,0,0,0,Northampton,2023-04-11
,0,0,0,0,Northampton,2023-04-12
,0,0,0,0,Northampton,2023-04-13
,0,0,0,0,Northampton,2023-04-14
,0,0,0,0,Northampton,2023-04-15
,0,0,0,0,Northampton,2023-04-17
,0,0,0,0,Northampton,2023-04-18
,0,0,0,0,Northampton,2023-04-19
,0,0,0,0,Northampton,2023-04-20
,0,0,0,0,Northampton,2023-04-23
,0,0,0,0,Northampton,2023-04-25
,0,0,0,0,Northampton,2023-04-27
,0,0,0,0,Northampton,2023-04-28
,0,0,0,0,Northampton,2023-04-29
,0,0,0,0,Northampton,2023-05-01
,0,0,0,0,Northampton,2023-05-06
,0,0,0,0,Onslow,2023-05-06
,0,0,0,0,Orange,2023-04-06
,0,0,0,0,Orange,2023-04-23
,0,0,0,0,Pamlico,2022-11-08
,0,0,0,0,Pamlico,2022-11-09
,0,0,0,0,Pamlico,2022-11-11
,0,0,0,0,Pamlico,2022-11-12
,0,0,0,0,Pamlico,2022-11-15
,0,0,0,0,Pamlico,2022-11-18
,0,0,0,0,Pamlico,2022-11-20
,0,0,0,0,Pamlico,2022-11-23
,0,0,0,0,Pamlico,2022-11-24
,0,0,0,0,Pamlico,2022-11-25
,0,0,0,0,Pamlico,2022-11-26
,0,0,0,0,Pamlico,2022-11-27
,0,0,0,0,Pamlico,2022-11-29
,0,0,0,0,Pamlico,2022-12-01
,0,0,0,0,Pamlico,2022-12-03
,0,0,0,0,Pamlico,2022-12-04
,0,0,0,0,Pamlico,2022-12-07
,0,0,0,0,Pamlico,2022-12-16
,0,0,0,0,Pamlico,2022-12-31
,0,0,0,0,Pamlico,2023-01-11
,0,0,0,0,Pamlico,2023-01-20
,0,0,0,0,Pamlico,2023-01-21
,0,0,0,0,Pamlico,2023-01-22
,0,0,0,0,Pamlico,2023-01-23
,0,0,0,0,Pamlico,2023-01-25
,0,0,0,0,Pamlico,2023-01-28
,0,0,0,0,Pamlico,2023-02-04
,0,0,0,0,Pamlico,2023-02-05
,0,0,0,0,Pamlico,2023-02-18
,0,0,0,0,Pamlico,2023-02-19
,0,0,0,0,Pamlico,2023-02-24
,0,0,0,0,Pamlico,2023-02-25
,0,0,0,0,Pamlico,2023-02-26
,0,0,0,0,Pamlico,2023-03-01
,0,0,0,0,Pamlico,2023-03-03
,0,0,0,0,Pamlico,2023-03-04
,0,0,0,0,Pamlico,2023-03-05
,0,0,0,0,Pamlico,2023-03-06
,0,0,0,0,Pamlico,2023-03-08
,0,0,0,0,Pamlico,2023-03-09
,0,0,0,0,Pamlico,2023-03-10
,0,0,0,0,Pamlico,2023-03-11
,0,0,0,0,Pamlico,2023-03-12
,0,0,0,0,Pamlico,2023-03-13
,0,0,0,0,Pamlico,2023-03-14
,0,0,0,0,Pamlico,2023-03-15
,0,0,0,0,Pamlico,2023-03-19
,0,0,0,0,Pamlico,2023-03-20
,0,0,0,0,Pamlico,2023-03-21
,0,0,0,0,Pamlico,2023-03-22
,0,0,0,0,Pamlico,2023-03-23
,0,0,0,0,Pamlico,2023-03-24
,0,0,0,0,Pamlico,2023-03-26
,0,0,0,0,Pamlico,2023-03-27
,0,0,0,0,Pamlico,2023-03-28
,0,0,0,0,Pamlico,2023-03-30
,0,0,0,0,Pamlico,2023-03-31
,0,0,0,0,Pamlico,2023-04-01
,0,0,0,0,Pamlico,2023-04-04
,0,0,0,0,Pamlico,2023-04-05
,0,0,0,0,Pamlico,2023-04-06
,0,0,0,0,Pamlico,2023-04-07
,0,0,0,0,Pamlico,2023-04-08
,0,0,0,0,Pamlico,2023-04-10
,0,0,0,0,Pamlico,2023-04-14
,0,0,0,0,Pamlico,2023-04-15
,0,0,0,0,Pamlico,2023-04-16
,0,0,0,0,Pamlico,2023-04-18
,0,0,0,0,Pamlico,2023-04-19
,0,0,0,0,Pamlico,2023-04-20
,0,0,0,0,Pamlico,2023-04-21
,0,0,0,0,Pamlico,2023-04-22
,0,0,0,0,Pamlico,2023-04-23
,0,0,0,0,Pamlico,2023-04-24
,0,0,0,0,Pamlico,2023-04-28
,0,0,0,0,Pamlico,2023-04-29
,0,0,0,0,Pamlico,2023-04-30
,0,0,0,0,Pamlico,2023-05-01
,0,0,0,0,Pamlico,2023-05-02
,0,0,0,0,Pamlico,2023-05-03
,0,0,0,0,Pamlico,2023-05-04
,0,0,0,0,Pamlico,2023-05-05
,0,0,0,0,Pamlico,2023-05-06
,0,0,0,0,Pasquotank,2022-11-10
,0,0,0,0,Pasquotank,2022-11-19
,0,0,0,0,Pasquotank,2023-03-09
,0,0,0,0,Pasquotank,2023-03-12
,0,0,0,0,Pasquotank,2023-03-13
,0,0,0,0,Pasquotank,2023-03-14
,0,0,0,0,Pasquotank,2023-03-21
,0,0,0,0,Pasquotank,2023-03-24
,0,0,0,0,Pasquotank,2023-03-29
,0,0,0,0,Pasquotank,2023-04-08
,0,0,0,0,Pasquotank,2023-04-12
,0,0,0,0,Pasquotank,2023-04-13
,0,0,0,0,Pasquotank,2023-04-24
,0,0,0,0,Pasquotank,2023-04-30
,0,0,0,0,Pasquotank,2023-05-01
,0,0,0,0,Pasquotank,2023-05-04
,0,0,0,0,Pasquotank,2023-05-05
,0,0,0,0,Pasquotank,2023-05-06
,0,0,0,0,Pender,2022-12-04
,0,0,0,0,Pender,2023-03-16
,0,0,0,0,Pender,2023-03-18
,0,0,0,0,Pender,2023-03-20
,0,0,0,0,Pender,2023-04-09
,0,0,0,0,Pender,2023-04-10
,0,0,0,0,Pender,2023-04-13
,0,0,0,0,Pender,2023-04-14
,0,0,0,0,Pender,2023-04-15
,0,0,0,0,Pender,2023-04-16
,0,0,0,0,Pender,2023-04-18
,0,0,0,0,Pender,2023-04-19
,0,0,0,0,Pender,2023-04-20
,0,0,0,0,Pender,2023-04-22
,0,0,0,0,Pender,2023-04-28
,0,0,0,0,Pender,2023-05-02
,0,0,0,0,Pender,2023-05-04
,0,0,0,0,Perquimans,2022-11-09
,0,0,0,0,Perquimans,2022-11-12
,0,0,0,0,Perquimans,2022-11-18
,0,0,0,0,Perquimans,2022-11-19
,0,0,0,0,Perquimans,2022-11-20
,0,0,0,0,Perquimans,2022-11-23
,0,0,0,0,Perquimans,2022-11-27
,0,0,0,0,Perquimans,2022-12-01
,0,0,0,0,Perquimans,2022-12-04
,0,0,0,0,Perquimans,2022-12-05
,0,0,0,0,Perquimans,2022-12-09
,0,0,0,0,Perquimans,2022-12-10
,0,0,0,0,Perquimans,2022-12-11
,0,0,0,0,Perquimans,2022-12-14
,0,0,0,0,Perquimans,2023-01-08
,0,0,0,0,Perquimans,2023-01-12
,0,0,0,0,Perquimans,2023-02-02
,0,0,0,0,Perquimans,2023-02-03
,0,0,0,0,Perquimans,2023-02-11
,0,0,0,0,Perquimans,2023-02-17
,0,0,0,0,Perquimans,2023-02-20
,0,0,0,0,Perquimans,2023-02-25
,0,0,0,0,Perquimans,2023-03-01
,0,0,0,0,Perquimans,2023-03-02
,0,0,0,0,Perquimans,2023-03-06
,0,0,0,0,Perquimans,2023-03-10
,0,0,0,0,Perquimans,2023-03-12
,0,0,0,0,Perquimans,2023-03-14
,0,0,0,0,Perquimans,2023-03-15
,0,0,0,0,Perquimans,2023-03-20
,0,0,0,0,Perquimans,2023-03-21
,0,0,0,0,Perquimans,2023-03-23
,0,0,0,0,Perquimans,2023-03-24
,0,0,0,0,Perquimans,2023-03-25
,0,0,0,0,Perquimans,2023-03-26
,0,0,0,0,Perquimans,2023-03-28
,0,0,0,0,Perquimans,2023-03-29
,0,0,0,0,Perquimans,2023-04-01
,0,0,0,0,Perquimans,2023-04-08
,0,0,0,0,Perquimans,2023-04-09
,0,0,0,0,Perquimans,2023-04-13
,0,0,0,0,Perquimans,2023-04-14
,0,0,0,0,Perquimans,2023-04-15
,0,0,0,0,Perquimans,2023-04-16
,0,0,0,0,Perquimans,2023-04-17
,0,0,0,0,Perquimans,2023-04-19
,0,0,0,0,Perquimans,2023-04-20
,0,0,0,0,Perquimans,2023-04-21
,0,0,0,0,Perquimans,2023-04-22
,0,0,0,0,Perquimans,2023-04-23
,0,0,0,0,Perquimans,2023-04-26
,0,0,0,0,Perquimans,2023-04-27
,0,0,0,0,Perquimans,2023-04-28
,0,0,0,0,Perquimans,2023-04-29
,0,0,0,0,Perquimans,2023-04-30
,0,0,0,0,Perquimans,2023-05-01
,0,0,0,0,Perquimans,2023-05-03
,0,0,0,0,Perquimans,2023-05-04
,0,0,0,0,Perquimans,2023-05-05
,0,0,0,0,Perquimans,2023-05-06
,0,0,0,0,Person,2022-11-24
,0,0,0,0,Person,2023-01-31
,0,0,0,0,Person,2023-03-01
,0,0,0,0,Person,2023-03-11
,0,0,0,0,Person,2023-03-16
,0,0,0,0,Person,2023-03-17
,0,0,0,0,Person,2023-03-25
,0,0,0,0,Person,2023-03-29
,0,0,0,0,Person,2023-03-30
,0,0,0,0,Person,2023-04-02
,0,0,0,0,Person,2023-04-06
,0,0,0,0,Person,2023-04-08
,0,0,0,0,Person,2023-04-09
,0,0,0,0,Person,2023-04-11
,0,0,0,0,Person,2023-04-13
,0,0,0,0,Person,2023-04-16
,0,0,0,0,Person,2023-04-19
,0,0,0,0,Person,2023-04-25
,0,0,0,0,Person,2023-04-26
,0,0,0,0,Person,2023-04-29
,0,0,0,0,Person,2023-04-30
,0,0,0,0,Person,2023-05-03
,0,0,0,0,Pitt,2023-03-26
,0,0,0,0,Pitt,2023-05-04
,0,0,0,0,Polk,2022-11-13
,0,0,0,0,Polk,2023-01-07
,0,0,0,0,Polk,2023-02-05
,0,0,0,0,Polk,2023-02-17
,0,0,0,0,Polk,2023-02-21
,0,0,0,0,Polk,2023-02-22
,0,0,0,0,Polk,2023-02-23
,0,0,0,0,Polk,2023-02-25
,0,0,0,0,Polk,2023-02-27
,0,0,0,0,Polk,2023-03-05
,0,0,0,0,Polk,2023-03-06
,0,0,0,0,Polk,2023-03-08
,0,0,0,0,Polk,2023-03-09
,0,0,0,0,Polk,2023-03-12
,0,0,0,0,Polk,2023-03-16
,0,0,0,0,Polk,2023-03-17
,0,0,0,0,Polk,2023-03-19
,0,0,0,0,Polk,2023-03-21
,0,0,0,0,Polk,2023-03-23
,0,0,0,0,Polk,2023-03-25
,0,0,0,0,Polk,2023-03-26
,0,0,0,0,Polk,2023-03-30
,0,0,0,0,Polk,2023-03-31
,0,0,0,0,Polk,2023-04-01
,0,0,0,0,Polk,2023-04-03
,0,0,0,0,Polk,2023-04-05
,0,0,0,0,Polk,2023-04-06
,0,0,0,0,Polk,2023-04-08
,0,0,0,0,Polk,2023-04-15
,0,0,0,0,Polk,2023-04-16
,0,0,0,0,Polk,2023-04-18
,0,0,0,0,Polk,2023-04-19
,0,0,0,0,Polk,2023-04-22
,0,0,0,0,Polk,2023-04-23
,0,0,0,0,Polk,2023-04-24
,0,0,0,0,Polk,2023-04-25
,0,0,0,0,Polk,2023-04-28
,0,0,0,0,Polk,2023-05-01
,0,0,0,0,Polk,2023-05-02
,0,0,0,0,Polk,2023-05-03
,0,0,0,0,Polk,2023-05-04
,0,0,0,0,Polk,2023-05-05
,0,0,0,0,Randolph,2023-04-22
,0,0,0,0,Richmond,2022-11-12
,0,0,0,0,Richmond,2022-11-20
,0,0,0,0,Richmond,2022-11-25
,0,0,0,0,Richmond,2023-03-29
,0,0,0,0,Richmond,2023-03-31
,0,0,0,0,Richmond,2023-04-01
,0,0,0,0,Richmond,2023-04-09
,0,0,0,0,Richmond,2023-04-11
,0,0,0,0,Richmond,2023-04-13
,0,0,0,0,Richmond,2023-04-14
,0,0,0,0,Richmond,2023-04-16
,0,0,0,0,Richmond,2023-04-21
,0,0,0,0,Richmond,2023-04-23
,0,0,0,0,Richmond,2023-04-26
,0,0,0,0,Richmond,2023-04-29
,0,0,0,0,Richmond,2023-05-06
,0,0,0,0,Robeson,2023-04-08
,0,0,0,0,Robeson,2023-04-29
,0,0,0,0,Rockingham,2023-03-30
,0,0,0,0,Rockingham,2023-04-09
,0,0,0,0,Rockingham,2023-04-28
,0,0,0,0,Rutherford,2023-02-22
,0,0,0,0,Rutherford,2023-02-25
,0,0,0,0,Rutherford,2023-04-01
,0,0,0,0,Rutherford,2023-04-03
,0,0,0,0,Rutherford,2023-04-13
,0,0,0,0,Rutherford,2023-04-18
,0,0,0,0,Rutherford,2023-04-22
,0,0,0,0,Rutherford,2023-04-23
,0,0,0,0,Sampson,2023-03-09
,0,0,0,0,Sampson,2023-03-27
,0,0,0,0,Sampson,2023-03-30
,0,0,0,0,Sampson,2023-04-08
,0,0,0,0,Sampson,2023-04-09
,0,0,0,0,Sampson,2023-04-14
,0,0,0,0,Sampson,2023-04-16
,0,0,0,0,Sampson,2023-04-23
,0,0,0,0,Sampson,2023-04-24
,0,0,0,0,Sampson,2023-04-25
,0,0,0,0,Sampson,2023-04-27
,0,0,0,0,Sampson,2023-05-02
,0,0,0,0,Sampson,2023-05-03
,0,0,0,0,Scotland,2022-11-12
,0,0,0,0,Scotland,2022-11-18
,0,0,0,0,Scotland,2022-11-26
,0,0,0,0,Scotland,2023-03-25
,0,0,0,0,Scotland,2023-04-02
,0,0,0,0,Scotland,2023-04-06
,0,0,0,0,Scotland,2023-04-09
,0,0,0,0,Scotland,2023-04-12
,0,0,0,0,Scotland,2023-04-21
,0,0,0,0,Scotland,2023-04-22
,0,0,0,0,Scotland,2023-04-23
,0,0,0,0,Scotland,2023-04-24
,0,0,0,0,Scotland,2023-04-26
,0,0,0,0,Scotland,2023-04-27
,0,0,0,0,Scotland,2023-04-28
,0,0,0,0,Scotland,2023-04-30
,0,0,0,0,Scotland,2023-05-01
,0,0,0,0,Scotland,2023-05-05
,0,0,0,0,Stanly,2023-04-11
,0,0,0,0,Stanly,2023-04-16
,0,0,0,0,Stanly,2023-04-22
,0,0,0,0,Stanly,2023-04-23
,0,0,0,0,Stanly,2023-05-06
,0,0,0,0,Stokes,2023-02-25
,0,0,0,0,Stokes,2023-03-18
,0,0,0,0,Stokes,2023-04-02
,0,0,0,0,Stokes,2023-04-16
,0,0,0,0,Surry,2023-04-21
,0,0,0,0,Surry,2023-04-25
,0,0,0,0,Swain,2022-11-20
,0,0,0,0,Swain,2022-11-24
,0,0,0,0,Swain,2022-12-17
,0,0,0,0,Swain,2023-01-26
,0,0,0,0,Swain,2023-01-29
,0,0,0,0,Swain,2023-02-08
,0,0,0,0,Swain,2023-02-10
,0,0,0,0,Swain,2023-02-18
,0,0,0,0,Swain,2023-02-20
,0,0,0,0,Swain,2023-02-25
,0,0,0,0,Swain,2023-02-26
,0,0,0,0,Swain,2023-03-07
,0,0,0,0,Swain,2023-03-16
,0,0,0,0,Swain,2023-03-17
,0,0,0,0,Swain,2023-03-18
,0,0,0,0,Swain,2023-03-19
,0,0,0,0,Swain,2023-03-25
,0,0,0,0,Swain,2023-03-26
,0,0,0,0,Swain,2023-03-30
,0,0,0,0,Swain,2023-04-06
,0,0,0,0,Swain,2023-04-07
,0,0,0,0,Swain,2023-04-08
,0,0,0,0,Swain,2023-04-09
,0,0,0,0,Swain,2023-04-12
,0,0,0,0,Swain,2023-04-14
,0,0,0,0,Swain,2023-04-15
,0,0,0,0,Swain,2023-04-19
,0,0,0,0,Swain,2023-04-21
,0,0,0,0,Swain,2023-04-22
,0,0,0,0,Swain,2023-04-24
,0,0,0,0,Swain,2023-04-27
,0,0,0,0,Swain,2023-04-30
,0,0,0,0,Swain,2023-05-03
,0,0,0,0,Swain,2023-05-04
,0,0,0,0,Swain,2023-05-05
,0,0,0,0,Swain,2023-05-06
,0,0,0,0,Transylvania,2022-11-15
,0,0,0,0,Transylvania,2023-01-28
,0,0,0,0,Transylvania,2023-02-14
,0,0,0,0,Transylvania,2023-03-02
,0,0,0,0,Transylvania,2023-03-09
,0,0,0,0,Transylvania,2023-03-12
,0,0,0,0,Transylvania,2023-03-13
,0,0,0,0,Transylvania,2023-03-19
,0,0,0,0,Transylvania,2023-03-22
,0,0,0,0,Transylvania,2023-03-28
,0,0,0,0,Transylvania,2023-03-30
,0,0,0,0,Transylvania,2023-04-01
,0,0,0,0,Transylvania,2023-04-09
,0,0,0,0,Transylvania,2023-04-20
,0,0,0,0,Transylvania,2023-05-03
,0,0,0,0,Transylvania,2023-05-06
,0,0,0,0,Tyrrell,2022-11-08
,0,0,0,0,Tyrrell,2022-11-09
,0,0,0,0,Tyrrell,2022-11-10
,0,0,0,0,Tyrrell,2022-11-11
,0,0,0,0,Tyrrell,2022-11-12
,0,0,0,0,Tyrrell,2022-11-14
,0,0,0,0,Tyrrell,2022-11-15
,0,0,0,0,Tyrrell,2022-11-16
,0,0,0,0,Tyrrell,2022-11-17
,0,0,0,0,Tyrrell,2022-11-18
,0,0,0,0,Tyrrell,2022-11-19
,0,0,0,0,Tyrrell,2022-11-21
,0,0,0,0,Tyrrell,2022-11-22
,0,0,0,0,Tyrrell,2022-11-23
,0,0,0,0,Tyrrell,2022-11-24
,0,0,0,0,Tyrrell,2022-11-25
,0,0,0,0,Tyrrell,2022-11-26
,0,0,0,0,Tyrrell,2022-11-27
,0,0,0,0,Tyrrell,2022-11-28
,0,0,0,0,Tyrrell,2022-11-29
,0,0,0,0,Tyrrell,2022-11-30
,0,0,0,0,Tyrrell,2022-12-01
,0,0,0,0,Tyrrell,2022-12-02
,0,0,0,0,Tyrrell,2022-12-03
,0,0,0,0,Tyrrell,2022-12-04
,0,0,0,0,Tyrrell,2022-12-05
,0,0,0,0,Tyrrell,2022-12-06
,0,0,0,0,Tyrrell,2022-12-07
,0,0,0,0,Tyrrell,2022-12-08
,0,0,0,0,Tyrrell,2022-12-09
,0,0,0,0,Tyrrell,2022-12-11
,0,0,0,0,Tyrrell,2022-12-12
,0,0,0,0,Tyrrell,2022-12-14
,0,0,0,0,Tyrrell,2022-12-16
,0,0,0,0,Tyrrell,2022-12-17
,0,0,0,0,Tyrrell,2022-12-18
,0,0,0,0,Tyrrell,2022-12-20
,0,0,0,0,Tyrrell,2022-12-22
,0,0,0,0,Tyrrell,2022-12-23
,0,0,0,0,Tyrrell,2022-12-24
,0,0,0,0,Tyrrell,2022-12-25
,0,0,0,0,Tyrrell,2022-12-26
,0,0,0,0,Tyrrell,2023-01-01
,0,0,0,0,Tyrrell,2023-01-02
,0,0,0,0,Tyrrell,2023-01-04
,0,0,0,0,Tyrrell,2023-01-05
,0,0,0,0,Tyrrell,2023-01-07
,0,0,0,0,Tyrrell,2023-01-08
,0,0,0,0,Tyrrell,2023-01-10
,0,0,0,0,Tyrrell,2023-01-12
,0,0,0,0,Tyrrell,2023-01-13
,0,0,0,0,Tyrrell,2023-01-14
,0,0,0,0,Tyrrell,2023-01-15
,0,0,0,0,Tyrrell,2023-01-16
,0,0,0,0,Tyrrell,2023-01-18
,0,0,0,0,Tyrrell,2023-01-19
,0,0,0,0,Tyrrell,2023-01-20
,0,0,0,0,Tyrrell,2023-01-21
,0,0,0,0,Tyrrell,2023-01-23
,0,0,0,0,Tyrrell,2023-01-26
,0,0,0,0,Tyrrell,2023-01-27
,0,0,0,0,Tyrrell,2023-01-29
,0,0,0,0,Tyrrell,2023-02-01
,0,0,0,0,Tyrrell,2023-02-03
,0,0,0,0,Tyrrell,2023-02-05
,0,0,0,0,Tyrrell,2023-02-08
,0,0,0,0,Tyrrell,2023-02-12
,0,0,0,0,Tyrrell,2023-02-13
,0,0,0,0,Tyrrell,2023-02-15
,0,0,0,0,Tyrrell,2023-02-17
,0,0,0,0,Tyrrell,2023-02-18
,0,0,0,0,Tyrrell,2023-02-19
,0,0,0,0,Tyrrell,2023-02-21
,0,0,0,0,Tyrrell,2023-02-22
,0,0,0,0,Tyrrell,2023-02-24
,0,0,0,0,Tyrrell,2023-02-25
,0,0,0,0,Tyrrell,2023-02-26
,0,0,0,0,Tyrrell,2023-02-27
,0,0,0,0,Tyrrell,2023-02-28
,0,0,0,0,Tyrrell,2023-03-01
,0,0,0,0,Tyrrell,2023-03-03
,0,0,0,0,Tyrrell,2023-03-04
,0,0,0,0,Tyrrell,2023-03-05
,0,0,0,0,Tyrrell,2023-03-06
,0,0,0,0,Tyrrell,2023-03-07
,0,0,0,0,Tyrrell,2023-03-08
,0,0,0,0,Tyrrell,2023-03-09
,0,0,0,0,Tyrrell,2023-03-10
,0,0,0,0,Tyrrell,2023-03-11
,0,0,0,0,Tyrrell,2023-03-12
,0,0,0,0,Tyrrell,2023-03-13
,0,0,0,0,Tyrrell,2023-03-14
,0,0,0,0,Tyrrell,2023-03-15
,0,0,0,0,Tyrrell,2023-03-16
,0,0,0,0,Tyrrell,2023-03-17
,0,0,0,0,Tyrrell,2023-03-18
,0,0,0,0,Tyrrell,2023-03-19
,0,0,0,0,Tyrrell,2023-03-20
,0,0,0,0,Tyrrell,2023-03-21
,0,0,0,0,Tyrrell,2023-03-22
,0,0,0,0,Tyrrell,2023-03-24
,0,0,0,0,Tyrrell,2023-03-25
,0,0,0,0,Tyrrell,2023-03-26
,0,0,0,0,Tyrrell,2023-03-27
,0,0,0,0,Tyrrell,2023-03-28
,0,0,0,0,Tyrrell,2023-03-29
,0,0,0,0,Tyrrell,2023-03-31
,0,0,0,0,Tyrrell,2023-04-01
,0,0,0,0,Tyrrell,2023-04-02
,0,0,0,0,Tyrrell,2023-04-04
,0,0,0,0,Tyrrell,2023-04-06
,0,0,0,0,Tyrrell,2023-04-07
,0,0,0,0,Tyrrell,2023-04-08
,0,0,0,0,Tyrrell,2023-04-09
,0,0,0,0,Tyrrell,2023-04-10
,0,0,0,0,Tyrrell,2023-04-12
,0,0,0,0,Tyrrell,2023-04-13
,0,0,0,0,Tyrrell,2023-04-14
,0,0,0,0,Tyrrell,2023-04-15
,0,0,0,0,Tyrrell,2023-04-16
,0,0,0,0,Tyrrell,2023-04-17
,0,0,0,0,Tyrrell,2023-04-18
,0,0,0,0,Tyrrell,2023-04-19
,0,0,0,0,Tyrrell,2023-04-20
,0,0,0,0,Tyrrell,2023-04-21
,0,0,0,0,Tyrrell,2023-04-22
,0,0,0,0,Tyrrell,2023-04-23
,0,0,0,0,Tyrrell,2023-04-24
,0,0,0,0,Tyrrell,2023-04-25
,0,0,0,0,Tyrrell,2023-04-26
,0,0,0,0,Tyrrell,2023-04-27
,0,0,0,0,Tyrrell,2023-04-28
,0,0,0,0,Tyrrell,2023-04-29
,0,0,0,0,Tyrrell,2023-04-30
,0,0,0,0,Tyrrell,2023-05-01
,0,0,0,0,Tyrrell,2023-05-02
,0,0,0,0,Tyrrell,2023-05-03
,0,0,0,0,Tyrrell,2023-05-04
,0,0,0,0,Tyrrell,2023-05-05
,0,0,0,0,Tyrrell,2023-05-06
,0,0,0,0,Vance,2022-11-11
,0,0,0,0,Vance,2022-11-13
,0,0,0,0,Vance,2022-11-16
,0,0,0,0,Vance,2022-11-24
,0,0,0,0,Vance,2023-03-05
,0,0,0,0,Vance,2023-03-10
,0,0,0,0,Vance,2023-04-09
,0,0,0,0,Vance,2023-04-24
,0,0,0,0,Vance,2023-04-30
,0,0,0,0,Vance,2023-05-04
,0,0,0,0,Warren,2022-11-10
,0,0,0,0,Warren,2022-11-12
,0,0,0,0,Warren,2022-11-13
,0,0,0,0,Warren,2022-11-26
,0,0,0,0,Warren,2022-12-03
,0,0,0,0,Warren,2022-12-04
,0,0,0,0,Warren,2023-02-04
,0,0,0,0,Warren,2023-02-24
,0,0,0,0,Warren,2023-03-04
,0,0,0,0,Warren,2023-03-09
,0,0,0,0,Warren,2023-03-11
,0,0,0,0,Warren,2023-03-13
,0,0,0,0,Warren,2023-03-14
,0,0,0,0,Warren,2023-03-15
,0,0,0,0,Warren,2023-03-16
,0,0,0,0,Warren,2023-03-19
,0,0,0,0,Warren,2023-03-20
,0,0,0,0,Warren,2023-03-21
,0,0,0,0,Warren,2023-03-22
,0,0,0,0,Warren,2023-03-25
,0,0,0,0,Warren,2023-03-28
,0,0,0,0,Warren,2023-04-01
,0,0,0,0,Warren,2023-04-02
,0,0,0,0,Warren,2023-04-04
,0,0,0,0,Warren,2023-04-08
,0,0,0,0,Warren,2023-04-11
,0,0,0,0,Warren,2023-04-14
,0,0,0,0,Warren,2023-04-16
,0,0,0,0,Warren,2023-04-17
,0,0,0,0,Warren,2023-04-24
,0,0,0,0,Warren,2023-04-26
,0,0,0,0,Warren,2023-04-27
,0,0,0,0,Warren,2023-04-30
,0,0,0,0,Warren,2023-05-01
,0,0,0,0,Warren,2023-05-02
,0,0,0,0,Warren,2023-05-04
,0,0,0,0,Warren,2023-05-05
,0,0,0,0,Warren,2023-05-06
,0,0,0,0,Washington,2022-11-11
,0,0,0,0,Washington,2022-11-12
,0,0,0,0,Washington,2022-11-13
,0,0,0,0,Washington,2022-11-14
,0,0,0,0,Washington,2022-11-15
,0,0,0,0,Washington,2022-11-16
,0,0,0,0,Washington,2022-11-18
,0,0,0,0,Washington,2022-11-19
,0,0,0,0,Washington,2022-11-21
,0,0,0,0,Washington,2022-11-22
,0,0,0,0,Washington,2022-11-24
,0,0,0,0,Washington,2022-11-25
,0,0,0,0,Washington,2022-11-28
,0,0,0,0,Washington,2022-12-02
,0,0,0,0,Washington,2022-12-04
,0,0,0,0,Washington,2022-12-05
,0,0,0,0,Washington,2022-12-18
,0,0,0,0,Washington,2023-01-01
,0,0,0,0,Washington,2023-01-12
,0,0,0,0,Washington,2023-01-29
,0,0,0,0,Washington,2023-02-05
,0,0,0,0,Washington,2023-02-11
,0,0,0,0,Washington,2023-02-16
,0,0,0,0,Washington,2023-02-19
,0,0,0,0,Washington,2023-02-22
,0,0,0,0,Washington,2023-02-23
,0,0,0,0,Washington,2023-02-26
,0,0,0,0,Washington,2023-02-27
,0,0,0,0,Washington,2023-03-02
,0,0,0,0,Washington,2023-03-03
,0,0,0,0,Washington,2023-03-04
,0,0,0,0,Washington,2023-03-05
,0,0,0,0,Washington,2023-03-08
,0,0,0,0,Washington,2023-03-10
,0,0,0,0,Washington,2023-03-11
,0,0,0,0,Washington,2023-03-12
,0,0,0,0,Washington,2023-03-14
,0,0,0,0,Washington,2023-03-18
,0,0,0,0,Washington,2023-03-22
,0,0,0,0,Washington,2023-03-23
,0,0,0,0,Washington,2023-03-24
,0,0,0,0,Washington,2023-03-26
,0,0,0,0,Washington,2023-03-27
,0,0,0,0,Washington,2023-03-28
,0,0,0,0,Washington,2023-03-29
,0,0,0,0,Washington,2023-03-31
,0,0,0,0,Washington,2023-04-02
,0,0,0,0,Washington,2023-04-03
,0,0,0,0,Washington,2023-04-05
,0,0,0,0,Washington,2023-04-06
,0,0,0,0,Washington,2023-04-07
,0,0,0,0,Washington,2023-04-08
,0,0,0,0,Washington,2023-04-11
,0,0,0,0,Washington,2023-04-13
,0,0,0,0,Washington,2023-04-14
,0,0,0,0,Washington,2023-04-15
,0,0,0,0,Washington,2023-04-16
,0,0,0,0,Washington,2023-04-17
,0,0,0,0,Washington,2023-04-18
,0,0,0,0,Washington,2023-04-20
,0,0,0,0,Washington,2023-04-22
,0,0,0,0,Washington,2023-04-23
,0,0,0,0,Washington,2023-04-24
,0,0,0,0,Washington,2023-04-26
,0,0,0,0,Washington,2023-04-27
,0,0,0,0,Washington,2023-04-28
,0,0,0,0,Washington,2023-04-29
,0,0,0,0,Washington,2023-04-30
,0,0,0,0,Washington,2023-05-01
,0,0,0,0,Washington,2023-05-02
,0,0,0,0,Washington,2023-05-03
,0,0,0,0,Washington,2023-05-04
,0,0,0,0,Washington,2023-05-05
,0,0,0,0,Washington,2023-05-06
,0,0,0,0,Watauga,2022-11-19
,0,0,0,0,Watauga,2022-12-23
,0,0,0,0,Watauga,2023-02-12
,0,0,0,0,Watauga,2023-03-18
,0,0,0,0,Watauga,2023-03-25
,0,0,0,0,Watauga,2023-03-30
,0,0,0,0,Watauga,2023-04-01
,0,0,0,0,Watauga,2023-04-07
,0,0,0,0,Watauga,2023-04-08
,0,0,0,0,Watauga,2023-04-13
,0,0,0,0,Watauga,2023-04-22
,0,0,0,0,Watauga,2023-04-23
,0,0,0,0,Watauga,2023-05-02
,0,0,0,0,Wayne,2023-04-11
,0,0,0,0,Wayne,2023-04-16
,0,0,0,0,Wayne,2023-05-04
,0,0,0,0,Wayne,2023-05-06
,0,0,0,0,Wilkes,2023-04-16
,0,0,0,0,Wilkes,2023-04-20
,0,0,0,0,Wilkes,2023-04-21
,0,0,0,0,Wilkes,2023-04-22
,0,0,0,0,Wilkes,2023-04-23
,0,0,0,0,Wilson,2023-03-05
,0,0,0,0,Wilson,2023-04-01
,0,0,0,0,Wilson,2023-04-08
,0,0,0,0,Wilson,2023-04-09
,0,0,0,0,Wilson,2023-04-10
,0,0,0,0,Wilson,2023-04-14
,0,0,0,0,Wilson,2023-04-23
,0,0,0,0,Wilson,2023-04-27
,0,0,0,0,Wilson,2023-04-28
,0,0,0,0,Wilson,2023-04-29
,0,0,0,0,Wilson,2023-04-30
,0,0,0,0,Wilson,2023-05-06
,0,0,0,0,Yadkin,2023-03-11
,0,0,0,0,Yadkin,2023-04-10
,0,0,0,0,Yadkin,2023-04-15
,0,0,0,0,Yadkin,2023-04-16
,0,0,0,0,Yadkin,2023-04-19
,0,0,0,0,Yadkin,2023-04-20
,0,0,0,0,Yadkin,2023-04-22
,0,0,0,0,Yadkin,2023-05-06
,0,0,0,0,Yancey,2022-11-10
,0,0,0,0,Yancey,2022-11-11
,0,0,0,0,Yancey,2022-11-13
,0,0,0,0,Yancey,2022-11-14
,0,0,0,0,Yancey,2022-11-15
,0,0,0,0,Yancey,2022-11-16
,0,0,0,0,Yancey,2022-11-20
,0,0,0,0,Yancey,2022-11-23
,0,0,0,0,Yancey,2022-11-27
,0,0,0,0,Yancey,2022-12-02
,0,0,0,0,Yancey,2022-12-04
,0,0,0,0,Yancey,2022-12-11
,0,0,0,0,Yancey,2022-12-22
,0,0,0,0,Yancey,2022-12-24
,0,0,0,0,Yancey,2023-01-07
,0,0,0,0,Yancey,2023-01-22
,0,0,0,0,Yancey,2023-01-26
,0,0,0,0,Yancey,2023-01-31
,0,0,0,0,Yancey,2023-02-11
,0,0,0,0,Yancey,2023-02-14
,0,0,0,0,Yancey,2023-02-15
,0,0,0,0,Yancey,2023-02-17
,0,0,0,0,Yancey,2023-02-18
,0,0,0,0,Yancey,2023-02-22
,0,0,0,0,Yancey,2023-02-25
,0,0,0,0,Yancey,2023-02-26
,0,0,0,0,Yancey,2023-02-27
,0,0,0,0,Yancey,2023-03-02
,0,0,0,0,Yancey,2023-03-03
,0,0,0,0,Yancey,2023-03-04
,0,0,0,0,Yancey,2023-03-07
,0,0,0,0,Yancey,2023-03-09
,0,0,0,0,Yancey,2023-03-14
,0,0,0,0,Yancey,2023-03-17
,0,0,0,0,Yancey,2023-03-18
,0,0,0,0,Yancey,2023-03-19
,0,0,0,0,Yancey,2023-03-20
,0,0,0,0,Yancey,2023-03-22
,0,0,0,0,Yancey,2023-03-25
,0,0,0,0,Yancey,2023-03-26
,0,0,0,0,Yancey,2023-03-29
,0,0,0,0,Yancey,2023-03-30
,0,0,0,0,Yancey,2023-03-31
,0,0,0,0,Yancey,2023-04-01
,0,0,0,0,Yancey,2023-04-02
,0,0,0,0,Yancey,2023-04-09
,0,0,0,0,Yancey,2023-04-15
,0,0,0,0,Yancey,2023-04-18
,0,0,0,0,Yancey,2023-04-19
,0,0,0,0,Yancey,2023-04-20
,0,0,0,0,Yancey,2023-04-21
,0,0,0,0,Yancey,2023-04-23
,0,0,0,0,Yancey,2023-04-25
,0,0,0,0,Yancey,2023-04-27
,0,0,0,0,Yancey,2023-04-28
,0,0,0,0,Yancey,2023-04-29
,0,0,0,0,Yancey,2023-05-02
,0,0,0,0,Yancey,2023-05-04
,0,0,0,0,Yancey,2023-05-05
,0,0,0,0,Yancey,2023-05-06
0,7,0,7,0,Alamance,2023-03-29
0,3,0,3,0,Alamance,2023-04-01
0,1,0,1,0,Alamance,2023-04-09
0,1,0,1,0,Alamance,2023-04-22
0,3,0,3,0,Alamance,2023-05-06
0,1,0,1,0,Alexander,2022-11-18
0,2,0,2,0,Alexander,2022-11-19
0,1,0,1,0,Alexander,2022-11-24
0,2,0,2,0,Alexander,2022-12-04
0,2,0,2,0,Alexander,2022-12-25
0,4,0,4,0,Alexander,2023-01-14
0,1,0,1,0,Alexander,2023-01-21
0,2,0,2,0,Alexander,2023-01-22
0,1,0,1,0,Alexander,2023-02-05
0,4,0,4,0,Alexander,2023-02-16
0,1,0,1,0,Alexander,2023-02-18
0,1,0,1,0,Alexander,2023-02-25
0,1,0,1,0,Alexander,2023-02-27
0,1,0,1,0,Alexander,2023-03-01
0,3,0,3,0,Alexander,2023-03-02
0,1,0,1,0,Alexander,2023-03-03
0,3,0,3,0,Alexander,2023-03-06
0,1,0,1,0,Alexander,2023-03-08
0,1,0,1,0,Alexander,2023-03-11
0,1,0,1,0,Alexander,2023-03-16
0,1,0,1,0,Alexander,2023-03-19
0,2,0,2,0,Alexander,2023-03-23
0,2,0,2,0,Alexander,2023-03-30
0,2,0,2,0,Alexander,2023-04-04
0,1,0,1,0,Alexander,2023-04-06
0,1,0,1,0,Alexander,2023-04-19
0,1,0,1,0,Alexander,2023-04-28
0,1,0,1,0,Alexander,2023-05-02
0,1,0,1,0,Alleghany,2022-11-16
0,1,0,1,0,Alleghany,2022-11-17
0,1,0,1,0,Alleghany,2022-12-06
0,1,0,1,0,Alleghany,2022-12-08
0,4,0,4,0,Alleghany,2022-12-19
0,1,0,1,0,Alleghany,2023-01-05
0,1,0,1,0,Alleghany,2023-01-17
0,1,0,1,0,Alleghany,2023-01-22
0,2,0,2,0,Alleghany,2023-01-28
0,1,0,1,0,Alleghany,2023-02-05
0,2,0,2,0,Alleghany,2023-02-12
0,1,0,1,0,Alleghany,2023-02-18
0,2,0,2,0,Alleghany,2023-02-28
0,1,0,1,0,Alleghany,2023-03-02
0,2,0,2,0,Alleghany,2023-03-04
0,1,0,1,0,Alleghany,2023-03-06
0,3,0,3,0,Alleghany,2023-03-07
0,1,0,1,0,Alleghany,2023-03-13
0,2,0,2,0,Alleghany,2023-03-26
0,1,0,1,0,Alleghany,2023-03-28
0,1,0,1,0,Alleghany,2023-03-30
0,1,0,1,0,Alleghany,2023-04-07
0,3,0,3,0,Anson,2022-11-11
0,4,0,4,0,Anson,2022-11-13
0,1,0,1,0,Anson,2022-11-14
0,1,0,1,0,Anson,2022-11-16
0,3,0,3,0,Anson,2022-11-27
0,2,0,2,0,Anson,2022-12-01
0,2,0,2,0,Anson,2022-12-02
0,1,0,1,0,Anson,2022-12-04
0,3,0,3,0,Anson,2022-12-06
0,5,0,5,0,Anson,2023-01-01
0,3,0,3,0,Anson,2023-01-07
0,1,0,1,0,Anson,2023-01-14
0,2,0,2,0,Anson,2023-01-15
0,1,0,1,0,Anson,2023-02-15
0,4,0,4,0,Anson,2023-02-17
0,3,0,3,0,Anson,2023-02-19
0,1,0,1,0,Anson,2023-02-28
0,2,0,2,0,Anson,2023-03-03
0,3,0,3,0,Anson,2023-03-04
0,1,0,1,0,Anson,2023-03-07
0,1,0,1,0,Anson,2023-03-11
0,2,0,2,0,Anson,2023-03-23
0,1,0,1,0,Anson,2023-03-31
0,1,0,1,0,Anson,2023-04-04
0,1,0,1,0,Anson,2023-04-06
0,1,0,1,0,Anson,2023-04-09
0,1,0,1,0,Anson,2023-04-10
0,1,0,1,0,Anson,2023-04-11
0,2,0,2,0,Anson,2023-04-16
0,1,0,1,0,Anson,2023-04-25
0,1,0,1,0,Anson,2023-04-27
0,1,0,1,0,Ashe,2022-11-13
0,2,0,2,0,Ashe,2022-11-14
0,2,0,2,0,Ashe,2022-11-16
0,1,0,1,0,Ashe,2022-11-17
0,1,0,1,0,Ashe,2022-11-18
0,1,0,1,0,Ashe,2022-11-19
0,2,0,2,0,Ashe,2022-11-24
0,2,0,2,0,Ashe,2022-11-27
0,1,0,1,0,Ashe,2022-12-01
0,4,0,4,0,Ashe,2022-12-02
0,2,0,2,0,Ashe,2022-12-03
0,2,0,2,0,Ashe,2022-12-14
0,3,0,3,0,Ashe,2022-12-17
0,3,0,3,0,Ashe,2023-01-01
0,1,0,1,0,Ashe,2023-01-08
0,1,0,1,0,Ashe,2023-01-14
0,1,0,1,0,Ashe,2023-01-15
0,2,0,2,0,Ashe,2023-02-09
0,4,0,4,0,Ashe,2023-02-15
0,3,0,3,0,Ashe,2023-02-16
0,2,0,2,0,Ashe,2023-02-18
0,1,0,1,0,Ashe,2023-02-19
0,1,0,1,0,Ashe,2023-02-25
0,1,0,1,0,Ashe,2023-03-04
0,1,0,1,0,Ashe,2023-03-09
0,2,0,2,0,Ashe,2023-03-14
0,1,0,1,0,Ashe,2023-03-17
0,2,0,2,0,Ashe,2023-03-18
0,1,0,1,0,Ashe,2023-04-17
0,1,0,1,0,Ashe,2023-04-28
0,1,0,1,0,Ashe,2023-05-04
0,2,0,2,0,Avery,2022-11-09
0,1,0,1,0,Avery,2022-11-16
0,2,0,2,0,Avery,2022-11-21
0,1,0,1,0,Avery,2022-11-23
0,1,0,1,0,Avery,2022-11-26
0,1,0,1,0,Avery,2022-12-01
0,2,0,2,0,Avery,2022-12-05
0,1,0,1,0,Avery,2022-12-13
0,1,0,1,0,Avery,2022-12-15
0,1,0,1,0,Avery,2022-12-17
0,6,0,6,0,Avery,2022-12-18
0,2,0,2,0,Avery,2022-12-21
0,3,0,3,0,Avery,2022-12-25
0,2,0,2,0,Avery,2022-12-30
0,1,0,1,0,Avery,2022-12-31
0,4,0,4,0,Avery,2023-01-05
0,1,0,1,0,Avery,2023-01-08
0,1,0,1,0,Avery,2023-01-12
0,1,0,1,0,Avery,2023-01-13
0,1,0,1,0,Avery,2023-01-18
0,1,0,1,0,Avery,2023-01-20
0,1,0,1,0,Avery,2023-01-22
0,1,0,1,0,Avery,2023-01-24
0,2,0,2,0,Avery,2023-01-26
0,1,0,1,0,Avery,2023-01-28
0,2,0,2,0,Avery,2023-01-30
0,1,0,1,0,Avery,2023-02-02
0,2,0,2,0,Avery,2023-02-05
0,1,0,1,0,Avery,2023-02-11
0,3,0,3,0,Avery,2023-02-17
0,2,0,2,0,Avery,2023-02-20
0,1,0,1,0,Avery,2023-02-21
0,1,0,1,0,Avery,2023-03-01
0,1,0,1,0,Avery,2023-03-06
0,1,0,1,0,Avery,2023-03-07
0,1,0,1,0,Avery,2023-03-12
0,1,0,1,0,Avery,2023-03-16
0,2,0,2,0,Avery,2023-03-17
0,1,0,1,0,Avery,2023-03-24
0,1,0,1,0,Avery,2023-03-29
0,1,0,1,0,Avery,2023-03-31
0,1,0,1,0,Avery,2023-04-09
0,1,0,1,0,Avery,2023-04-26
0,1,0,1,0,Avery,2023-04-28
0,5,0,5,0,Beaufort,2022-11-12
0,3,0,3,0,Beaufort,2022-11-17
0,1,0,1,0,Beaufort,2022-11-18
0,5,0,5,0,Beaufort,2022-11-22
0,1,0,1,0,Beaufort,2022-11-23
0,4,0,4,0,Beaufort,2022-11-29
0,3,0,3,0,Beaufort,2022-11-30
0,5,0,5,0,Beaufort,2022-12-01
0,3,0,3,0,Beaufort,2022-12-06
0,8,0,8,0,Beaufort,2022-12-31
0,2,0,2,0,Beaufort,2023-01-25
0,5,0,5,0,Beaufort,2023-01-29
0,2,0,2,0,Beaufort,2023-02-04
0,4,0,4,0,Beaufort,2023-02-12
0,1,0,1,0,Beaufort,2023-02-25
0,2,0,2,0,Beaufort,2023-02-26
0,3,0,3,0,Beaufort,2023-03-04
0,1,0,1,0,Beaufort,2023-03-12
0,1,0,1,0,Beaufort,2023-03-30
0,2,0,2,0,Beaufort,2023-04-02
0,1,0,1,0,Beaufort,2023-04-06
0,1,0,1,0,Beaufort,2023-04-15
0,1,0,1,0,Beaufort,2023-04-17
0,1,0,1,0,Beaufort,2023-04-19
0,1,0,1,0,Beaufort,2023-04-28
0,1,0,1,0,Beaufort,2023-04-30
0,2,0,2,0,Bertie,2022-11-08
0,3,0,3,0,Bertie,2022-11-12
0,2,0,2,0,Bertie,2022-11-15
0,3,0,3,0,Bertie,2022-12-01
0,1,0,1,0,Bertie,2022-12-03
0,3,0,3,0,Bertie,2022-12-10
0,1,0,1,0,Bertie,2022-12-16
0,1,0,1,0,Bertie,2022-12-17
0,4,0,4,0,Bertie,2022-12-19
0,3,0,3,0,Bertie,2022-12-21
0,5,0,5,0,Bertie,2022-12-23
0,1,0,1,0,Bertie,2022-12-25
0,3,0,3,0,Bertie,2023-01-01
0,5,0,5,0,Bertie,2023-01-06
0,1,0,1,0,Bertie,2023-01-07
0,1,0,1,0,Bertie,2023-01-08
0,1,0,1,0,Bertie,2023-01-23
0,3,0,3,0,Bertie,2023-01-24
0,1,0,1,0,Bertie,2023-01-25
0,1,0,1,0,Bertie,2023-01-28
0,1,0,1,0,Bertie,2023-02-05
0,2,0,2,0,Bertie,2023-02-07
0,1,0,1,0,Bertie,2023-02-12
0,2,0,2,0,Bertie,2023-02-14
0,3,0,3,0,Bertie,2023-02-16
0,1,0,1,0,Bertie,2023-02-19
0,1,0,1,0,Bertie,2023-02-21
0,1,0,1,0,Bertie,2023-02-22
0,2,0,2,0,Bertie,2023-02-26
0,1,0,1,0,Bertie,2023-02-27
0,3,0,3,0,Bertie,2023-03-01
0,1,0,1,0,Bertie,2023-03-04
0,1,0,1,0,Bertie,2023-03-05
0,1,0,1,0,Bertie,2023-03-09
0,1,0,1,0,Bertie,2023-03-13
0,1,0,1,0,Bertie,2023-03-18
0,1,0,1,0,Bertie,2023-03-21
0,1,0,1,0,Bertie,2023-03-23
0,1,0,1,0,Bertie,2023-03-29
0,1,0,1,0,Bertie,2023-04-02
0,1,0,1,0,Bertie,2023-04-03
0,1,0,1,0,Bertie,2023-04-10
0,1,0,1,0,Bertie,2023-04-21
0,2,0,2,0,Bladen,2022-11-12
0,2,0,2,0,Bladen,2022-11-14
0,2,0,2,0,Bladen,2022-11-19
0,1,0,1,0,Bladen,2022-11-23
0,1,0,1,0,Bladen,2022-11-24
0,4,0,4,0,Bladen,2022-12-02
0,2,0,2,0,Bladen,2022-12-03
0,2,0,2,0,Bladen,2022-12-10
0,3,0,3,0,Bladen,2022-12-31
0,2,0,2,0,Bladen,2023-02-05
0,1,0,1,0,Bladen,2023-02-26
0,3,0,3,0,Bladen,2023-03-01
0,1,0,1,0,Bladen,2023-03-03
0,1,0,1,0,Bladen,2023-03-04
0,1,0,1,0,Bladen,2023-03-05
0,1,0,1,0,Bladen,2023-03-08
0,1,0,1,0,Bladen,2023-03-12
0,1,0,1,0,Bladen,2023-03-13
0,1,0,1,0,Bladen,2023-03-21
0,2,0,2,0,Bladen,2023-03-24
0,1,0,1,0,Bladen,2023-04-06
0,2,0,2,0,Bladen,2023-04-16
0,1,0,1,0,Bladen,2023-04-20
0,1,0,1,0,Bladen,2023-04-24
0,2,0,2,0,Bladen,2023-05-01
0,9,0,9,0,Brunswick,2022-11-20
0,2,0,2,0,Brunswick,2023-02-11
0,4,0,4,0,Brunswick,2023-02-22
0,2,0,2,0,Brunswick,2023-03-05
0,4,0,4,0,Brunswick,2023-03-09
0,3,0,3,0,Brunswick,2023-03-11
0,2,0,2,0,Brunswick,2023-04-08
0,1,0,1,0,Brunswick,2023-04-09
0,1,0,1,0,Brunswick,2023-04-12
0,2,0,2,0,Brunswick,2023-04-20
0,1,0,1,0,Brunswick,2023-04-21
0,5,0,5,0,Brunswick,2023-04-22
0,1,0,1,0,Brunswick,2023-04-23
0,1,0,1,0,Brunswick,2023-04-29
0,7,0,7,0,Brunswick,2023-05-02
0,2,0,2,0,Brunswick,2023-05-06
0,5,0,5,0,Burke,2022-11-17
0,3,0,3,0,Burke,2022-11-20
0,2,0,2,0,Burke,2022-11-24
0,3,0,3,0,Burke,2023-01-29
0,2,0,2,0,Burke,2023-03-01
0,4,0,4,0,Burke,2023-03-04
0,2,0,2,0,Burke,2023-03-13
0,1,0,1,0,Burke,2023-03-26
0,2,0,2,0,Burke,2023-04-03
0,2,0,2,0,Burke,2023-04-05
0,2,0,2,0,Burke,2023-04-06
0,1,0,1,0,Burke,2023-04-12
0,2,0,2,0,Burke,2023-04-16
0,2,0,2,0,Burke,2023-04-19
0,1,0,1,0,Burke,2023-04-22
0,2,0,2,0,Burke,2023-05-01
0,3,0,3,0,Burke,2023-05-02
0,2,0,2,0,Burke,2023-05-05
0,1,0,1,0,Burke,2023-05-06
0,5,0,5,0,Cabarrus,2023-03-11
0,5,0,5,0,Cabarrus,2023-04-08
0,5,0,5,0,Cabarrus,2023-04-11
0,6,0,6,0,Caldwell,2022-11-18
0,4,0,4,0,Caldwell,2022-11-24
0,3,0,3,0,Caldwell,2023-04-08
0,2,0,2,0,Caldwell,2023-04-09
0,1,0,1,0,Caldwell,2023-04-18
0,4,0,4,0,Caldwell,2023-04-20
0,3,0,3,0,Caldwell,2023-04-22
0,4,0,4,0,Caldwell,2023-04-29
0,1,0,1,0,Caldwell,2023-04-30
0,1,0,1,0,Caldwell,2023-05-05
0,1,0,1,0,Camden,2022-11-12
0,1,0,1,0,Camden,2022-12-11
0,2,0,2,0,Camden,2022-12-25
0,2,0,2,0,Camden,2022-12-26
0,3,0,3,0,Camden,2022-12-30
0,3,0,3,0,Camden,2023-01-02
0,1,0,1,0,Camden,2023-01-03
0,1,0,1,0,Camden,2023-01-06
0,1,0,1,0,Camden,2023-01-11
0,1,0,1,0,Camden,2023-01-22
0,1,0,1,0,Camden,2023-02-03
0,1,0,1,0,Camden,2023-02-04
0,1,0,1,0,Camden,2023-03-04
0,1,0,1,0,Camden,2023-03-07
0,1,0,1,0,Camden,2023-03-09
0,1,0,1,0,Camden,2023-03-12
0,1,0,1,0,Camden,2023-03-23
0,1,0,1,0,Camden,2023-03-26
0,1,0,1,0,Camden,2023-04-02
0,1,0,1,0,Camden,2023-04-11
0,3,0,3,0,Carteret,2022-11-19
0,1,0,1,0,Carteret,2022-11-20
0,1,0,1,0,Carteret,2022-11-24
0,2,0,2,0,Carteret,2022-11-26
0,3,0,3,0,Carteret,2023-01-07
0,4,0,4,0,Carteret,2023-02-23
0,1,0,1,0,Carteret,2023-03-08
0,2,0,2,0,Carteret,2023-03-09
0,1,0,1,0,Carteret,2023-03-22
0,1,0,1,0,Carteret,2023-03-24
0,1,0,1,0,Carteret,2023-03-28
0,1,0,1,0,Carteret,2023-04-08
0,1,0,1,0,Carteret,2023-04-24
0,1,0,1,0,Carteret,2023-04-25
0,1,0,1,0,Carteret,2023-04-26
0,1,0,1,0,Carteret,2023-04-29
0,1,0,1,0,Carteret,2023-04-30
0,1,0,1,0,Caswell,2022-11-11
0,2,0,2,0,Caswell,2022-11-15
0,1,0,1,0,Caswell,2022-11-19
0,4,0,4,0,Caswell,2022-11-27
0,1,0,1,0,Caswell,2022-12-01
0,1,0,1,0,Caswell,2022-12-03
0,2,0,2,0,Caswell,2022-12-04
0,4,0,4,0,Caswell,2022-12-09
0,1,0,1,0,Caswell,2022-12-11
0,3,0,3,0,Caswell,2022-12-13
0,2,0,2,0,Caswell,2022-12-16
0,2,0,2,0,Caswell,2022-12-17
0,1,0,1,0,Caswell,2022-12-18
0,2,0,2,0,Caswell,2022-12-31
0,1,0,1,0,Caswell,2023-01-07
0,1,0,1,0,Caswell,2023-01-08
0,3,0,3,0,Caswell,2023-01-12
0,1,0,1,0,Caswell,2023-01-14
0,1,0,1,0,Caswell,2023-01-15
0,1,0,1,0,Caswell,2023-01-21
0,1,0,1,0,Caswell,2023-01-22
0,3,0,3,0,Caswell,2023-01-30
0,2,0,2,0,Caswell,2023-02-01
0,2,0,2,0,Caswell,2023-02-04
0,1,0,1,0,Caswell,2023-02-14
0,1,0,1,0,Caswell,2023-02-21
0,2,0,2,0,Caswell,2023-02-22
0,1,0,1,0,Caswell,2023-02-23
0,1,0,1,0,Caswell,2023-02-26
0,1,0,1,0,Caswell,2023-03-02
0,2,0,2,0,Caswell,2023-03-13
0,1,0,1,0,Caswell,2023-03-15
0,1,0,1,0,Caswell,2023-03-17
0,1,0,1,0,Caswell,2023-03-20
0,1,0,1,0,Caswell,2023-03-22
0,1,0,1,0,Caswell,2023-03-23
0,1,0,1,0,Caswell,2023-03-31
0,1,0,1,0,Caswell,2023-04-02
0,1,0,1,0,Caswell,2023-04-04
0,1,0,1,0,Caswell,2023-04-05
0,1,0,1,0,Caswell,2023-04-13
0,1,0,1,0,Caswell,2023-04-15
0,2,0,2,0,Caswell,2023-04-18
0,2,0,2,0,Caswell,2023-04-20
0,1,0,1,0,Caswell,2023-04-25
0,1,0,1,0,Caswell,2023-04-26
0,1,0,1,0,Caswell,2023-04-28
0,1,0,1,0,Caswell,2023-05-06
0,1,0,1,0,Catawba,2023-04-23
0,7,0,7,0,Chatham,2022-11-12
0,2,0,2,0,Chatham,2022-11-20
0,7,0,7,0,Chatham,2022-11-23
0,1,0,1,0,Chatham,2022-11-24
0,6,0,6,0,Chatham,2022-11-25
0,2,0,2,0,Chatham,2023-03-03
0,1,0,1,0,Chatham,2023-03-04
0,2,0,2,0,Chatham,2023-03-07
0,7,0,7,0,Chatham,2023-03-09
0,3,0,3,0,Chatham,2023-03-11
0,3,0,3,0,Chatham,2023-03-21
0,1,0,1,0,Chatham,2023-03-26
0,1,0,1,0,Chatham,2023-03-30
0,1,0,1,0,Chatham,2023-03-31
0,2,0,2,0,Chatham,2023-04-01
0,1,0,1,0,Chatham,2023-04-02
0,1,0,1,0,Chatham,2023-04-03
0,1,0,1,0,Chatham,2023-04-04
0,1,0,1,0,Chatham,2023-04-08
0,2,0,2,0,Chatham,2023-04-10
0,3,0,3,0,Chatham,2023-04-11
0,1,0,1,0,Chatham,2023-04-12
0,1,0,1,0,Chatham,2023-04-16
0,1,0,1,0,Chatham,2023-04-19
0,3,0,3,0,Chatham,2023-04-25
0,1,0,1,0,Chatham,2023-04-26
0,3,0,3,0,Chatham,2023-04-28
0,3,0,3,0,Chatham,2023-04-29
0,2,0,2,0,Chatham,2023-05-03
0,1,0,1,0,Cherokee,2022-11-10
0,2,0,2,0,Cherokee,2022-11-12
0,4,0,4,0,Cherokee,2022-11-21
0,3,0,3,0,Cherokee,2022-11-23
0,2,0,2,0,Cherokee,2022-11-24
0,3,0,3,0,Cherokee,2022-11-26
0,1,0,1,0,Cherokee,2022-12-02
0,1,0,1,0,Cherokee,2022-12-03
0,4,0,4,0,Cherokee,2022-12-05
0,2,0,2,0,Cherokee,2022-12-09
0,2,0,2,0,Cherokee,2022-12-17
0,1,0,1,0,Cherokee,2022-12-27
0,9,0,9,0,Cherokee,2023-01-06
0,4,0,4,0,Cherokee,2023-02-21
0,2,0,2,0,Cherokee,2023-02-23
0,1,0,1,0,Cherokee,2023-02-24
0,1,0,1,0,Cherokee,2023-03-01
0,1,0,1,0,Cherokee,2023-03-03
0,1,0,1,0,Cherokee,2023-03-05
0,3,0,3,0,Cherokee,2023-03-08
0,2,0,2,0,Cherokee,2023-03-09
0,2,0,2,0,Cherokee,2023-03-15
0,1,0,1,0,Cherokee,2023-03-16
0,1,0,1,0,Cherokee,2023-03-18
0,1,0,1,0,Cherokee,2023-03-21
0,4,0,4,0,Cherokee,2023-03-23
0,4,0,4,0,Cherokee,2023-03-27
0,3,0,3,0,Cherokee,2023-03-30
0,2,0,2,0,Cherokee,2023-04-06
0,2,0,2,0,Cherokee,2023-04-07
0,2,0,2,0,Cherokee,2023-04-10
0,1,0,1,0,Cherokee,2023-04-15
0,1,0,1,0,Cherokee,2023-04-18
0,2,0,2,0,Cherokee,2023-04-24
0,2,0,2,0,Cherokee,2023-04-25
0,1,0,1,0,Cherokee,2023-04-29
0,2,0,2,0,Cherokee,2023-05-01
0,2,0,2,0,Chowan,2022-11-09
0,1,0,1,0,Chowan,2022-11-16
0,1,0,1,0,Chowan,2022-11-19
0,1,0,1,0,Chowan,2022-11-20
0,2,0,2,0,Chowan,2022-11-25
0,1,0,1,0,Chowan,2022-11-27
0,2,0,2,0,Chowan,2022-12-01
0,1,0,1,0,Chowan,2022-12-03
0,1,0,1,0,Chowan,2022-12-06
0,1,0,1,0,Chowan,2022-12-09
0,1,0,1,0,Chowan,2022-12-10
0,1,0,1,0,Chowan,2022-12-12
0,4,0,4,0,Chowan,2022-12-15
0,1,0,1,0,Chowan,2022-12-17
0,1,0,1,0,Chowan,2023-01-01
0,11,0,11,0,Chowan,2023-01-10
0,8,0,8,0,Chowan,2023-01-12
0,3,0,3,0,Chowan,2023-01-16
0,5,0,5,0,Chowan,2023-01-25
0,1,0,1,0,Chowan,2023-02-09
0,2,0,2,0,Chowan,2023-02-11
0,3,0,3,0,Chowan,2023-02-14
0,3,0,3,0,Chowan,2023-02-15
0,2,0,2,0,Chowan,2023-02-17
0,1,0,1,0,Chowan,2023-02-18
0,1,0,1,0,Chowan,2023-02-23
0,1,0,1,0,Chowan,2023-02-26
0,1,0,1,0,Chowan,2023-03-01
0,2,0,2,0,Chowan,2023-03-02
0,1,0,1,0,Chowan,2023-03-09
0,1,0,1,0,Chowan,2023-03-10
0,2,0,2,0,Chowan,2023-03-13
0,3,0,3,0,Chowan,2023-03-17
0,1,0,1,0,Chowan,2023-03-20
0,1,0,1,0,Chowan,2023-03-21
0,1,0,1,0,Chowan,2023-03-22
0,2,0,2,0,Chowan,2023-03-23
0,1,0,1,0,Chowan,2023-04-06
0,1,0,1,0,Chowan,2023-04-22
0,1,0,1,0,Clay,2022-11-09
0,1,0,1,0,Clay,2022-11-11
0,1,0,1,0,Clay,2022-11-21
0,4,0,4,0,Clay,2022-11-27
0,1,0,1,0,Clay,2022-12-01
0,1,0,1,0,Clay,2022-12-02
0,1,0,1,0,Clay,2022-12-03
0,3,0,3,0,Clay,2022-12-06
0,2,0,2,0,Clay,2022-12-07
0,1,0,1,0,Clay,2022-12-09
0,1,0,1,0,Clay,2022-12-10
0,1,0,1,0,Clay,2022-12-12
0,5,0,5,0,Clay,2022-12-14
0,2,0,2,0,Clay,2022-12-17
0,4,0,4,0,Clay,2022-12-22
0,2,0,2,0,Clay,2023-01-01
0,2,0,2,0,Clay,2023-01-03
0,3,0,3,0,Clay,2023-01-06
0,1,0,1,0,Clay,2023-01-07
0,1,0,1,0,Clay,2023-01-09
0,3,0,3,0,Clay,2023-01-12
0,1,0,1,0,Clay,2023-01-21
0,1,0,1,0,Clay,2023-01-22
0,2,0,2,0,Clay,2023-01-31
0,1,0,1,0,Clay,2023-02-07
0,2,0,2,0,Clay,2023-02-09
0,5,0,5,0,Clay,2023-02-10
0,3,0,3,0,Clay,2023-02-11
0,3,0,3,0,Clay,2023-02-12
0,1,0,1,0,Clay,2023-02-14
0,1,0,1,0,Clay,2023-02-15
0,2,0,2,0,Clay,2023-02-17
0,1,0,1,0,Clay,2023-02-22
0,1,0,1,0,Clay,2023-02-24
0,1,0,1,0,Clay,2023-02-26
0,2,0,2,0,Clay,2023-02-27
0,1,0,1,0,Clay,2023-02-28
0,1,0,1,0,Clay,2023-03-13
0,1,0,1,0,Clay,2023-03-15
0,1,0,1,0,Clay,2023-03-17
0,1,0,1,0,Clay,2023-03-23
0,1,0,1,0,Clay,2023-03-26
0,1,0,1,0,Clay,2023-03-27
0,1,0,1,0,Clay,2023-04-08
0,1,0,1,0,Clay,2023-04-13
0,1,0,1,0,Clay,2023-04-15
0,1,0,1,0,Clay,2023-04-17
0,1,0,1,0,Clay,2023-04-20
0,2,0,2,0,Clay,2023-04-23
0,1,0,1,0,Clay,2023-04-30
0,1,0,1,0,Clay,2023-05-04
0,8,0,8,0,Cleveland,2022-11-11
0,4,0,4,0,Cleveland,2022-11-12
0,1,0,1,0,Cleveland,2022-11-13
0,1,0,1,0,Cleveland,2022-11-24
0,3,0,3,0,Cleveland,2023-02-12
0,1,0,1,0,Cleveland,2023-02-18
0,2,0,2,0,Cleveland,2023-03-14
0,1,0,1,0,Cleveland,2023-03-22
0,2,0,2,0,Cleveland,2023-03-23
0,1,0,1,0,Cleveland,2023-03-28
0,2,0,2,0,Cleveland,2023-03-30
0,1,0,1,0,Cleveland,2023-04-08
0,2,0,2,0,Cleveland,2023-04-09
0,2,0,2,0,Cleveland,2023-04-12
0,1,0,1,0,Cleveland,2023-04-13
0,3,0,3,0,Cleveland,2023-04-14
0,1,0,1,0,Cleveland,2023-04-17
0,2,0,2,0,Cleveland,2023-04-22
0,1,0,1,0,Cleveland,2023-04-28
0,1,0,1,0,Cleveland,2023-05-03
0,2,0,2,0,Cleveland,2023-05-05
0,2,0,2,0,Columbus,2022-11-13
0,4,0,4,0,Columbus,2022-11-20
0,2,0,2,0,Columbus,2022-11-22
0,2,0,2,0,Columbus,2022-12-24
0,2,0,2,0,Columbus,2023-01-29
0,2,0,2,0,Columbus,2023-02-05
0,1,0,1,0,Columbus,2023-02-24
0,3,0,3,0,Columbus,2023-03-02
0,2,0,2,0,Columbus,2023-03-07
0,2,0,2,0,Columbus,2023-03-08
0,1,0,1,0,Columbus,2023-03-15
0,1,0,1,0,Columbus,2023-03-18
0,1,0,1,0,Columbus,2023-03-19
0,1,0,1,0,Columbus,2023-03-20
0,1,0,1,0,Columbus,2023-03-28
0,1,0,1,0,Columbus,2023-03-29
0,1,0,1,0,Columbus,2023-04-01
0,2,0,2,0,Columbus,2023-04-03
0,1,0,1,0,Columbus,2023-04-06
0,2,0,2,0,Columbus,2023-04-08
0,1,0,1,0,Columbus,2023-04-12
0,2,0,2,0,Columbus,2023-04-13
0,1,0,1,0,Columbus,2023-04-16
0,3,0,3,0,Columbus,2023-04-19
0,1,0,1,0,Columbus,2023-04-20
0,1,0,1,0,Columbus,2023-04-21
0,2,0,2,0,Columbus,2023-04-23
0,1,0,1,0,Columbus,2023-04-26
0,1,0,1,0,Columbus,2023-05-02
0,1,0,1,0,Columbus,2023-05-04
0,5,0,5,0,Craven,2022-11-18
0,3,0,3,0,Craven,2022-11-24
0,7,0,7,0,Craven,2022-11-27
0,5,0,5,0,Craven,2023-02-19
0,3,0,3,0,Craven,2023-02-27
0,1,0,1,0,Craven,2023-03-04
0,1,0,1,0,Craven,2023-03-25
0,1,0,1,0,Craven,2023-03-26
0,2,0,2,0,Craven,2023-03-30
0,5,0,5,0,Craven,2023-03-31
0,1,0,1,0,Craven,2023-04-16
0,1,0,1,0,Craven,2023-04-20
0,2,0,2,0,Craven,2023-04-27
0,1,0,1,0,Craven,2023-04-30
0,1,0,1,0,Craven,2023-05-04
0,2,0,2,0,Currituck,2022-11-10
0,2,0,2,0,Currituck,2022-11-13
0,1,0,1,0,Currituck,2022-11-14
0,1,0,1,0,Currituck,2022-11-17
0,1,0,1,0,Currituck,2022-11-20
0,1,0,1,0,Currituck,2022-11-21
0,1,0,1,0,Currituck,2022-11-23
0,4,0,4,0,Currituck,2022-11-30
0,1,0,1,0,Currituck,2022-12-01
0,1,0,1,0,Currituck,2022-12-03
0,2,0,2,0,Currituck,2022-12-04
0,1,0,1,0,Currituck,2022-12-06
0,1,0,1,0,Currituck,2022-12-10
0,1,0,1,0,Currituck,2022-12-11
0,1,0,1,0,Currituck,2022-12-13
0,3,0,3,0,Currituck,2022-12-14
0,3,0,3,0,Currituck,2022-12-16
0,4,0,4,0,Currituck,2022-12-17
0,1,0,1,0,Currituck,2022-12-23
0,1,0,1,0,Currituck,2022-12-24
0,2,0,2,0,Currituck,2022-12-25
0,7,0,7,0,Currituck,2022-12-26
0,2,0,2,0,Currituck,2022-12-28
0,4,0,4,0,Currituck,2022-12-31
0,1,0,1,0,Currituck,2023-01-03
0,2,0,2,0,Currituck,2023-01-07
0,1,0,1,0,Currituck,2023-01-08
0,3,0,3,0,Currituck,2023-01-10
0,1,0,1,0,Currituck,2023-01-11
0,2,0,2,0,Currituck,2023-01-16
0,1,0,1,0,Currituck,2023-01-22
0,2,0,2,0,Currituck,2023-01-30
0,2,0,2,0,Currituck,2023-01-31
0,2,0,2,0,Currituck,2023-02-05
0,2,0,2,0,Currituck,2023-02-14
0,1,0,1,0,Currituck,2023-02-19
0,2,0,2,0,Currituck,2023-02-21
0,1,0,1,0,Currituck,2023-02-22
0,3,0,3,0,Currituck,2023-02-28
0,1,0,1,0,Currituck,2023-03-15
0,2,0,2,0,Currituck,2023-03-19
0,1,0,1,0,Currituck,2023-04-09
0,1,0,1,0,Currituck,2023-04-14
0,2,0,2,0,Currituck,2023-04-16
0,1,0,1,0,Currituck,2023-04-17
0,3,0,3,0,Dare,2022-11-10
0,3,0,3,0,Dare,2022-11-12
0,2,0,2,0,Dare,2022-11-13
0,1,0,1,0,Dare,2022-11-14
0,1,0,1,0,Dare,2022-11-15
0,4,0,4,0,Dare,2022-11-17
0,5,0,5,0,Dare,2022-11-22
0,3,0,3,0,Dare,2022-11-25
0,2,0,2,0,Dare,2022-11-26
0,4,0,4,0,Dare,2022-11-29
0,2,0,2,0,Dare,2022-12-02
0,3,0,3,0,Dare,2022-12-05
0,2,0,2,0,Dare,2022-12-06
0,8,0,8,0,Dare,2022-12-11
0,5,0,5,0,Dare,2023-01-08
0,4,0,4,0,Dare,2023-01-11
0,4,0,4,0,Dare,2023-01-12
0,1,0,1,0,Dare,2023-01-14
0,5,0,5,0,Dare,2023-01-15
0,4,0,4,0,Dare,2023-01-22
0,11,0,11,0,Dare,2023-01-27
0,5,0,5,0,Dare,2023-01-29
0,5,0,5,0,Dare,2023-01-31
0,4,0,4,0,Dare,2023-02-05
0,7,0,7,0,Dare,2023-02-06
0,7,0,7,0,Dare,2023-02-09
0,6,0,6,0,Dare,2023-02-11
0,2,0,2,0,Dare,2023-02-17
0,3,0,3,0,Dare,2023-02-23
0,2,0,2,0,Dare,2023-02-25
0,2,0,2,0,Dare,2023-02-28
0,4,0,4,0,Dare,2023-03-02
0,4,0,4,0,Dare,2023-03-04
0,3,0,3,0,Dare,2023-03-08
0,1,0,1,0,Dare,2023-03-09
0,1,0,1,0,Dare,2023-03-11
0,3,0,3,0,Dare,2023-03-12
0,1,0,1,0,Dare,2023-03-14
0,4,0,4,0,Dare,2023-03-15
0,3,0,3,0,Dare,2023-03-17
0,1,0,1,0,Dare,2023-03-18
0,3,0,3,0,Dare,2023-03-21
0,5,0,5,0,Dare,2023-03-23
0,1,0,1,0,Dare,2023-03-25
0,2,0,2,0,Dare,2023-03-28
0,2,0,2,0,Dare,2023-03-31
0,1,0,1,0,Dare,2023-04-04
0,1,0,1,0,Dare,2023-04-09
0,2,0,2,0,Dare,2023-04-10
0,1,0,1,0,Dare,2023-04-15
0,1,0,1,0,Dare,2023-04-18
0,1,0,1,0,Dare,2023-04-20
0,1,0,1,0,Dare,2023-04-23
0,4,0,4,0,Dare,2023-04-24
0,1,0,1,0,Dare,2023-04-25
0,1,0,1,0,Dare,2023-04-27
0,1,0,1,0,Dare,2023-05-01
0,3,0,3,0,Dare,2023-05-04
0,2,0,2,0,Dare,2023-05-05
0,2,0,2,0,Davidson,2023-02-26
0,5,0,5,0,Davidson,2023-03-11
0,5,0,5,0,Davidson,2023-03-12
0,4,0,4,0,Davidson,2023-04-08
0,4,0,4,0,Davidson,2023-04-25
0,1,0,1,0,Davidson,2023-04-29
0,4,0,4,0,Davidson,2023-05-06
0,3,0,3,0,Davie,2022-11-15
0,1,0,1,0,Davie,2022-11-18
0,4,0,4,0,Davie,2022-11-26
0,2,0,2,0,Davie,2023-02-03
0,1,0,1,0,Davie,2023-02-18
0,1,0,1,0,Davie,2023-03-20
0,3,0,3,0,Davie,2023-03-23
0,2,0,2,0,Davie,2023-03-26
0,1,0,1,0,Davie,2023-03-30
0,3,0,3,0,Davie,2023-04-02
0,2,0,2,0,Davie,2023-04-05
0,1,0,1,0,Davie,2023-04-07
0,1,0,1,0,Davie,2023-04-08
0,2,0,2,0,Davie,2023-04-14
0,1,0,1,0,Davie,2023-04-17
0,1,0,1,0,Davie,2023-04-18
0,1,0,1,0,Davie,2023-04-22
0,1,0,1,0,Davie,2023-04-25
0,2,0,2,0,Davie,2023-04-30
0,1,0,1,0,Davie,2023-05-01
0,1,0,1,0,Davie,2023-05-05
0,1,0,1,0,Duplin,2022-11-13
0,1,0,1,0,Duplin,2022-11-20
0,1,0,1,0,Duplin,2022-11-24
0,2,0,2,0,Duplin,2022-11-27
0,1,0,1,0,Duplin,2022-12-03
0,1,0,1,0,Duplin,2022-12-04
0,1,0,1,0,Duplin,2022-12-10
0,2,0,2,0,Duplin,2022-12-11
0,3,0,3,0,Duplin,2023-01-22
0,7,0,7,0,Duplin,2023-01-29
0,4,0,4,0,Duplin,2023-02-19
0,1,0,1,0,Duplin,2023-02-26
0,1,0,1,0,Duplin,2023-03-03
0,3,0,3,0,Duplin,2023-03-04
0,1,0,1,0,Duplin,2023-03-08
0,2,0,2,0,Duplin,2023-03-09
0,3,0,3,0,Duplin,2023-03-21
0,4,0,4,0,Duplin,2023-03-23
0,2,0,2,0,Duplin,2023-03-24
0,1,0,1,0,Duplin,2023-04-07
0,1,0,1,0,Duplin,2023-04-15
0,1,0,1,0,Duplin,2023-04-27
0,1,0,1,0,Duplin,2023-05-01
0,1,0,1,0,Duplin,2023-05-04
0,2,0,2,0,Duplin,2023-05-05
0,4,0,4,0,Durham,2023-04-08
0,1,0,1,0,Edgecombe,2022-11-12
0,2,0,2,0,Edgecombe,2022-11-17
0,1,0,1,0,Edgecombe,2022-11-18
0,2,0,2,0,Edgecombe,2022-11-25
0,1,0,1,0,Edgecombe,2022-11-27
0,7,0,7,0,Edgecombe,2022-12-09
0,4,0,4,0,Edgecombe,2022-12-10
0,4,0,4,0,Edgecombe,2023-01-22
0,10,0,10,0,Edgecombe,2023-02-16
0,4,0,4,0,Edgecombe,2023-02-17
0,3,0,3,0,Edgecombe,2023-02-18
0,5,0,5,0,Edgecombe,2023-02-27
0,2,0,2,0,Edgecombe,2023-03-02
0,4,0,4,0,Edgecombe,2023-03-03
0,1,0,1,0,Edgecombe,2023-03-06
0,1,0,1,0,Edgecombe,2023-03-09
0,1,0,1,0,Edgecombe,2023-03-10
0,1,0,1,0,Edgecombe,2023-03-17
0,1,0,1,0,Edgecombe,2023-03-23
0,1,0,1,0,Edgecombe,2023-03-24
0,1,0,1,0,Edgecombe,2023-03-26
0,2,0,2,0,Edgecombe,2023-03-31
0,1,0,1,0,Edgecombe,2023-04-01
0,1,0,1,0,Edgecombe,2023-04-07
0,1,0,1,0,Edgecombe,2023-04-09
0,1,0,1,0,Edgecombe,2023-04-14
0,2,0,2,0,Edgecombe,2023-04-15
0,1,0,1,0,Edgecombe,2023-04-16
0,3,0,3,0,Edgecombe,2023-04-20
0,1,0,1,0,Edgecombe,2023-04-21
0,1,0,1,0,Edgecombe,2023-04-27
0,1,0,1,0,Edgecombe,2023-04-28
0,1,0,1,0,Edgecombe,2023-04-29
0,1,0,1,0,Edgecombe,2023-05-01
0,3,0,3,0,Edgecombe,2023-05-04
0,2,0,2,0,Franklin,2022-11-17
0,1,0,1,0,Franklin,2022-11-24
0,3,0,3,0,Franklin,2023-03-01
0,2,0,2,0,Franklin,2023-03-03
0,1,0,1,0,Franklin,2023-03-04
0,1,0,1,0,Franklin,2023-03-05
0,2,0,2,0,Franklin,2023-03-15
0,1,0,1,0,Franklin,2023-03-19
0,1,0,1,0,Franklin,2023-03-22
0,2,0,2,0,Franklin,2023-04-01
0,2,0,2,0,Franklin,2023-04-02
0,3,0,3,0,Franklin,2023-04-03
0,2,0,2,0,Franklin,2023-04-04
0,2,0,2,0,Franklin,2023-04-05
0,2,0,2,0,Franklin,2023-04-10
0,1,0,1,0,Franklin,2023-04-12
0,1,0,1,0,Franklin,2023-04-14
0,1,0,1,0,Franklin,2023-04-22
0,2,0,2,0,Franklin,2023-04-26
0,3,0,3,0,Franklin,2023-04-28
0,1,0,1,0,Franklin,2023-05-03
0,3,0,3,0,Gaston,2023-04-30
0,1,0,1,0,Gaston,2023-05-06
0,1,0,1,0,Gates,2022-11-08
0,1,0,1,0,Gates,2022-11-13
0,2,0,2,0,Gates,2022-11-15
0,1,0,1,0,Gates,2022-11-17
0,1,0,1,0,Gates,2022-11-20
0,1,0,1,0,Gates,2022-11-21
0,1,0,1,0,Gates,2022-12-04
0,2,0,2,0,Gates,2022-12-11
0,2,0,2,0,Gates,2022-12-12
0,2,0,2,0,Gates,2022-12-16
0,1,0,1,0,Gates,2022-12-22
0,2,0,2,0,Gates,2022-12-24
0,1,0,1,0,Gates,2022-12-26
0,1,0,1,0,Gates,2023-01-02
0,3,0,3,0,Gates,2023-01-11
0,1,0,1,0,Gates,2023-01-13
0,1,0,1,0,Gates,2023-01-15
0,1,0,1,0,Gates,2023-01-17
0,2,0,2,0,Gates,2023-02-10
0,2,0,2,0,Gates,2023-02-11
0,1,0,1,0,Gates,2023-02-12
0,1,0,1,0,Gates,2023-02-14
0,1,0,1,0,Gates,2023-02-15
0,1,0,1,0,Gates,2023-02-18
0,1,0,1,0,Gates,2023-02-22
0,1,0,1,0,Gates,2023-02-25
0,1,0,1,0,Gates,2023-03-15
0,1,0,1,0,Gates,2023-03-19
0,1,0,1,0,Gates,2023-03-20
0,1,0,1,0,Gates,2023-03-23
0,1,0,1,0,Gates,2023-04-05
0,1,0,1,0,Gates,2023-04-06
0,1,0,1,0,Gates,2023-04-26
0,1,0,1,0,Gates,2023-05-05
0,1,0,1,0,Graham,2022-11-17
0,1,0,1,0,Graham,2022-11-18
0,1,0,1,0,Graham,2022-12-24
0,1,0,1,0,Graham,2022-12-31
0,1,0,1,0,Graham,2023-01-07
0,1,0,1,0,Graham,2023-01-18
0,1,0,1,0,Graham,2023-01-27
0,1,0,1,0,Graham,2023-01-31
0,1,0,1,0,Graham,2023-02-05
0,1,0,1,0,Graham,2023-02-13
0,1,0,1,0,Graham,2023-02-14
0,2,0,2,0,Graham,2023-02-15
0,1,0,1,0,Graham,2023-03-01
0,2,0,2,0,Graham,2023-03-15
0,2,0,2,0,Graham,2023-04-03
0,1,0,1,0,Graham,2023-04-11
0,1,0,1,0,Graham,2023-04-14
0,5,0,5,0,Granville,2022-11-08
0,2,0,2,0,Granville,2022-11-13
0,8,0,8,0,Granville,2022-11-17
0,1,0,1,0,Granville,2022-11-24
0,2,0,2,0,Granville,2022-12-06
0,1,0,1,0,Granville,2023-03-12
0,3,0,3,0,Granville,2023-03-19
0,1,0,1,0,Granville,2023-03-20
0,4,0,4,0,Granville,2023-03-24
0,1,0,1,0,Granville,2023-04-07
0,1,0,1,0,Granville,2023-04-08
0,4,0,4,0,Granville,2023-04-13
0,1,0,1,0,Granville,2023-04-16
0,4,0,4,0,Granville,2023-04-17
0,4,0,4,0,Granville,2023-04-18
0,1,0,1,0,Granville,2023-04-28
0,1,0,1,0,Granville,2023-05-02
0,1,0,1,0,Greene,2022-11-11
0,1,0,1,0,Greene,2022-11-13
0,1,0,1,0,Greene,2022-11-17
0,2,0,2,0,Greene,2022-11-22
0,1,0,1,0,Greene,2022-12-02
0,1,0,1,0,Greene,2022-12-03
0,2,0,2,0,Greene,2022-12-10
0,1,0,1,0,Greene,2022-12-25
0,4,0,4,0,Greene,2023-01-20
0,2,0,2,0,Greene,2023-01-25
0,2,0,2,0,Greene,2023-01-26
0,1,0,1,0,Greene,2023-01-27
0,8,0,8,0,Greene,2023-01-30
0,1,0,1,0,Greene,2023-02-05
0,1,0,1,0,Greene,2023-02-15
0,1,0,1,0,Greene,2023-02-25
0,2,0,2,0,Greene,2023-02-27
0,2,0,2,0,Greene,2023-03-01
0,1,0,1,0,Greene,2023-03-07
0,1,0,1,0,Greene,2023-03-09
0,1,0,1,0,Greene,2023-03-17
0,1,0,1,0,Greene,2023-03-23
0,1,0,1,0,Greene,2023-04-06
0,1,0,1,0,Greene,2023-04-11
0,1,0,1,0,Greene,2023-04-13
0,2,0,2,0,Greene,2023-04-17
0,1,0,1,0,Greene,2023-04-20
0,2,0,2,0,Greene,2023-05-02
0,6,0,6,0,Halifax,2022-11-08
0,1,0,1,0,Halifax,2022-11-17
0,2,0,2,0,Halifax,2022-11-19
0,1,0,1,0,Halifax,2022-11-24
0,1,0,1,0,Halifax,2022-11-27
0,1,0,1,0,Halifax,2023-01-15
0,3,0,3,0,Halifax,2023-03-05
0,2,0,2,0,Halifax,2023-03-08
0,2,0,2,0,Halifax,2023-03-11
0,1,0,1,0,Halifax,2023-03-18
0,1,0,1,0,Halifax,2023-03-22
0,2,0,2,0,Halifax,2023-03-24
0,2,0,2,0,Halifax,2023-03-25
0,3,0,3,0,Halifax,2023-03-29
0,2,0,2,0,Halifax,2023-04-01
0,3,0,3,0,Halifax,2023-04-19
0,3,0,3,0,Halifax,2023-04-29
0,2,0,2,0,Harnett,2023-03-12
0,3,0,3,0,Harnett,2023-03-18
0,5,0,5,0,Harnett,2023-03-23
0,5,0,5,0,Harnett,2023-03-25
0,2,0,2,0,Harnett,2023-03-30
0,1,0,1,0,Harnett,2023-04-02
0,1,0,1,0,Harnett,2023-04-05
0,1,0,1,0,Harnett,2023-04-10
0,5,0,5,0,Harnett,2023-04-12
0,1,0,1,0,Harnett,2023-04-14
0,1,0,1,0,Harnett,2023-04-25
0,1,0,1,0,Harnett,2023-04-30
0,3,0,3,0,Harnett,2023-05-02
0,5,0,5,0,Haywood,2022-11-18
0,4,0,4,0,Haywood,2022-11-19
0,3,0,3,0,Haywood,2023-01-14
0,3,0,3,0,Haywood,2023-02-04
0,2,0,2,0,Haywood,2023-02-12
0,1,0,1,0,Haywood,2023-02-19
0,4,0,4,0,Haywood,2023-03-05
0,1,0,1,0,Haywood,2023-03-06
0,4,0,4,0,Haywood,2023-03-22
0,1,0,1,0,Haywood,2023-03-23
0,1,0,1,0,Haywood,2023-04-06
0,4,0,4,0,Haywood,2023-04-09
0,1,0,1,0,Haywood,2023-04-18
0,1,0,1,0,Haywood,2023-04-19
0,1,0,1,0,Haywood,2023-04-20
0,1,0,1,0,Haywood,2023-04-21
0,1,0,1,0,Haywood,2023-04-23
0,1,0,1,0,Haywood,2023-04-24
0,1,0,1,0,Haywood,2023-04-26
0,5,0,5,0,Henderson,2023-04-12
0,3,0,3,0,Henderson,2023-04-30
0,2,0,2,0,Hertford,2022-11-11
0,2,0,2,0,Hertford,2022-11-12
0,1,0,1,0,Hertford,2022-11-18
0,2,0,2,0,Hertford,2022-11-25
0,1,0,1,0,Hertford,2022-11-27
0,1,0,1,0,Hertford,2022-12-11
0,1,0,1,0,Hertford,2022-12-17
0,1,0,1,0,Hertford,2022-12-18
0,3,0,3,0,Hertford,2023-01-19
0,1,0,1,0,Hertford,2023-01-21
0,1,0,1,0,Hertford,2023-01-27
0,1,0,1,0,Hertford,2023-02-05
0,3,0,3,0,Hertford,2023-02-16
0,1,0,1,0,Hertford,2023-02-21
0,1,0,1,0,Hertford,2023-02-24
0,1,0,1,0,Hertford,2023-03-03
0,2,0,2,0,Hertford,2023-03-08
0,1,0,1,0,Hertford,2023-03-12
0,2,0,2,0,Hertford,2023-03-14
0,1,0,1,0,Hertford,2023-03-16
0,1,0,1,0,Hertford,2023-03-19
0,1,0,1,0,Hertford,2023-03-20
0,1,0,1,0,Hertford,2023-03-27
0,1,0,1,0,Hertford,2023-05-05
0,1,0,1,0,Hertford,2023-05-06
0,6,0,6,0,Hoke,2022-11-08
0,4,0,4,0,Hoke,2022-11-14
0,2,0,2,0,Hoke,2022-11-18
0,2,0,2,0,Hoke,2022-11-24
0,7,0,7,0,Hoke,2022-12-11
0,4,0,4,0,Hoke,2023-01-18
0,4,0,4,0,Hoke,2023-03-03
0,2,0,2,0,Hoke,2023-03-04
0,3,0,3,0,Hoke,2023-03-07
0,3,0,3,0,Hoke,2023-03-09
0,1,0,1,0,Hoke,2023-03-17
0,2,0,2,0,Hoke,2023-03-27
0,4,0,4,0,Hoke,2023-03-28
0,2,0,2,0,Hoke,2023-04-05
0,1,0,1,0,Hoke,2023-04-10
0,2,0,2,0,Hoke,2023-04-11
0,1,0,1,0,Hoke,2023-04-19
0,1,0,1,0,Hoke,2023-04-21
0,1,0,1,0,Hoke,2023-04-22
0,1,0,1,0,Hoke,2023-04-24
0,1,0,1,0,Hoke,2023-04-26
0,1,0,1,0,Hoke,2023-05-05
0,1,0,1,0,Hyde,2022-11-21
0,1,0,1,0,Hyde,2022-11-24
0,2,0,2,0,Hyde,2022-12-09
0,1,0,1,0,Hyde,2022-12-19
0,1,0,1,0,Hyde,2022-12-24
0,2,0,2,0,Hyde,2022-12-29
0,1,0,1,0,Hyde,2022-12-30
0,2,0,2,0,Hyde,2022-12-31
0,1,0,1,0,Hyde,2023-01-03
0,1,0,1,0,Hyde,2023-01-05
0,1,0,1,0,Hyde,2023-01-07
0,3,0,3,0,Hyde,2023-01-09
0,1,0,1,0,Hyde,2023-01-16
0,2,0,2,0,Hyde,2023-01-17
0,1,0,1,0,Hyde,2023-01-19
0,1,0,1,0,Hyde,2023-01-22
0,2,0,2,0,Hyde,2023-01-23
0,1,0,1,0,Hyde,2023-01-24
0,1,0,1,0,Hyde,2023-01-25
0,1,0,1,0,Hyde,2023-01-27
0,2,0,2,0,Hyde,2023-01-31
0,1,0,1,0,Hyde,2023-02-01
0,2,0,2,0,Hyde,2023-02-02
0,1,0,1,0,Hyde,2023-02-05
0,1,0,1,0,Hyde,2023-02-08
0,1,0,1,0,Hyde,2023-02-15
0,1,0,1,0,Hyde,2023-02-17
0,1,0,1,0,Hyde,2023-03-14
0,1,0,1,0,Hyde,2023-03-23
0,1,0,1,0,Hyde,2023-04-06
0,2,0,2,0,Hyde,2023-04-13
0,1,0,1,0,Hyde,2023-04-26
0,1,0,1,0,Hyde,2023-04-27
0,2,0,2,0,Jackson,2022-11-14
0,1,0,1,0,Jackson,2022-11-16
0,2,0,2,0,Jackson,2022-11-17
0,1,0,1,0,Jackson,2022-11-24
0,2,0,2,0,Jackson,2022-11-26
0,3,0,3,0,Jackson,2022-11-28
0,4,0,4,0,Jackson,2022-12-01
0,3,0,3,0,Jackson,2022-12-03
0,5,0,5,0,Jackson,2022-12-31
0,4,0,4,0,Jackson,2023-01-07
0,5,0,5,0,Jackson,2023-01-16
0,2,0,2,0,Jackson,2023-01-29
0,1,0,1,0,Jackson,2023-02-12
0,2,0,2,0,Jackson,2023-02-18
0,2,0,2,0,Jackson,2023-02-28
0,1,0,1,0,Jackson,2023-03-08
0,1,0,1,0,Jackson,2023-03-16
0,2,0,2,0,Jackson,2023-03-25
0,2,0,2,0,Jackson,2023-03-30
0,1,0,1,0,Jackson,2023-04-02
0,1,0,1,0,Jackson,2023-04-22
0,2,0,2,0,Jackson,2023-04-30
0,2,0,2,0,Johnston,2023-04-16
0,3,0,3,0,Johnston,2023-04-26
0,1,0,1,0,Jones,2022-11-12
0,1,0,1,0,Jones,2022-11-18
0,2,0,2,0,Jones,2022-12-05
0,1,0,1,0,Jones,2022-12-08
0,1,0,1,0,Jones,2022-12-10
0,2,0,2,0,Jones,2022-12-11
0,1,0,1,0,Jones,2022-12-17
0,1,0,1,0,Jones,2023-01-02
0,3,0,3,0,Jones,2023-01-09
0,1,0,1,0,Jones,2023-01-13
0,1,0,1,0,Jones,2023-01-20
0,1,0,1,0,Jones,2023-01-21
0,1,0,1,0,Jones,2023-01-28
0,1,0,1,0,Jones,2023-01-29
0,1,0,1,0,Jones,2023-02-05
0,4,0,4,0,Jones,2023-02-08
0,1,0,1,0,Jones,2023-02-10
0,2,0,2,0,Jones,2023-02-22
0,1,0,1,0,Jones,2023-02-24
0,1,0,1,0,Jones,2023-03-08
0,1,0,1,0,Jones,2023-03-13
0,1,0,1,0,Jones,2023-03-17
0,1,0,1,0,Jones,2023-03-24
0,1,0,1,0,Jones,2023-03-29
0,1,0,1,0,Jones,2023-04-02
0,2,0,2,0,Jones,2023-04-06
0,1,0,1,0,Jones,2023-04-07
0,1,0,1,0,Jones,2023-04-21
0,1,0,1,0,Lee,2022-11-09
0,2,0,2,0,Lee,2022-11-14
0,2,0,2,0,Lee,2022-11-15
0,1,0,1,0,Lee,2022-11-20
0,5,0,5,0,Lee,2023-03-07
0,1,0,1,0,Lee,2023-03-13
0,1,0,1,0,Lee,2023-03-22
0,1,0,1,0,Lee,2023-03-25
0,3,0,3,0,Lee,2023-03-31
0,1,0,1,0,Lee,2023-04-02
0,1,0,1,0,Lee,2023-04-11
0,2,0,2,0,Lee,2023-04-14
0,2,0,2,0,Lee,2023-04-18
0,2,0,2,0,Lee,2023-04-21
0,2,0,2,0,Lee,2023-04-26
0,3,0,3,0,Lenoir,2022-11-12
0,2,0,2,0,Lenoir,2022-11-17
0,1,0,1,0,Lenoir,2022-11-25
0,3,0,3,0,Lenoir,2023-01-28
0,3,0,3,0,Lenoir,2023-02-18
0,3,0,3,0,Lenoir,2023-02-19
0,3,0,3,0,Lenoir,2023-03-01
0,5,0,5,0,Lenoir,2023-03-10
0,2,0,2,0,Lenoir,2023-03-11
0,2,0,2,0,Lenoir,2023-03-16
0,1,0,1,0,Lenoir,2023-03-17
0,1,0,1,0,Lenoir,2023-03-18
0,1,0,1,0,Lenoir,2023-03-19
0,2,0,2,0,Lenoir,2023-03-21
0,1,0,1,0,Lenoir,2023-03-25
0,3,0,3,0,Lenoir,2023-03-26
0,2,0,2,0,Lenoir,2023-03-27
0,3,0,3,0,Lenoir,2023-03-28
0,1,0,1,0,Lenoir,2023-03-30
0,2,0,2,0,Lenoir,2023-03-31
0,1,0,1,0,Lenoir,2023-04-04
0,1,0,1,0,Lenoir,2023-04-08
0,2,0,2,0,Lenoir,2023-04-13
0,2,0,2,0,Lenoir,2023-04-14
0,4,0,4,0,Lenoir,2023-04-17
0,1,0,1,0,Lenoir,2023-04-18
0,1,0,1,0,Lenoir,2023-04-19
0,1,0,1,0,Lenoir,2023-04-22
0,1,0,1,0,Lenoir,2023-04-30
0,5,0,5,0,Lincoln,2022-11-12
0,4,0,4,0,Lincoln,2022-11-19
0,4,0,4,0,Lincoln,2022-12-25
0,4,0,4,0,Lincoln,2023-03-18
0,1,0,1,0,Lincoln,2023-04-02
0,2,0,2,0,Lincoln,2023-04-05
0,1,0,1,0,Lincoln,2023-04-06
0,1,0,1,0,Lincoln,2023-04-07
0,3,0,3,0,Lincoln,2023-04-11
0,1,0,1,0,Lincoln,2023-04-15
0,2,0,2,0,Lincoln,2023-04-20
0,3,0,3,0,Lincoln,2023-04-26
0,1,0,1,0,Lincoln,2023-04-28
0,1,0,1,0,Lincoln,2023-04-30
0,1,0,1,0,Lincoln,2023-05-03
0,2,0,2,0,Macon,2022-11-08
0,2,0,2,0,Macon,2022-11-09
0,1,0,1,0,Macon,2022-11-13
0,2,0,2,0,Macon,2022-11-15
0,1,0,1,0,Macon,2022-11-19
0,2,0,2,0,Macon,2022-11-24
0,4,0,4,0,Macon,2022-11-26
0,1,0,1,0,Macon,2022-11-27
0,2,0,2,0,Macon,2022-11-28
0,2,0,2,0,Macon,2022-11-29
0,2,0,2,0,Macon,2022-11-30
0,1,0,1,0,Macon,2022-12-04
0,3,0,3,0,Macon,2022-12-11
0,7,0,7,0,Macon,2022-12-18
0,3,0,3,0,Macon,2022-12-24
0,1,0,1,0,Macon,2022-12-25
0,4,0,4,0,Macon,2023-01-08
0,1,0,1,0,Macon,2023-01-14
0,1,0,1,0,Macon,2023-01-15
0,2,0,2,0,Macon,2023-01-28
0,1,0,1,0,Macon,2023-01-30
0,1,0,1,0,Macon,2023-01-31
0,2,0,2,0,Macon,2023-02-08
0,1,0,1,0,Macon,2023-02-09
0,1,0,1,0,Macon,2023-02-11
0,1,0,1,0,Macon,2023-02-13
0,3,0,3,0,Macon,2023-02-15
0,2,0,2,0,Macon,2023-02-16
0,2,0,2,0,Macon,2023-02-25
0,1,0,1,0,Macon,2023-03-01
0,1,0,1,0,Macon,2023-03-05
0,3,0,3,0,Macon,2023-03-09
0,1,0,1,0,Macon,2023-03-13
0,1,0,1,0,Macon,2023-03-14
0,1,0,1,0,Macon,2023-03-18
0,1,0,1,0,Macon,2023-03-19
0,2,0,2,0,Macon,2023-03-27
0,3,0,3,0,Macon,2023-03-30
0,2,0,2,0,Macon,2023-04-02
0,1,0,1,0,Macon,2023-04-03
0,1,0,1,0,Macon,2023-04-08
0,1,0,1,0,Macon,2023-04-13
0,1,0,1,0,Macon,2023-04-15
0,1,0,1,0,Macon,2023-04-17
0,2,0,2,0,Macon,2023-04-19
0,1,0,1,0,Macon,2023-04-21
0,2,0,2,0,Macon,2023-04-23
0,2,0,2,0,Macon,2023-04-27
0,1,0,1,0,Macon,2023-04-30
0,1,0,1,0,Madison,2022-11-27
0,1,0,1,0,Madison,2022-12-04
0,1,0,1,0,Madison,2022-12-18
0,1,0,1,0,Madison,2022-12-24
0,1,0,1,0,Madison,2023-01-05
0,1,0,1,0,Madison,2023-01-16
0,1,0,1,0,Madison,2023-01-22
0,1,0,1,0,Madison,2023-01-23
0,1,0,1,0,Madison,2023-01-24
0,1,0,1,0,Madison,2023-01-25
0,1,0,1,0,Madison,2023-01-31
0,1,0,1,0,Madison,2023-02-08
0,1,0,1,0,Madison,2023-02-10
0,1,0,1,0,Madison,2023-02-18
0,1,0,1,0,Madison,2023-03-06
0,1,0,1,0,Madison,2023-03-12
0,1,0,1,0,Madison,2023-03-23
0,1,0,1,0,Madison,2023-04-05
0,1,0,1,0,Madison,2023-04-18
0,1,0,1,0,Madison,2023-04-30
0,1,0,1,0,Madison,2023-05-01
0,3,0,3,0,Madison,2023-05-03
0,3,0,3,0,Martin,2022-11-08
0,1,0,1,0,Martin,2022-11-10
0,2,0,2,0,Martin,2022-11-14
0,3,0,3,0,Martin,2022-11-17
0,1,0,1,0,Martin,2022-11-18
0,1,0,1,0,Martin,2022-11-19
0,1,0,1,0,Martin,2022-11-23
0,1,0,1,0,Martin,2022-11-25
0,1,0,1,0,Martin,2022-11-28
0,2,0,2,0,Martin,2022-12-02
0,2,0,2,0,Martin,2022-12-03
0,1,0,1,0,Martin,2022-12-04
0,1,0,1,0,Martin,2022-12-06
0,2,0,2,0,Martin,2022-12-08
0,1,0,1,0,Martin,2022-12-10
0,2,0,2,0,Martin,2022-12-13
0,2,0,2,0,Martin,2022-12-15
0,1,0,1,0,Martin,2022-12-18
0,2,0,2,0,Martin,2022-12-19
0,4,0,4,0,Martin,2022-12-20
0,4,0,4,0,Martin,2022-12-21
0,1,0,1,0,Martin,2022-12-24
0,2,0,2,0,Martin,2022-12-30
0,1,0,1,0,Martin,2023-01-01
0,3,0,3,0,Martin,2023-01-06
0,1,0,1,0,Martin,2023-01-07
0,1,0,1,0,Martin,2023-01-08
0,1,0,1,0,Martin,2023-01-11
0,3,0,3,0,Martin,2023-01-12
0,2,0,2,0,Martin,2023-01-22
0,2,0,2,0,Martin,2023-01-23
0,3,0,3,0,Martin,2023-01-24
0,1,0,1,0,Martin,2023-02-04
0,1,0,1,0,Martin,2023-02-05
0,1,0,1,0,Martin,2023-02-09
0,2,0,2,0,Martin,2023-02-15
0,1,0,1,0,Martin,2023-02-18
0,1,0,1,0,Martin,2023-02-19
0,1,0,1,0,Martin,2023-02-20
0,1,0,1,0,Martin,2023-03-05
0,1,0,1,0,Martin,2023-03-06
0,1,0,1,0,Martin,2023-03-07
0,3,0,3,0,Martin,2023-03-15
0,1,0,1,0,Martin,2023-03-22
0,1,0,1,0,Martin,2023-03-29
0,1,0,1,0,Martin,2023-04-03
0,1,0,1,0,Martin,2023-04-14
0,1,0,1,0,McDowell,2022-11-16
0,1,0,1,0,McDowell,2022-11-20
0,7,0,7,0,McDowell,2022-12-04
0,4,0,4,0,McDowell,2022-12-13
0,2,0,2,0,McDowell,2023-02-12
0,3,0,3,0,McDowell,2023-02-19
0,4,0,4,0,McDowell,2023-02-20
0,3,0,3,0,McDowell,2023-02-22
0,3,0,3,0,McDowell,2023-02-25
0,2,0,2,0,McDowell,2023-03-01
0,1,0,1,0,McDowell,2023-03-06
0,1,0,1,0,McDowell,2023-03-13
0,1,0,1,0,McDowell,2023-03-16
0,2,0,2,0,McDowell,2023-03-18
0,2,0,2,0,McDowell,2023-03-20
0,2,0,2,0,McDowell,2023-03-21
0,1,0,1,0,McDowell,2023-03-29
0,1,0,1,0,McDowell,2023-04-05
0,1,0,1,0,McDowell,2023-04-11
0,1,0,1,0,McDowell,2023-04-12
0,1,0,1,0,McDowell,2023-04-15
0,1,0,1,0,McDowell,2023-04-19
0,2,0,2,0,McDowell,2023-04-23
0,1,0,1,0,McDowell,2023-04-26
0,1,0,1,0,McDowell,2023-04-30
0,1,0,1,0,Mitchell,2022-11-12
0,3,0,3,0,Mitchell,2022-11-15
0,2,0,2,0,Mitchell,2022-11-17
0,1,0,1,0,Mitchell,2022-11-18
0,1,0,1,0,Mitchell,2022-11-20
0,1,0,1,0,Mitchell,2022-11-21
0,1,0,1,0,Mitchell,2022-11-22
0,2,0,2,0,Mitchell,2022-11-25
0,1,0,1,0,Mitchell,2022-11-30
0,1,0,1,0,Mitchell,2022-12-03
0,1,0,1,0,Mitchell,2022-12-04
0,1,0,1,0,Mitchell,2022-12-09
0,2,0,2,0,Mitchell,2022-12-10
0,1,0,1,0,Mitchell,2022-12-18
0,2,0,2,0,Mitchell,2022-12-25
0,3,0,3,0,Mitchell,2022-12-31
0,1,0,1,0,Mitchell,2023-01-01
0,2,0,2,0,Mitchell,2023-01-02
0,1,0,1,0,Mitchell,2023-01-06
0,2,0,2,0,Mitchell,2023-01-22
0,1,0,1,0,Mitchell,2023-02-01
0,1,0,1,0,Mitchell,2023-02-02
0,2,0,2,0,Mitchell,2023-02-05
0,1,0,1,0,Mitchell,2023-02-06
0,1,0,1,0,Mitchell,2023-02-07
0,1,0,1,0,Mitchell,2023-02-13
0,1,0,1,0,Mitchell,2023-02-14
0,2,0,2,0,Mitchell,2023-02-15
0,1,0,1,0,Mitchell,2023-02-22
0,1,0,1,0,Mitchell,2023-02-24
0,1,0,1,0,Mitchell,2023-02-28
0,1,0,1,0,Mitchell,2023-03-01
0,1,0,1,0,Mitchell,2023-03-03
0,1,0,1,0,Mitchell,2023-03-05
0,3,0,3,0,Mitchell,2023-03-16
0,1,0,1,0,Mitchell,2023-03-18
0,1,0,1,0,Mitchell,2023-03-22
0,1,0,1,0,Mitchell,2023-03-24
0,1,0,1,0,Mitchell,2023-03-25
0,1,0,1,0,Mitchell,2023-03-31
0,1,0,1,0,Mitchell,2023-04-02
0,1,0,1,0,Mitchell,2023-04-09
0,2,0,2,0,Mitchell,2023-04-11
0,1,0,1,0,Mitchell,2023-04-23
0,1,0,1,0,Mitchell,2023-04-24
0,1,0,1,0,Mitchell,2023-05-01
0,1,0,1,0,Mitchell,2023-05-04
0,1,0,1,0,Mitchell,2023-05-06
0,1,0,1,0,Montgomery,2022-11-14
0,1,0,1,0,Montgomery,2022-11-18
0,1,0,1,0,Montgomery,2022-11-20
0,2,0,2,0,Montgomery,2022-11-26
0,2,0,2,0,Montgomery,2022-12-01
0,1,0,1,0,Montgomery,2022-12-06
0,3,0,3,0,Montgomery,2022-12-10
0,3,0,3,0,Montgomery,2022-12-15
0,3,0,3,0,Montgomery,2022-12-16
0,6,0,6,0,Montgomery,2023-01-17
0,5,0,5,0,Montgomery,2023-01-21
0,2,0,2,0,Montgomery,2023-01-25
0,3,0,3,0,Montgomery,2023-01-27
0,3,0,3,0,Montgomery,2023-01-28
0,4,0,4,0,Montgomery,2023-02-10
0,2,0,2,0,Montgomery,2023-02-15
0,2,0,2,0,Montgomery,2023-02-22
0,2,0,2,0,Montgomery,2023-02-24
0,1,0,1,0,Montgomery,2023-02-25
0,1,0,1,0,Montgomery,2023-02-26
0,1,0,1,0,Montgomery,2023-03-06
0,1,0,1,0,Montgomery,2023-03-26
0,1,0,1,0,Montgomery,2023-03-27
0,1,0,1,0,Montgomery,2023-03-31
0,1,0,1,0,Montgomery,2023-04-06
0,2,0,2,0,Montgomery,2023-04-07
0,1,0,1,0,Montgomery,2023-04-11
0,2,0,2,0,Montgomery,2023-04-12
0,2,0,2,0,Montgomery,2023-04-13
0,1,0,1,0,Montgomery,2023-04-22
0,1,0,1,0,Montgomery,2023-04-28
0,2,0,2,0,Montgomery,2023-04-29
0,1,0,1,0,Moore,2022-11-24
0,6,0,6,0,Moore,2023-03-17
0,6,0,6,0,Moore,2023-03-25
0,3,0,3,0,Moore,2023-03-28
0,1,0,1,0,Moore,2023-03-31
0,3,0,3,0,Moore,2023-04-03
0,3,0,3,0,Moore,2023-04-05
0,2,0,2,0,Moore,2023-04-07
0,1,0,1,0,Moore,2023-04-15
0,1,0,1,0,Moore,2023-04-18
0,2,0,2,0,Moore,2023-04-21
0,3,0,3,0,Moore,2023-04-22
0,1,0,1,0,Moore,2023-04-26
0,3,0,3,0,Moore,2023-05-03
0,4,0,4,0,Nash,2022-11-08
0,3,0,3,0,Nash,2022-11-12
0,2,0,2,0,Nash,2022-11-13
0,3,0,3,0,Nash,2022-11-20
0,9,0,9,0,Nash,2022-12-04
0,2,0,2,0,Nash,2023-03-03
0,3,0,3,0,Nash,2023-03-08
0,1,0,1,0,Nash,2023-03-12
0,4,0,4,0,Nash,2023-03-15
0,1,0,1,0,Nash,2023-03-18
0,1,0,1,0,Nash,2023-03-21
0,1,0,1,0,Nash,2023-03-31
0,1,0,1,0,Nash,2023-04-01
0,1,0,1,0,Nash,2023-04-11
0,1,0,1,0,Nash,2023-04-22
0,1,0,1,0,Nash,2023-05-06
0,3,0,3,0,New Hanover,2023-03-09
0,3,0,3,0,New Hanover,2023-04-16
0,3,0,3,0,New Hanover,2023-04-30
0,1,0,1,0,Northampton,2022-11-10
0,1,0,1,0,Northampton,2022-11-14
0,1,0,1,0,Northampton,2022-11-19
0,2,0,2,0,Northampton,2022-11-26
0,2,0,2,0,Northampton,2022-12-08
0,1,0,1,0,Northampton,2022-12-17
0,6,0,6,0,Northampton,2023-01-07
0,1,0,1,0,Northampton,2023-01-15
0,1,0,1,0,Northampton,2023-02-26
0,1,0,1,0,Northampton,2023-03-13
0,1,0,1,0,Northampton,2023-03-16
0,1,0,1,0,Northampton,2023-03-22
0,1,0,1,0,Northampton,2023-03-27
0,1,0,1,0,Northampton,2023-03-30
0,1,0,1,0,Northampton,2023-04-16
0,1,0,1,0,Northampton,2023-04-24
0,1,0,1,0,Northampton,2023-04-26
0,1,0,1,0,Northampton,2023-04-30
0,2,0,2,0,Onslow,2022-11-13
0,2,0,2,0,Onslow,2022-11-19
0,6,0,6,0,Onslow,2022-11-24
0,8,0,8,0,Onslow,2022-11-26
0,2,0,2,0,Onslow,2023-02-26
0,1,0,1,0,Onslow,2023-03-05
0,2,0,2,0,Onslow,2023-03-18
0,4,0,4,0,Onslow,2023-03-26
0,2,0,2,0,Onslow,2023-04-01
0,6,0,6,0,Onslow,2023-04-05
0,1,0,1,0,Onslow,2023-04-08
0,3,0,3,0,Onslow,2023-04-09
0,5,0,5,0,Onslow,2023-04-19
0,1,0,1,0,Onslow,2023-04-22
0,2,0,2,0,Onslow,2023-04-23
0,1,0,1,0,Onslow,2023-04-29
0,5,0,5,0,Onslow,2023-05-04
0,2,0,2,0,Onslow,2023-05-05
0,8,0,8,0,Orange,2022-11-18
0,7,0,7,0,Orange,2022-11-20
0,23,0,23,0,Orange,2022-12-11
0,6,0,6,0,Orange,2023-02-11
0,3,0,3,0,Orange,2023-03-04
0,5,0,5,0,Orange,2023-03-25
0,1,0,1,0,Orange,2023-04-09
0,5,0,5,0,Orange,2023-04-13
0,3,0,3,0,Orange,2023-04-16
0,1,0,1,0,Orange,2023-04-22
0,1,0,1,0,Orange,2023-04-24
0,3,0,3,0,Orange,2023-04-28
0,4,0,4,0,Orange,2023-04-30
0,6,0,6,0,Orange,2023-05-05
0,5,0,5,0,Orange,2023-05-06
0,1,0,1,0,Pamlico,2022-11-10
0,1,0,1,0,Pamlico,2022-11-13
0,2,0,2,0,Pamlico,2022-11-19
0,1,0,1,0,Pamlico,2022-11-21
0,1,0,1,0,Pamlico,2022-11-22
0,2,0,2,0,Pamlico,2022-11-28
0,2,0,2,0,Pamlico,2022-12-02
0,1,0,1,0,Pamlico,2022-12-10
0,2,0,2,0,Pamlico,2022-12-11
0,1,0,1,0,Pamlico,2022-12-13
0,2,0,2,0,Pamlico,2022-12-14
0,1,0,1,0,Pamlico,2022-12-15
0,1,0,1,0,Pamlico,2022-12-17
0,2,0,2,0,Pamlico,2022-12-19
0,1,0,1,0,Pamlico,2022-12-21
0,3,0,3,0,Pamlico,2022-12-22
0,1,0,1,0,Pamlico,2022-12-24
0,1,0,1,0,Pamlico,2022-12-25
0,2,0,2,0,Pamlico,2023-01-08
0,2,0,2,0,Pamlico,2023-01-10
0,2,0,2,0,Pamlico,2023-01-13
0,1,0,1,0,Pamlico,2023-01-15
0,1,0,1,0,Pamlico,2023-01-17
0,1,0,1,0,Pamlico,2023-01-24
0,2,0,2,0,Pamlico,2023-02-03
0,2,0,2,0,Pamlico,2023-02-09
0,1,0,1,0,Pamlico,2023-02-17
0,1,0,1,0,Pamlico,2023-02-20
0,1,0,1,0,Pamlico,2023-02-21
0,1,0,1,0,Pamlico,2023-02-22
0,1,0,1,0,Pamlico,2023-03-02
0,1,0,1,0,Pamlico,2023-03-17
0,1,0,1,0,Pamlico,2023-03-18
0,1,0,1,0,Pamlico,2023-03-25
0,1,0,1,0,Pamlico,2023-04-02
0,1,0,1,0,Pamlico,2023-04-03
0,1,0,1,0,Pamlico,2023-04-09
0,1,0,1,0,Pasquotank,2022-11-12
0,2,0,2,0,Pasquotank,2022-11-14
0,1,0,1,0,Pasquotank,2022-11-24
0,1,0,1,0,Pasquotank,2022-12-10
0,2,0,2,0,Pasquotank,2022-12-17
0,3,0,3,0,Pasquotank,2023-01-22
0,2,0,2,0,Pasquotank,2023-02-11
0,2,0,2,0,Pasquotank,2023-03-01
0,1,0,1,0,Pasquotank,2023-03-03
0,1,0,1,0,Pasquotank,2023-03-15
0,1,0,1,0,Pasquotank,2023-03-20
0,1,0,1,0,Pasquotank,2023-03-23
0,1,0,1,0,Pasquotank,2023-03-25
0,1,0,1,0,Pasquotank,2023-03-27
0,1,0,1,0,Pasquotank,2023-03-28
0,1,0,1,0,Pasquotank,2023-04-04
0,1,0,1,0,Pasquotank,2023-04-05
0,2,0,2,0,Pasquotank,2023-04-06
0,1,0,1,0,Pasquotank,2023-04-07
0,1,0,1,0,Pasquotank,2023-04-10
0,1,0,1,0,Pasquotank,2023-04-23
0,1,0,1,0,Pasquotank,2023-04-26
0,1,0,1,0,Pasquotank,2023-05-02
0,1,0,1,0,Pasquotank,2023-05-03
0,1,0,1,0,Pender,2022-11-09
0,2,0,2,0,Pender,2022-11-10
0,1,0,1,0,Pender,2022-11-11
0,2,0,2,0,Pender,2022-11-12
0,1,0,1,0,Pender,2022-11-18
0,3,0,3,0,Pender,2022-11-25
0,1,0,1,0,Pender,2022-11-26
0,5,0,5,0,Pender,2023-01-01
0,5,0,5,0,Pender,2023-01-15
0,3,0,3,0,Pender,2023-02-04
0,2,0,2,0,Pender,2023-02-05
0,7,0,7,0,Pender,2023-02-07
0,2,0,2,0,Pender,2023-02-08
0,5,0,5,0,Pender,2023-02-10
0,1,0,1,0,Pender,2023-02-17
0,2,0,2,0,Pender,2023-02-21
0,4,0,4,0,Pender,2023-02-25
0,1,0,1,0,Pender,2023-02-27
0,3,0,3,0,Pender,2023-02-28
0,3,0,3,0,Pender,2023-03-02
0,1,0,1,0,Pender,2023-03-03
0,1,0,1,0,Pender,2023-03-04
0,1,0,1,0,Pender,2023-03-08
0,1,0,1,0,Pender,2023-03-11
0,2,0,2,0,Pender,2023-03-14
0,1,0,1,0,Pender,2023-03-17
0,1,0,1,0,Pender,2023-03-19
0,1,0,1,0,Pender,2023-03-24
0,1,0,1,0,Pender,2023-03-30
0,1,0,1,0,Pender,2023-04-02
0,2,0,2,0,Pender,2023-04-05
0,1,0,1,0,Pender,2023-04-06
0,1,0,1,0,Pender,2023-04-08
0,1,0,1,0,Pender,2023-04-11
0,1,0,1,0,Pender,2023-04-12
0,3,0,3,0,Pender,2023-04-17
0,1,0,1,0,Pender,2023-04-23
0,2,0,2,0,Pender,2023-04-25
0,1,0,1,0,Pender,2023-04-26
0,4,0,4,0,Pender,2023-04-27
0,1,0,1,0,Pender,2023-04-29
0,1,0,1,0,Pender,2023-04-30
0,1,0,1,0,Pender,2023-05-03
0,1,0,1,0,Pender,2023-05-05
0,2,0,2,0,Perquimans,2022-11-11
0,1,0,1,0,Perquimans,2022-11-14
0,1,0,1,0,Perquimans,2022-11-17
0,1,0,1,0,Perquimans,2022-11-22
0,1,0,1,0,Perquimans,2022-11-24
0,1,0,1,0,Perquimans,2022-11-25
0,1,0,1,0,Perquimans,2022-11-26
0,2,0,2,0,Perquimans,2022-11-29
0,1,0,1,0,Perquimans,2022-11-30
0,1,0,1,0,Perquimans,2022-12-02
0,1,0,1,0,Perquimans,2022-12-03
0,1,0,1,0,Perquimans,2022-12-07
0,1,0,1,0,Perquimans,2022-12-13
0,1,0,1,0,Perquimans,2022-12-15
0,3,0,3,0,Perquimans,2022-12-19
0,1,0,1,0,Perquimans,2022-12-25
0,2,0,2,0,Perquimans,2022-12-31
0,1,0,1,0,Perquimans,2023-01-07
0,5,0,5,0,Perquimans,2023-01-09
0,3,0,3,0,Perquimans,2023-01-10
0,2,0,2,0,Perquimans,2023-01-16
0,1,0,1,0,Perquimans,2023-01-17
0,1,0,1,0,Perquimans,2023-01-19
0,2,0,2,0,Perquimans,2023-01-22
0,1,0,1,0,Perquimans,2023-01-25
0,2,0,2,0,Perquimans,2023-01-29
0,1,0,1,0,Perquimans,2023-02-13
0,2,0,2,0,Perquimans,2023-02-14
0,1,0,1,0,Perquimans,2023-02-19
0,1,0,1,0,Perquimans,2023-02-27
0,2,0,2,0,Perquimans,2023-03-03
0,2,0,2,0,Perquimans,2023-03-04
0,1,0,1,0,Perquimans,2023-03-08
0,1,0,1,0,Perquimans,2023-03-11
0,1,0,1,0,Perquimans,2023-03-17
0,1,0,1,0,Perquimans,2023-03-18
0,1,0,1,0,Perquimans,2023-03-27
0,1,0,1,0,Perquimans,2023-03-30
0,1,0,1,0,Perquimans,2023-04-11
0,1,0,1,0,Perquimans,2023-04-12
0,1,0,1,0,Perquimans,2023-04-18
0,1,0,1,0,Perquimans,2023-04-25
0,1,0,1,0,Perquimans,2023-05-02
0,5,0,5,0,Person,2022-11-10
0,2,0,2,0,Person,2022-11-26
0,2,0,2,0,Person,2022-11-27
0,6,0,6,0,Person,2022-11-29
0,2,0,2,0,Person,2022-12-04
0,1,0,1,0,Person,2022-12-15
0,4,0,4,0,Person,2022-12-18
0,2,0,2,0,Person,2022-12-25
0,2,0,2,0,Person,2023-01-10
0,1,0,1,0,Person,2023-01-15
0,1,0,1,0,Person,2023-02-04
0,5,0,5,0,Person,2023-02-09
0,2,0,2,0,Person,2023-02-11
0,1,0,1,0,Person,2023-02-21
0,1,0,1,0,Person,2023-02-23
0,2,0,2,0,Person,2023-02-26
0,1,0,1,0,Person,2023-03-02
0,2,0,2,0,Person,2023-03-08
0,1,0,1,0,Person,2023-03-15
0,1,0,1,0,Person,2023-03-18
0,2,0,2,0,Person,2023-03-23
0,1,0,1,0,Person,2023-03-24
0,1,0,1,0,Person,2023-04-01
0,1,0,1,0,Person,2023-04-04
0,1,0,1,0,Person,2023-04-05
0,1,0,1,0,Person,2023-04-07
0,2,0,2,0,Person,2023-04-18
0,2,0,2,0,Person,2023-04-22
0,1,0,1,0,Person,2023-04-23
0,1,0,1,0,Person,2023-04-24
0,1,0,1,0,Person,2023-04-27
0,2,0,2,0,Person,2023-05-01
0,1,0,1,0,Person,2023-05-02
0,1,0,1,0,Person,2023-05-05
0,1,0,1,0,Person,2023-05-06
0,7,0,7,0,Pitt,2022-11-13
0,1,0,1,0,Pitt,2023-04-06
0,2,0,2,0,Pitt,2023-04-15
0,1,0,1,0,Pitt,2023-04-23
0,1,0,1,0,Pitt,2023-04-29
0,3,0,3,0,Polk,2022-12-15
0,1,0,1,0,Polk,2022-12-20
0,1,0,1,0,Polk,2023-01-14
0,1,0,1,0,Polk,2023-01-20
0,2,0,2,0,Polk,2023-01-28
0,1,0,1,0,Polk,2023-02-07
0,2,0,2,0,Polk,2023-02-18
0,1,0,1,0,Polk,2023-02-19
0,1,0,1,0,Polk,2023-02-26
0,1,0,1,0,Polk,2023-03-02
0,1,0,1,0,Polk,2023-03-03
0,1,0,1,0,Polk,2023-03-04
0,1,0,1,0,Polk,2023-03-07
0,1,0,1,0,Polk,2023-03-20
0,2,0,2,0,Polk,2023-03-22
0,1,0,1,0,Polk,2023-03-27
0,1,0,1,0,Polk,2023-04-02
0,1,0,1,0,Polk,2023-04-10
0,1,0,1,0,Polk,2023-04-12
0,1,0,1,0,Polk,2023-04-27
0,1,0,1,0,Polk,2023-04-29
0,1,0,1,0,Polk,2023-04-30
0,1,0,1,0,Polk,2023-05-06
0,1,0,1,0,Randolph,2023-03-04
0,2,0,2,0,Randolph,2023-04-09
0,1,0,1,0,Randolph,2023-04-24
0,4,0,4,0,Richmond,2022-11-11
0,3,0,3,0,Richmond,2022-11-13
0,4,0,4,0,Richmond,2022-11-21
0,1,0,1,0,Richmond,2022-11-24
0,4,0,4,0,Richmond,2023-01-15
0,2,0,2,0,Richmond,2023-01-28
0,4,0,4,0,Richmond,2023-02-12
0,3,0,3,0,Richmond,2023-02-18
0,2,0,2,0,Richmond,2023-02-25
0,3,0,3,0,Richmond,2023-02-26
0,2,0,2,0,Richmond,2023-03-05
0,3,0,3,0,Richmond,2023-03-11
0,1,0,1,0,Richmond,2023-03-14
0,2,0,2,0,Richmond,2023-03-16
0,2,0,2,0,Richmond,2023-03-17
0,3,0,3,0,Richmond,2023-03-28
0,2,0,2,0,Richmond,2023-04-05
0,1,0,1,0,Richmond,2023-04-07
0,1,0,1,0,Richmond,2023-04-17
0,1,0,1,0,Richmond,2023-04-18
0,2,0,2,0,Richmond,2023-04-24
0,2,0,2,0,Richmond,2023-04-30
0,1,0,1,0,Richmond,2023-05-05
0,1,0,1,0,Robeson,2023-04-16
0,2,0,2,0,Robeson,2023-04-22
0,1,0,1,0,Robeson,2023-04-24
0,5,0,5,0,Rockingham,2022-12-25
0,6,0,6,0,Rockingham,2023-02-06
0,2,0,2,0,Rockingham,2023-02-25
0,2,0,2,0,Rockingham,2023-03-03
0,3,0,3,0,Rockingham,2023-03-04
0,2,0,2,0,Rockingham,2023-03-11
0,3,0,3,0,Rockingham,2023-03-12
0,7,0,7,0,Rockingham,2023-03-13
0,5,0,5,0,Rockingham,2023-03-17
0,1,0,1,0,Rockingham,2023-03-18
0,4,0,4,0,Rockingham,2023-03-22
0,2,0,2,0,Rockingham,2023-03-25
0,2,0,2,0,Rockingham,2023-03-26
0,4,0,4,0,Rockingham,2023-03-27
0,1,0,1,0,Rockingham,2023-04-11
0,1,0,1,0,Rockingham,2023-04-19
0,2,0,2,0,Rockingham,2023-04-22
0,1,0,1,0,Rockingham,2023-04-25
0,1,0,1,0,Rockingham,2023-05-01
0,11,0,11,0,Rowan,2023-01-29
0,6,0,6,0,Rowan,2023-02-12
0,11,0,11,0,Rowan,2023-02-24
0,1,0,1,0,Rowan,2023-04-29
0,1,0,1,0,Rowan,2023-04-30
0,3,0,3,0,Rowan,2023-05-04
0,3,0,3,0,Rutherford,2022-11-17
0,1,0,1,0,Rutherford,2022-11-18
0,7,0,7,0,Rutherford,2022-12-11
0,5,0,5,0,Rutherford,2023-02-10
0,5,0,5,0,Rutherford,2023-02-12
0,2,0,2,0,Rutherford,2023-02-19
0,1,0,1,0,Rutherford,2023-02-24
0,1,0,1,0,Rutherford,2023-02-26
0,3,0,3,0,Rutherford,2023-03-05
0,2,0,2,0,Rutherford,2023-03-06
0,1,0,1,0,Rutherford,2023-03-10
0,2,0,2,0,Rutherford,2023-03-11
0,1,0,1,0,Rutherford,2023-03-16
0,1,0,1,0,Rutherford,2023-03-19
0,2,0,2,0,Rutherford,2023-03-21
0,1,0,1,0,Rutherford,2023-03-22
0,1,0,1,0,Rutherford,2023-03-27
0,2,0,2,0,Rutherford,2023-03-29
0,1,0,1,0,Rutherford,2023-04-06
0,3,0,3,0,Rutherford,2023-04-08
0,2,0,2,0,Rutherford,2023-04-10
0,2,0,2,0,Rutherford,2023-04-11
0,1,0,1,0,Rutherford,2023-04-20
0,3,0,3,0,Rutherford,2023-04-29
0,3,0,3,0,Sampson,2022-11-19
0,1,0,1,0,Sampson,2022-11-24
0,2,0,2,0,Sampson,2023-02-18
0,4,0,4,0,Sampson,2023-03-02
0,1,0,1,0,Sampson,2023-04-19
0,1,0,1,0,Sampson,2023-04-21
0,1,0,1,0,Sampson,2023-04-30
0,1,0,1,0,Sampson,2023-05-04
0,1,0,1,0,Sampson,2023-05-05
0,1,0,1,0,Scotland,2022-11-20
0,1,0,1,0,Scotland,2022-11-25
0,1,0,1,0,Scotland,2022-12-03
0,1,0,1,0,Scotland,2023-03-17
0,3,0,3,0,Scotland,2023-03-24
0,1,0,1,0,Scotland,2023-04-07
0,2,0,2,0,Scotland,2023-04-10
0,2,0,2,0,Scotland,2023-04-29
0,5,0,5,0,Stanly,2022-11-10
0,4,0,4,0,Stanly,2022-11-16
0,8,0,8,0,Stanly,2022-11-22
0,4,0,4,0,Stanly,2022-11-24
0,4,0,4,0,Stanly,2022-11-26
0,4,0,4,0,Stanly,2022-11-27
0,6,0,6,0,Stanly,2022-11-28
0,4,0,4,0,Stanly,2022-12-04
0,8,0,8,0,Stanly,2022-12-10
0,3,0,3,0,Stanly,2022-12-25
0,3,0,3,0,Stanly,2023-01-29
0,7,0,7,0,Stanly,2023-02-03
0,7,0,7,0,Stanly,2023-02-09
0,2,0,2,0,Stanly,2023-02-24
0,1,0,1,0,Stanly,2023-02-26
0,2,0,2,0,Stanly,2023-03-01
0,4,0,4,0,Stanly,2023-03-04
0,2,0,2,0,Stanly,2023-03-05
0,4,0,4,0,Stanly,2023-03-06
0,4,0,4,0,Stanly,2023-03-07
0,1,0,1,0,Stanly,2023-03-10
0,2,0,2,0,Stanly,2023-03-11
0,2,0,2,0,Stanly,2023-03-12
0,3,0,3,0,Stanly,2023-03-13
0,2,0,2,0,Stanly,2023-03-16
0,1,0,1,0,Stanly,2023-03-17
0,1,0,1,0,Stanly,2023-03-18
0,1,0,1,0,Stanly,2023-03-21
0,2,0,2,0,Stanly,2023-03-24
0,1,0,1,0,Stanly,2023-03-26
0,1,0,1,0,Stanly,2023-03-27
0,2,0,2,0,Stanly,2023-03-31
0,2,0,2,0,Stanly,2023-04-01
0,1,0,1,0,Stanly,2023-04-06
0,1,0,1,0,Stanly,2023-04-08
0,1,0,1,0,Stanly,2023-04-13
0,1,0,1,0,Stanly,2023-04-20
0,2,0,2,0,Stanly,2023-04-21
0,2,0,2,0,Stanly,2023-04-26
0,1,0,1,0,Stanly,2023-04-29
0,2,0,2,0,Stanly,2023-04-30
0,1,0,1,0,Stanly,2023-05-01
0,3,0,3,0,Stanly,2023-05-02
0,3,0,3,0,Stanly,2023-05-05
0,3,0,3,0,Stokes,2022-11-10
0,12,0,12,0,Stokes,2023-02-14
0,2,0,2,0,Stokes,2023-03-04
0,4,0,4,0,Stokes,2023-03-07
0,1,0,1,0,Stokes,2023-03-17
0,2,0,2,0,Stokes,2023-03-21
0,3,0,3,0,Stokes,2023-03-23
0,1,0,1,0,Stokes,2023-03-24
0,2,0,2,0,Stokes,2023-03-25
0,3,0,3,0,Stokes,2023-03-26
0,1,0,1,0,Stokes,2023-03-29
0,1,0,1,0,Stokes,2023-04-01
0,2,0,2,0,Stokes,2023-04-04
0,2,0,2,0,Stokes,2023-04-05
0,5,0,5,0,Stokes,2023-04-10
0,4,0,4,0,Stokes,2023-04-12
0,4,0,4,0,Stokes,2023-04-14
0,1,0,1,0,Stokes,2023-04-15
0,2,0,2,0,Stokes,2023-04-18
0,1,0,1,0,Stokes,2023-04-25
0,1,0,1,0,Stokes,2023-04-27
0,1,0,1,0,Stokes,2023-05-04
0,6,0,6,0,Surry,2023-03-04
0,3,0,3,0,Surry,2023-03-11
0,1,0,1,0,Surry,2023-03-16
0,2,0,2,0,Surry,2023-04-05
0,1,0,1,0,Surry,2023-04-08
0,1,0,1,0,Surry,2023-04-23
0,3,0,3,0,Surry,2023-04-27
0,1,0,1,0,Surry,2023-04-29
0,1,0,1,0,Surry,2023-05-02
0,1,0,1,0,Surry,2023-05-05
0,1,0,1,0,Swain,2022-11-11
0,1,0,1,0,Swain,2022-11-13
0,2,0,2,0,Swain,2022-11-17
0,1,0,1,0,Swain,2022-11-18
0,3,0,3,0,Swain,2022-11-19
0,3,0,3,0,Swain,2022-11-22
0,1,0,1,0,Swain,2022-11-23
0,1,0,1,0,Swain,2022-11-27
0,1,0,1,0,Swain,2022-12-15
0,2,0,2,0,Swain,2022-12-25
0,2,0,2,0,Swain,2023-01-23
0,1,0,1,0,Swain,2023-02-04
0,2,0,2,0,Swain,2023-02-13
0,2,0,2,0,Swain,2023-02-23
0,1,0,1,0,Swain,2023-03-06
0,1,0,1,0,Swain,2023-03-08
0,3,0,3,0,Swain,2023-03-09
0,2,0,2,0,Swain,2023-03-10
0,1,0,1,0,Swain,2023-03-15
0,2,0,2,0,Swain,2023-03-20
0,1,0,1,0,Swain,2023-03-22
0,1,0,1,0,Swain,2023-03-29
0,1,0,1,0,Swain,2023-04-02
0,1,0,1,0,Swain,2023-04-16
0,1,0,1,0,Swain,2023-04-20
0,1,0,1,0,Swain,2023-05-01
0,3,0,3,0,Transylvania,2022-11-08
0,3,0,3,0,Transylvania,2022-11-09
0,2,0,2,0,Transylvania,2022-11-11
0,2,0,2,0,Transylvania,2022-11-17
0,2,0,2,0,Transylvania,2022-11-18
0,2,0,2,0,Transylvania,2022-11-19
0,1,0,1,0,Transylvania,2022-11-21
0,1,0,1,0,Transylvania,2022-11-23
0,1,0,1,0,Transylvania,2022-11-24
0,5,0,5,0,Transylvania,2022-12-05
0,4,0,4,0,Transylvania,2022-12-07
0,3,0,3,0,Transylvania,2022-12-08
0,3,0,3,0,Transylvania,2022-12-16
0,5,0,5,0,Transylvania,2022-12-17
0,4,0,4,0,Transylvania,2022-12-27
0,4,0,4,0,Transylvania,2023-01-01
0,2,0,2,0,Transylvania,2023-01-06
0,4,0,4,0,Transylvania,2023-01-16
0,1,0,1,0,Transylvania,2023-02-04
0,1,0,1,0,Transylvania,2023-02-06
0,8,0,8,0,Transylvania,2023-02-08
0,1,0,1,0,Transylvania,2023-02-10
0,1,0,1,0,Transylvania,2023-02-15
0,1,0,1,0,Transylvania,2023-02-22
0,2,0,2,0,Transylvania,2023-02-24
0,2,0,2,0,Transylvania,2023-03-03
0,1,0,1,0,Transylvania,2023-03-04
0,2,0,2,0,Transylvania,2023-03-08
0,1,0,1,0,Transylvania,2023-03-11
0,2,0,2,0,Transylvania,2023-03-14
0,1,0,1,0,Transylvania,2023-03-16
0,2,0,2,0,Transylvania,2023-03-20
0,2,0,2,0,Transylvania,2023-03-25
0,1,0,1,0,Transylvania,2023-03-26
0,5,0,5,0,Transylvania,2023-03-27
0,1,0,1,0,Transylvania,2023-04-04
0,1,0,1,0,Transylvania,2023-04-05
0,2,0,2,0,Transylvania,2023-04-07
0,1,0,1,0,Transylvania,2023-04-08
0,1,0,1,0,Transylvania,2023-04-11
0,1,0,1,0,Transylvania,2023-04-12
0,2,0,2,0,Transylvania,2023-04-16
0,3,0,3,0,Transylvania,2023-04-22
0,2,0,2,0,Transylvania,2023-04-23
0,1,0,1,0,Transylvania,2023-04-27
0,1,0,1,0,Transylvania,2023-04-28
0,1,0,1,0,Transylvania,2023-04-29
0,1,0,1,0,Transylvania,2023-04-30
0,2,0,2,0,Transylvania,2023-05-01
0,1,0,1,0,Transylvania,2023-05-02
0,1,0,1,0,Transylvania,2023-05-04
0,1,0,1,0,Tyrrell,2022-11-13
0,1,0,1,0,Tyrrell,2022-11-20
0,1,0,1,0,Tyrrell,2022-12-10
0,1,0,1,0,Tyrrell,2022-12-19
0,1,0,1,0,Tyrrell,2022-12-29
0,1,0,1,0,Tyrrell,2022-12-31
0,1,0,1,0,Tyrrell,2023-01-09
0,1,0,1,0,Tyrrell,2023-01-28
0,1,0,1,0,Tyrrell,2023-01-30
0,1,0,1,0,Tyrrell,2023-02-16
0,1,0,1,0,Tyrrell,2023-04-05
0,1,0,1,0,Tyrrell,2023-04-11
0,10,0,10,0,Union,2022-12-25
0,4,0,4,0,Union,2023-04-29
0,1,0,1,0,Vance,2022-11-19
0,3,0,3,0,Vance,2022-11-20
0,2,0,2,0,Vance,2022-11-25
0,4,0,4,0,Vance,2022-12-04
0,1,0,1,0,Vance,2022-12-24
0,4,0,4,0,Vance,2023-02-21
0,3,0,3,0,Vance,2023-03-01
0,1,0,1,0,Vance,2023-03-03
0,2,0,2,0,Vance,2023-03-13
0,2,0,2,0,Vance,2023-03-24
0,2,0,2,0,Vance,2023-03-26
0,1,0,1,0,Vance,2023-04-15
0,1,0,1,0,Vance,2023-04-19
0,1,0,1,0,Vance,2023-04-21
0,2,0,2,0,Vance,2023-04-25
0,4,0,4,0,Vance,2023-04-28
0,1,0,1,0,Vance,2023-04-29
0,1,0,1,0,Vance,2023-05-01
0,1,0,1,0,Vance,2023-05-02
0,2,0,2,0,Warren,2022-11-27
0,2,0,2,0,Warren,2022-11-29
0,2,0,2,0,Warren,2022-11-30
0,1,0,1,0,Warren,2022-12-17
0,3,0,3,0,Warren,2022-12-21
0,3,0,3,0,Warren,2022-12-24
0,1,0,1,0,Warren,2023-01-01
0,1,0,1,0,Warren,2023-01-15
0,2,0,2,0,Warren,2023-01-16
0,5,0,5,0,Warren,2023-01-17
0,1,0,1,0,Warren,2023-01-20
0,3,0,3,0,Warren,2023-01-27
0,3,0,3,0,Warren,2023-02-05
0,1,0,1,0,Warren,2023-02-08
0,2,0,2,0,Warren,2023-02-14
0,2,0,2,0,Warren,2023-03-12
0,2,0,2,0,Warren,2023-03-17
0,1,0,1,0,Warren,2023-03-18
0,1,0,1,0,Warren,2023-03-26
0,1,0,1,0,Warren,2023-03-27
0,1,0,1,0,Warren,2023-04-03
0,1,0,1,0,Warren,2023-04-09
0,1,0,1,0,Warren,2023-04-10
0,2,0,2,0,Warren,2023-04-15
0,1,0,1,0,Warren,2023-04-20
0,3,0,3,0,Warren,2023-04-22
0,1,0,1,0,Warren,2023-04-23
0,1,0,1,0,Warren,2023-04-25
0,1,0,1,0,Warren,2023-04-28
0,2,0,2,0,Warren,2023-04-29
0,1,0,1,0,Washington,2022-11-08
0,1,0,1,0,Washington,2022-11-17
0,1,0,1,0,Washington,2022-11-20
0,1,0,1,0,Washington,2022-11-29
0,2,0,2,0,Washington,2022-12-01
0,4,0,4,0,Washington,2022-12-08
0,1,0,1,0,Washington,2022-12-09
0,2,0,2,0,Washington,2022-12-10
0,1,0,1,0,Washington,2022-12-11
0,3,0,3,0,Washington,2022-12-13
0,5,0,5,0,Washington,2022-12-20
0,3,0,3,0,Washington,2022-12-29
0,3,0,3,0,Washington,2023-01-04
0,2,0,2,0,Washington,2023-01-08
0,1,0,1,0,Washington,2023-01-10
0,3,0,3,0,Washington,2023-01-16
0,3,0,3,0,Washington,2023-01-17
0,1,0,1,0,Washington,2023-01-21
0,3,0,3,0,Washington,2023-01-24
0,1,0,1,0,Washington,2023-01-28
0,6,0,6,0,Washington,2023-02-01
0,5,0,5,0,Washington,2023-02-08
0,1,0,1,0,Washington,2023-02-09
0,1,0,1,0,Washington,2023-02-14
0,1,0,1,0,Washington,2023-02-18
0,1,0,1,0,Washington,2023-02-20
0,1,0,1,0,Washington,2023-02-21
0,1,0,1,0,Washington,2023-02-24
0,1,0,1,0,Washington,2023-02-25
0,1,0,1,0,Washington,2023-02-28
0,1,0,1,0,Washington,2023-03-06
0,1,0,1,0,Washington,2023-03-07
0,2,0,2,0,Washington,2023-03-09
0,1,0,1,0,Washington,2023-03-16
0,1,0,1,0,Washington,2023-03-17
0,3,0,3,0,Washington,2023-03-20
0,1,0,1,0,Washington,2023-03-21
0,2,0,2,0,Washington,2023-04-01
0,1,0,1,0,Washington,2023-04-09
0,1,0,1,0,Washington,2023-04-12
0,1,0,1,0,Washington,2023-04-21
0,4,0,4,0,Watauga,2022-11-18
0,3,0,3,0,Watauga,2022-11-23
0,1,0,1,0,Watauga,2022-11-24
0,2,0,2,0,Watauga,2022-11-26
0,2,0,2,0,Watauga,2022-11-27
0,7,0,7,0,Watauga,2023-01-01
0,3,0,3,0,Watauga,2023-01-05
0,2,0,2,0,Watauga,2023-01-14
0,5,0,5,0,Watauga,2023-02-10
0,1,0,1,0,Watauga,2023-03-02
0,2,0,2,0,Watauga,2023-03-05
0,2,0,2,0,Watauga,2023-03-11
0,2,0,2,0,Watauga,2023-03-31
0,1,0,1,0,Watauga,2023-04-02
0,1,0,1,0,Watauga,2023-04-06
0,2,0,2,0,Watauga,2023-04-11
0,1,0,1,0,Watauga,2023-04-12
0,2,0,2,0,Watauga,2023-04-18
0,2,0,2,0,Watauga,2023-04-20
0,1,0,1,0,Watauga,2023-04-25
0,1,0,1,0,Watauga,2023-04-27
0,2,0,2,0,Watauga,2023-04-29
0,1,0,1,0,Watauga,2023-05-04
0,2,0,2,0,Watauga,2023-05-05
0,2,0,2,0,Wayne,2023-04-01
0,1,0,1,0,Wayne,2023-04-09
0,4,0,4,0,Wayne,2023-04-21
0,1,0,1,0,Wayne,2023-04-30
0,3,0,3,0,Wilkes,2022-11-20
0,1,0,1,0,Wilkes,2023-03-23
0,2,0,2,0,Wilkes,2023-03-28
0,1,0,1,0,Wilkes,2023-04-10
0,1,0,1,0,Wilson,2022-11-24
0,1,0,1,0,Wilson,2023-03-25
0,3,0,3,0,Wilson,2023-03-27
0,3,0,3,0,Wilson,2023-03-31
0,1,0,1,0,Wilson,2023-04-07
0,2,0,2,0,Wilson,2023-04-16
0,2,0,2,0,Yadkin,2022-11-08
0,1,0,1,0,Yadkin,2022-11-20
0,1,0,1,0,Yadkin,2022-11-26
0,8,0,8,0,Yadkin,2023-01-13
0,1,0,1,0,Yadkin,2023-03-04
0,2,0,2,0,Yadkin,2023-03-07
0,2,0,2,0,Yadkin,2023-03-08
0,1,0,1,0,Yadkin,2023-03-10
0,1,0,1,0,Yadkin,2023-03-23
0,2,0,2,0,Yadkin,2023-03-27
0,1,0,1,0,Yadkin,2023-03-29
0,2,0,2,0,Yadkin,2023-04-01
0,3,0,3,0,Yadkin,2023-04-02
0,5,0,5,0,Yadkin,2023-04-03
0,1,0,1,0,Yadkin,2023-04-05
0,2,0,2,0,Yadkin,2023-04-06
0,1,0,1,0,Yadkin,2023-04-07
0,2,0,2,0,Yadkin,2023-04-08
0,1,0,1,0,Yadkin,2023-04-09
0,2,0,2,0,Yadkin,2023-04-11
0,2,0,2,0,Yadkin,2023-04-17
0,2,0,2,0,Yancey,2022-11-08
0,1,0,1,0,Yancey,2022-11-09
0,1,0,1,0,Yancey,2022-11-12
0,1,0,1,0,Yancey,2022-11-19
0,2,0,2,0,Yancey,2022-11-25
0,1,0,1,0,Yancey,2022-12-06
0,1,0,1,0,Yancey,2022-12-17
0,1,0,1,0,Yancey,2022-12-25
0,1,0,1,0,Yancey,2023-01-01
0,1,0,1,0,Yancey,2023-01-08
0,1,0,1,0,Yancey,2023-01-11
0,1,0,1,0,Yancey,2023-01-13
0,1,0,1,0,Yancey,2023-01-14
0,1,0,1,0,Yancey,2023-01-15
0,1,0,1,0,Yancey,2023-01-21
0,1,0,1,0,Yancey,2023-01-25
0,1,0,1,0,Yancey,2023-01-29
0,2,0,2,0,Yancey,2023-01-30
0,1,0,1,0,Yancey,2023-02-03
0,1,0,1,0,Yancey,2023-02-05
0,4,0,4,0,Yancey,2023-02-08
0,1,0,1,0,Yancey,2023-02-10
0,1,0,1,0,Yancey,2023-02-19
0,1,0,1,0,Yancey,2023-02-23
0,1,0,1,0,Yancey,2023-03-11
0,1,0,1,0,Yancey,2023-03-12
0,1,0,1,0,Yancey,2023-03-24
0,1,0,1,0,Yancey,2023-04-03
0,1,0,1,0,Yancey,2023-04-06
0,1,0,1,0,Yancey,2023-04-07
0,2,0,2,0,Yancey,2023-04-22
0,1,0,1,0,Yancey,2023-04-24
0,1,0,1,0,Yancey,2023-04-26
0,2,0,2,0,Yancey,2023-04-30
0,2,0,2,0,Yancey,2023-05-03
0,12,1,11,0,Alamance,2022-11-12
0,8,1,7,0,Alamance,2023-03-26
0,3,1,2,0,Alamance,2023-04-08
0,9,1,8,0,Alamance,2023-04-12
0,3,1,2,0,Alexander,2022-11-09
0,2,1,1,0,Alexander,2022-11-26
0,4,1,3,0,Alexander,2022-11-27
0,1,1,0,0,Alexander,2023-01-15
0,3,1,2,0,Alexander,2023-02-11
0,1,1,0,0,Alexander,2023-02-12
0,2,1,1,0,Alexander,2023-02-19
0,1,1,0,0,Alexander,2023-03-05
0,4,1,3,0,Alexander,2023-03-07
0,1,1,0,0,Alexander,2023-03-17
0,2,1,1,0,Alexander,2023-03-22
0,2,1,1,0,Alexander,2023-03-26
0,4,1,3,0,Alexander,2023-03-27
0,1,1,0,0,Alexander,2023-03-28
0,3,1,2,0,Alexander,2023-04-05
0,1,1,0,0,Alexander,2023-04-20
0,2,1,1,0,Alexander,2023-05-01
0,1,1,0,0,Alleghany,2022-11-08
0,1,1,0,0,Alleghany,2022-11-11
0,1,1,0,0,Alleghany,2022-11-13
0,1,1,0,0,Alleghany,2022-11-14
0,2,1,1,0,Alleghany,2022-11-24
0,1,1,0,0,Alleghany,2022-11-26
0,5,1,4,0,Alleghany,2022-12-09
0,1,1,0,0,Alleghany,2022-12-10
0,1,1,0,0,Alleghany,2022-12-18
0,1,1,0,0,Alleghany,2022-12-23
0,1,1,0,0,Alleghany,2022-12-24
0,3,1,2,0,Alleghany,2022-12-25
0,2,1,1,0,Alleghany,2022-12-26
0,1,1,0,0,Alleghany,2023-01-07
0,2,1,1,0,Alleghany,2023-02-08
0,2,1,1,0,Alleghany,2023-03-03
0,1,1,0,0,Alleghany,2023-03-17
0,2,1,1,0,Alleghany,2023-04-06
0,1,1,0,0,Alleghany,2023-04-12
0,3,1,2,0,Anson,2022-11-25
0,3,1,2,0,Anson,2022-11-29
0,7,1,6,0,Anson,2022-12-23
0,2,1,1,0,Anson,2023-01-20
0,2,1,1,0,Anson,2023-01-22
0,6,1,5,0,Anson,2023-01-25
0,5,1,4,0,Anson,2023-02-11
0,2,1,1,0,Anson,2023-02-16
0,6,1,5,0,Anson,2023-02-20
0,2,1,1,0,Anson,2023-02-26
0,1,1,0,0,Anson,2023-03-02
0,2,1,1,0,Anson,2023-03-14
0,3,1,2,0,Anson,2023-03-21
0,1,1,0,0,Anson,2023-04-08
0,3,1,2,0,Anson,2023-04-12
0,2,1,1,0,Anson,2023-04-17
0,1,1,0,0,Anson,2023-05-01
0,3,1,2,0,Ashe,2022-11-20
0,1,1,0,0,Ashe,2022-11-22
0,3,1,2,0,Ashe,2022-11-25
0,1,1,0,0,Ashe,2022-12-04
0,3,1,2,0,Ashe,2022-12-13
0,3,1,2,0,Ashe,2023-01-21
0,8,1,7,0,Ashe,2023-01-23
0,4,1,3,0,Ashe,2023-01-26
0,2,1,1,0,Ashe,2023-02-08
0,2,1,1,0,Ashe,2023-02-10
0,3,1,2,0,Ashe,2023-02-11
0,1,1,0,0,Ashe,2023-02-28
0,1,1,0,0,Ashe,2023-03-02
0,3,1,2,0,Ashe,2023-03-03
0,2,1,1,0,Ashe,2023-03-06
0,2,1,1,0,Ashe,2023-03-08
0,1,1,0,0,Ashe,2023-03-11
0,2,1,1,0,Ashe,2023-03-25
0,4,1,3,0,Ashe,2023-03-27
0,1,1,0,0,Ashe,2023-04-13
0,1,1,0,0,Ashe,2023-04-16
0,1,1,0,0,Ashe,2023-04-20
0,1,1,0,0,Ashe,2023-04-29
0,1,1,0,0,Ashe,2023-05-02
0,1,1,0,0,Avery,2022-11-13
0,1,1,0,0,Avery,2022-11-18
0,1,1,0,0,Avery,2022-11-22
0,3,1,2,0,Avery,2022-12-07
0,3,1,2,0,Avery,2022-12-10
0,9,1,8,0,Avery,2022-12-19
0,3,1,2,0,Avery,2022-12-22
0,7,1,6,0,Avery,2022-12-28
0,2,1,1,0,Avery,2023-01-01
0,5,1,4,0,Avery,2023-01-02
0,2,1,1,0,Avery,2023-01-17
0,1,1,0,0,Avery,2023-01-27
0,1,1,0,0,Avery,2023-04-10
0,3,1,2,0,Avery,2023-04-18
0,1,1,0,0,Avery,2023-04-23
0,1,1,0,0,Beaufort,2022-11-08
0,3,1,2,0,Beaufort,2022-11-19
0,4,1,3,0,Beaufort,2022-12-08
0,1,1,0,0,Beaufort,2022-12-25
0,3,1,2,0,Beaufort,2023-03-02
0,2,1,1,0,Beaufort,2023-03-25
0,1,1,0,0,Beaufort,2023-03-27
0,2,1,1,0,Beaufort,2023-04-03
0,2,1,1,0,Beaufort,2023-04-05
0,1,1,0,0,Beaufort,2023-04-18
0,1,1,0,0,Bertie,2022-11-10
0,1,1,0,0,Bertie,2022-12-07
0,1,1,0,0,Bertie,2022-12-13
0,3,1,2,0,Bertie,2022-12-14
0,3,1,2,0,Bertie,2022-12-20
0,7,1,6,0,Bertie,2022-12-31
0,3,1,2,0,Bertie,2023-01-20
0,2,1,1,0,Bertie,2023-01-27
0,5,1,4,0,Bertie,2023-02-08
0,3,1,2,0,Bertie,2023-02-25
0,4,1,3,0,Bertie,2023-03-07
0,1,1,0,0,Bertie,2023-04-11
0,1,1,0,0,Bertie,2023-04-25
0,1,1,0,0,Bertie,2023-04-27
0,3,1,2,0,Bladen,2022-11-15
0,3,1,2,0,Bladen,2023-01-01
0,5,1,4,0,Bladen,2023-01-29
0,2,1,1,0,Bladen,2023-02-28
0,1,1,0,0,Bladen,2023-03-15
0,3,1,2,0,Bladen,2023-04-11
0,1,1,0,0,Bladen,2023-04-18
0,2,1,1,0,Bladen,2023-04-29
0,1,1,0,0,Bladen,2023-05-05
0,10,1,9,0,Brunswick,2023-02-10
0,4,1,3,0,Brunswick,2023-03-18
0,10,1,9,0,Brunswick,2023-03-26
0,5,1,4,0,Brunswick,2023-03-31
0,4,1,3,0,Brunswick,2023-04-16
0,6,1,5,0,Brunswick,2023-04-30
0,3,1,2,0,Buncombe,2023-03-12
0,6,1,5,0,Buncombe,2023-04-20
0,3,1,2,0,Buncombe,2023-05-04
0,5,1,4,0,Buncombe,2023-05-06
0,9,1,8,0,Burke,2023-02-01
0,5,1,4,0,Burke,2023-03-02
0,1,1,0,0,Burke,2023-03-03
0,8,1,7,0,Burke,2023-03-07
0,4,1,3,0,Burke,2023-03-09
0,3,1,2,0,Burke,2023-03-14
0,6,1,5,0,Burke,2023-03-25
0,1,1,0,0,Burke,2023-04-14
0,1,1,0,0,Burke,2023-04-15
0,4,1,3,0,Burke,2023-04-27
0,3,1,2,0,Burke,2023-05-04
0,6,1,5,0,Cabarrus,2023-05-05
0,6,1,5,0,Cabarrus,2023-05-06
0,8,1,7,0,Caldwell,2023-02-18
0,5,1,4,0,Caldwell,2023-03-09
0,2,1,1,0,Caldwell,2023-03-25
0,3,1,2,0,Caldwell,2023-03-31
0,2,1,1,0,Caldwell,2023-04-28
0,5,1,4,0,Caldwell,2023-05-01
0,1,1,0,0,Camden,2022-11-08
0,1,1,0,0,Camden,2022-11-10
0,1,1,0,0,Camden,2022-11-15
0,2,1,1,0,Camden,2022-11-18
0,1,1,0,0,Camden,2022-11-21
0,1,1,0,0,Camden,2022-11-25
0,1,1,0,0,Camden,2022-12-01
0,1,1,0,0,Camden,2022-12-04
0,1,1,0,0,Camden,2022-12-07
0,2,1,1,0,Camden,2022-12-09
0,1,1,0,0,Camden,2022-12-12
0,1,1,0,0,Camden,2022-12-17
0,3,1,2,0,Camden,2022-12-18
0,1,1,0,0,Camden,2022-12-22
0,1,1,0,0,Camden,2023-01-20
0,3,1,2,0,Camden,2023-01-28
0,1,1,0,0,Camden,2023-02-01
0,1,1,0,0,Camden,2023-02-02
0,2,1,1,0,Camden,2023-02-14
0,1,1,0,0,Camden,2023-02-16
0,1,1,0,0,Camden,2023-02-20
0,1,1,0,0,Camden,2023-02-23
0,1,1,0,0,Camden,2023-02-27
0,1,1,0,0,Camden,2023-03-03
0,1,1,0,0,Camden,2023-03-13
0,1,1,0,0,Camden,2023-03-16
0,1,1,0,0,Camden,2023-03-17
0,2,1,1,0,Camden,2023-03-22
0,1,1,0,0,Camden,2023-03-27
0,1,1,0,0,Camden,2023-03-28
0,1,1,0,0,Camden,2023-03-30
0,1,1,0,0,Camden,2023-04-06
0,1,1,0,0,Camden,2023-04-09
0,1,1,0,0,Camden,2023-04-30
0,1,1,0,0,Carteret,2022-11-08
0,1,1,0,0,Carteret,2022-11-10
0,2,1,1,0,Carteret,2022-11-11
0,1,1,0,0,Carteret,2022-11-12
0,3,1,2,0,Carteret,2022-11-16
0,2,1,1,0,Carteret,2022-11-18
0,7,1,6,0,Carteret,2022-11-29
0,1,1,0,0,Carteret,2023-01-21
0,5,1,4,0,Carteret,2023-02-27
0,7,1,6,0,Carteret,2023-02-28
0,1,1,0,0,Carteret,2023-03-10
0,2,1,1,0,Carteret,2023-03-15
0,2,1,1,0,Carteret,2023-03-16
0,1,1,0,0,Carteret,2023-03-27
0,5,1,4,0,Carteret,2023-03-31
0,1,1,0,0,Carteret,2023-04-01
0,1,1,0,0,Carteret,2023-04-03
0,3,1,2,0,Carteret,2023-04-06
0,1,1,0,0,Carteret,2023-04-07
0,1,1,0,0,Carteret,2023-04-12
0,1,1,0,0,Carteret,2023-04-13
0,1,1,0,0,Carteret,2023-04-22
0,3,1,2,0,Carteret,2023-04-23
0,1,1,0,0,Carteret,2023-04-27
0,2,1,1,0,Carteret,2023-04-28
0,4,1,3,0,Caswell,2022-11-12
0,1,1,0,0,Caswell,2022-11-13
0,4,1,3,0,Caswell,2022-11-29
0,6,1,5,0,Caswell,2022-12-12
0,3,1,2,0,Caswell,2022-12-20
0,4,1,3,0,Caswell,2023-01-06
0,2,1,1,0,Caswell,2023-01-17
0,1,1,0,0,Caswell,2023-01-24
0,4,1,3,0,Caswell,2023-01-25
0,2,1,1,0,Caswell,2023-01-27
0,4,1,3,0,Caswell,2023-01-29
0,1,1,0,0,Caswell,2023-02-08
0,3,1,2,0,Caswell,2023-02-27
0,1,1,0,0,Caswell,2023-03-26
0,8,1,7,0,Catawba,2022-11-13
0,4,1,3,0,Catawba,2023-03-18
0,2,1,1,0,Catawba,2023-03-19
0,1,1,0,0,Catawba,2023-04-09
0,2,1,1,0,Catawba,2023-04-28
0,9,1,8,0,Chatham,2022-11-26
0,6,1,5,0,Chatham,2022-12-01
0,13,1,12,0,Chatham,2022-12-06
0,7,1,6,0,Chatham,2022-12-18
0,7,1,6,0,Chatham,2022-12-24
0,8,1,7,0,Chatham,2023-03-02
0,1,1,0,0,Chatham,2023-03-05
0,2,1,1,0,Chatham,2023-03-22
0,4,1,3,0,Chatham,2023-04-17
0,4,1,3,0,Chatham,2023-04-20
0,2,1,1,0,Chatham,2023-05-04
0,1,1,0,0,Chatham,2023-05-05
0,3,1,2,0,Cherokee,2022-11-17
0,6,1,5,0,Cherokee,2022-11-27
0,3,1,2,0,Cherokee,2022-11-28
0,6,1,5,0,Cherokee,2022-12-01
0,5,1,4,0,Cherokee,2022-12-13
0,1,1,0,0,Cherokee,2022-12-25
0,1,1,0,0,Cherokee,2023-01-08
0,7,1,6,0,Cherokee,2023-01-10
0,1,1,0,0,Cherokee,2023-02-01
0,4,1,3,0,Cherokee,2023-02-19
0,1,1,0,0,Cherokee,2023-02-22
0,1,1,0,0,Cherokee,2023-02-26
0,1,1,0,0,Cherokee,2023-02-27
0,2,1,1,0,Cherokee,2023-02-28
0,4,1,3,0,Cherokee,2023-03-02
0,2,1,1,0,Cherokee,2023-03-20
0,1,1,0,0,Cherokee,2023-04-05
0,3,1,2,0,Cherokee,2023-04-11
0,4,1,3,0,Chowan,2022-11-14
0,2,1,1,0,Chowan,2022-12-05
0,7,1,6,0,Chowan,2022-12-23
0,1,1,0,0,Chowan,2023-02-12
0,1,1,0,0,Chowan,2023-03-26
0,2,1,1,0,Chowan,2023-04-16
0,1,1,0,0,Chowan,2023-04-29
0,1,1,0,0,Chowan,2023-05-02
0,4,1,3,0,Clay,2022-11-10
0,1,1,0,0,Clay,2022-11-12
0,2,1,1,0,Clay,2022-11-23
0,3,1,2,0,Clay,2022-12-05
0,6,1,5,0,Clay,2022-12-21
0,2,1,1,0,Clay,2023-01-13
0,5,1,4,0,Clay,2023-01-17
0,1,1,0,0,Clay,2023-01-25
0,1,1,0,0,Clay,2023-03-01
0,2,1,1,0,Clay,2023-03-14
0,8,1,7,0,Cleveland,2022-11-10
0,2,1,1,0,Cleveland,2023-03-06
0,3,1,2,0,Cleveland,2023-03-09
0,6,1,5,0,Cleveland,2023-03-10
0,2,1,1,0,Cleveland,2023-03-16
0,1,1,0,0,Cleveland,2023-04-18
0,4,1,3,0,Cleveland,2023-04-21
0,5,1,4,0,Cleveland,2023-05-02
0,1,1,0,0,Cleveland,2023-05-06
0,5,1,4,0,Columbus,2022-11-08
0,7,1,6,0,Columbus,2022-11-15
0,2,1,1,0,Columbus,2023-02-12
0,6,1,5,0,Columbus,2023-02-14
0,2,1,1,0,Columbus,2023-02-21
0,3,1,2,0,Columbus,2023-03-03
0,2,1,1,0,Columbus,2023-03-09
0,1,1,0,0,Columbus,2023-03-17
0,2,1,1,0,Columbus,2023-03-21
0,2,1,1,0,Columbus,2023-03-24
0,4,1,3,0,Columbus,2023-04-04
0,1,1,0,0,Columbus,2023-04-05
0,1,1,0,0,Columbus,2023-04-30
0,7,1,6,0,Craven,2022-12-10
0,8,1,7,0,Craven,2023-03-06
0,2,1,1,0,Craven,2023-03-11
0,4,1,3,0,Craven,2023-03-13
0,4,1,3,0,Craven,2023-03-23
0,3,1,2,0,Craven,2023-04-17
0,1,1,0,0,Craven,2023-04-18
0,1,1,0,0,Craven,2023-04-21
0,1,1,0,0,Craven,2023-05-05
0,2,1,1,0,Craven,2023-05-06
0,15,1,14,0,Cumberland,2022-11-24
0,9,1,8,0,Cumberland,2023-04-05
0,5,1,4,0,Cumberland,2023-04-21
0,2,1,1,0,Currituck,2022-11-09
0,1,1,0,0,Currituck,2022-11-15
0,2,1,1,0,Currituck,2022-11-19
0,2,1,1,0,Currituck,2022-11-28
0,5,1,4,0,Currituck,2022-12-19
0,4,1,3,0,Currituck,2022-12-21
0,4,1,3,0,Currituck,2023-01-01
0,7,1,6,0,Currituck,2023-01-02
0,4,1,3,0,Currituck,2023-01-23
0,1,1,0,0,Currituck,2023-01-27
0,3,1,2,0,Currituck,2023-01-28
0,1,1,0,0,Currituck,2023-02-02
0,2,1,1,0,Currituck,2023-02-06
0,3,1,2,0,Currituck,2023-02-25
0,1,1,0,0,Currituck,2023-03-04
0,1,1,0,0,Currituck,2023-03-05
0,2,1,1,0,Currituck,2023-03-28
0,1,1,0,0,Currituck,2023-04-05
0,4,1,3,0,Currituck,2023-04-08
0,2,1,1,0,Currituck,2023-04-12
0,1,1,0,0,Currituck,2023-04-19
0,1,1,0,0,Currituck,2023-04-23
0,5,1,4,0,Dare,2022-12-13
0,7,1,6,0,Dare,2022-12-24
0,1,1,0,0,Dare,2023-04-19
0,1,1,0,0,Davidson,2023-04-09
0,1,1,0,0,Davidson,2023-04-14
0,4,1,3,0,Davie,2022-11-27
0,3,1,2,0,Davie,2023-02-11
0,4,1,3,0,Davie,2023-03-03
0,2,1,1,0,Davie,2023-03-05
0,6,1,5,0,Davie,2023-03-09
0,2,1,1,0,Davie,2023-03-12
0,2,1,1,0,Davie,2023-03-15
0,1,1,0,0,Davie,2023-03-27
0,2,1,1,0,Davie,2023-04-03
0,3,1,2,0,Davie,2023-04-04
0,2,1,1,0,Davie,2023-04-09
0,1,1,0,0,Davie,2023-05-04
0,3,1,2,0,Duplin,2022-11-25
0,5,1,4,0,Duplin,2022-11-26
0,6,1,5,0,Duplin,2022-12-25
0,5,1,4,0,Duplin,2023-01-01
0,6,1,5,0,Duplin,2023-02-25
0,4,1,3,0,Duplin,2023-03-14
0,2,1,1,0,Duplin,2023-03-18
0,1,1,0,0,Duplin,2023-03-19
0,1,1,0,0,Duplin,2023-03-27
0,2,1,1,0,Duplin,2023-04-10
0,2,1,1,0,Duplin,2023-04-25
0,17,1,16,0,Durham,2022-11-19
0,3,1,2,0,Edgecombe,2022-11-09
0,2,1,1,0,Edgecombe,2022-11-23
0,6,1,5,0,Edgecombe,2022-11-26
0,5,1,4,0,Edgecombe,2022-12-07
0,9,1,8,0,Edgecombe,2022-12-24
0,3,1,2,0,Edgecombe,2023-02-12
0,1,1,0,0,Edgecombe,2023-03-12
0,3,1,2,0,Edgecombe,2023-03-19
0,1,1,0,0,Edgecombe,2023-04-19
0,8,1,7,0,Forsyth,2023-04-29
0,5,1,4,0,Franklin,2022-11-11
0,8,1,7,0,Franklin,2022-12-08
0,11,1,10,0,Franklin,2023-01-24
0,9,1,8,0,Franklin,2023-01-26
0,6,1,5,0,Franklin,2023-02-05
0,5,1,4,0,Franklin,2023-02-19
0,2,1,1,0,Franklin,2023-04-16
0,2,1,1,0,Franklin,2023-04-29
0,10,1,9,0,Gaston,2022-11-19
0,1,1,0,0,Gates,2022-11-26
0,2,1,1,0,Gates,2022-11-28
0,2,1,1,0,Gates,2022-12-05
0,1,1,0,0,Gates,2022-12-09
0,1,1,0,0,Gates,2022-12-15
0,1,1,0,0,Gates,2022-12-18
0,3,1,2,0,Gates,2022-12-19
0,1,1,0,0,Gates,2022-12-27
0,6,1,5,0,Gates,2022-12-28
0,2,1,1,0,Gates,2022-12-29
0,4,1,3,0,Gates,2023-01-05
0,1,1,0,0,Gates,2023-01-06
0,5,1,4,0,Gates,2023-01-12
0,1,1,0,0,Gates,2023-01-14
0,1,1,0,0,Gates,2023-02-06
0,2,1,1,0,Gates,2023-03-01
0,1,1,0,0,Gates,2023-03-06
0,1,1,0,0,Gates,2023-03-07
0,1,1,0,0,Gates,2023-03-10
0,2,1,1,0,Gates,2023-03-18
0,1,1,0,0,Graham,2022-11-13
0,1,1,0,0,Graham,2022-11-22
0,1,1,0,0,Graham,2022-12-02
0,1,1,0,0,Graham,2022-12-09
0,1,1,0,0,Graham,2022-12-11
0,1,1,0,0,Graham,2022-12-14
0,2,1,1,0,Graham,2022-12-20
0,1,1,0,0,Graham,2023-01-05
0,1,1,0,0,Graham,2023-01-12
0,1,1,0,0,Graham,2023-01-20
0,1,1,0,0,Graham,2023-01-25
0,6,1,5,0,Graham,2023-02-03
0,1,1,0,0,Graham,2023-02-10
0,1,1,0,0,Graham,2023-02-20
0,2,1,1,0,Graham,2023-02-21
0,1,1,0,0,Graham,2023-03-10
0,1,1,0,0,Graham,2023-03-11
0,1,1,0,0,Graham,2023-03-14
0,1,1,0,0,Graham,2023-03-21
0,1,1,0,0,Graham,2023-03-24
0,1,1,0,0,Graham,2023-04-22
0,1,1,0,0,Graham,2023-05-05
0,4,1,3,0,Granville,2022-11-11
0,10,1,9,0,Granville,2022-11-12
0,4,1,3,0,Granville,2022-11-19
0,8,1,7,0,Granville,2022-11-25
0,4,1,3,0,Granville,2022-11-26
0,5,1,4,0,Granville,2023-02-27
0,8,1,7,0,Granville,2023-03-02
0,1,1,0,0,Granville,2023-03-05
0,2,1,1,0,Granville,2023-03-16
0,2,1,1,0,Granville,2023-03-29
0,5,1,4,0,Granville,2023-04-06
0,2,1,1,0,Granville,2023-04-10
0,1,1,0,0,Granville,2023-04-19
0,1,1,0,0,Granville,2023-04-21
0,3,1,2,0,Greene,2022-11-08
0,2,1,1,0,Greene,2022-11-10
0,2,1,1,0,Greene,2022-11-14
0,3,1,2,0,Greene,2022-11-18
0,5,1,4,0,Greene,2022-12-06
0,4,1,3,0,Greene,2022-12-07
0,2,1,1,0,Greene,2022-12-09
0,1,1,0,0,Greene,2022-12-11
0,2,1,1,0,Greene,2022-12-14
0,2,1,1,0,Greene,2022-12-31
0,2,1,1,0,Greene,2023-01-16
0,1,1,0,0,Greene,2023-01-21
0,2,1,1,0,Greene,2023-01-22
0,1,1,0,0,Greene,2023-02-11
0,2,1,1,0,Greene,2023-02-22
0,1,1,0,0,Greene,2023-02-23
0,1,1,0,0,Greene,2023-03-06
0,1,1,0,0,Greene,2023-03-31
0,1,1,0,0,Greene,2023-04-23
0,5,1,4,0,Guilford,2023-04-09
0,8,1,7,0,Halifax,2022-11-10
0,4,1,3,0,Halifax,2022-11-15
0,4,1,3,0,Halifax,2023-01-22
0,2,1,1,0,Halifax,2023-02-26
0,9,1,8,0,Halifax,2023-03-01
0,4,1,3,0,Halifax,2023-03-02
0,1,1,0,0,Halifax,2023-03-17
0,4,1,3,0,Halifax,2023-03-23
0,2,1,1,0,Halifax,2023-04-04
0,1,1,0,0,Halifax,2023-04-05
0,2,1,1,0,Halifax,2023-04-20
0,1,1,0,0,Halifax,2023-04-23
0,2,1,1,0,Halifax,2023-04-25
0,1,1,0,0,Halifax,2023-04-27
0,1,1,0,0,Halifax,2023-05-05
0,8,1,7,0,Harnett,2022-11-18
0,6,1,5,0,Harnett,2023-03-13
0,4,1,3,0,Harnett,2023-03-19
0,7,1,6,0,Harnett,2023-03-26
0,4,1,3,0,Harnett,2023-04-09
0,2,1,1,0,Harnett,2023-04-11
0,1,1,0,0,Harnett,2023-04-13
0,2,1,1,0,Harnett,2023-04-23
0,2,1,1,0,Harnett,2023-04-29
0,6,1,5,0,Harnett,2023-05-03
0,2,1,1,0,Harnett,2023-05-04
0,3,1,2,0,Haywood,2022-11-26
0,1,1,0,0,Haywood,2022-12-01
0,3,1,2,0,Haywood,2022-12-10
0,3,1,2,0,Haywood,2022-12-24
0,3,1,2,0,Haywood,2023-03-08
0,3,1,2,0,Haywood,2023-04-01
0,4,1,3,0,Haywood,2023-04-10
0,3,1,2,0,Haywood,2023-04-15
0,1,1,0,0,Haywood,2023-04-29
0,3,1,2,0,Haywood,2023-04-30
0,4,1,3,0,Henderson,2022-11-20
0,6,1,5,0,Henderson,2023-02-24
0,2,1,1,0,Henderson,2023-02-25
0,5,1,4,0,Henderson,2023-03-12
0,2,1,1,0,Henderson,2023-04-08
0,3,1,2,0,Hertford,2022-11-09
0,1,1,0,0,Hertford,2022-11-16
0,6,1,5,0,Hertford,2022-12-07
0,3,1,2,0,Hertford,2022-12-10
0,3,1,2,0,Hertford,2022-12-16
0,6,1,5,0,Hertford,2022-12-23
0,4,1,3,0,Hertford,2022-12-25
0,1,1,0,0,Hertford,2022-12-30
0,2,1,1,0,Hertford,2022-12-31
0,2,1,1,0,Hertford,2023-01-15
0,3,1,2,0,Hertford,2023-02-11
0,2,1,1,0,Hertford,2023-02-13
0,2,1,1,0,Hertford,2023-02-15
0,1,1,0,0,Hertford,2023-02-18
0,1,1,0,0,Hertford,2023-02-20
0,2,1,1,0,Hertford,2023-02-28
0,1,1,0,0,Hertford,2023-03-09
0,1,1,0,0,Hertford,2023-03-21
0,1,1,0,0,Hertford,2023-03-23
0,1,1,0,0,Hertford,2023-04-04
0,2,1,1,0,Hertford,2023-04-05
0,1,1,0,0,Hertford,2023-04-14
0,1,1,0,0,Hertford,2023-04-24
0,1,1,0,0,Hertford,2023-04-28
0,3,1,2,0,Hoke,2022-11-15
0,1,1,0,0,Hoke,2022-11-20
0,4,1,3,0,Hoke,2022-11-22
0,5,1,4,0,Hoke,2022-12-02
0,8,1,7,0,Hoke,2023-01-16
0,6,1,5,0,Hoke,2023-02-11
0,6,1,5,0,Hoke,2023-03-13
0,7,1,6,0,Hoke,2023-03-15
0,2,1,1,0,Hoke,2023-03-25
0,1,1,0,0,Hoke,2023-03-29
0,3,1,2,0,Hoke,2023-04-06
0,1,1,0,0,Hoke,2023-04-07
0,1,1,0,0,Hoke,2023-04-08
0,2,1,1,0,Hoke,2023-04-13
0,1,1,0,0,Hyde,2022-12-06
0,2,1,1,0,Hyde,2022-12-20
0,1,1,0,0,Hyde,2023-01-10
0,2,1,1,0,Iredell,2023-02-25
0,5,1,4,0,Iredell,2023-04-12
0,4,1,3,0,Iredell,2023-04-26
0,1,1,0,0,Iredell,2023-04-30
0,2,1,1,0,Iredell,2023-05-04
0,5,1,4,0,Jackson,2022-11-08
0,1,1,0,0,Jackson,2022-11-10
0,3,1,2,0,Jackson,2022-11-13
0,1,1,0,0,Jackson,2022-11-15
0,3,1,2,0,Jackson,2022-11-25
0,4,1,3,0,Jackson,2022-12-05
0,3,1,2,0,Jackson,2022-12-07
0,1,1,0,0,Jackson,2022-12-15
0,6,1,5,0,Jackson,2022-12-17
0,4,1,3,0,Jackson,2022-12-23
0,4,1,3,0,Jackson,2023-01-19
0,6,1,5,0,Jackson,2023-01-23
0,7,1,6,0,Jackson,2023-01-27
0,2,1,1,0,Jackson,2023-02-04
0,1,1,0,0,Jackson,2023-03-03
0,4,1,3,0,Jackson,2023-03-04
0,3,1,2,0,Jackson,2023-03-10
0,5,1,4,0,Jackson,2023-03-22
0,4,1,3,0,Jackson,2023-03-24
0,2,1,1,0,Jackson,2023-03-27
0,2,1,1,0,Jackson,2023-04-03
0,6,1,5,0,Jackson,2023-04-05
0,5,1,4,0,Jackson,2023-04-07
0,4,1,3,0,Jackson,2023-04-11
0,4,1,3,0,Jackson,2023-04-19
0,3,1,2,0,Jackson,2023-05-01
0,2,1,1,0,Jackson,2023-05-05
0,11,1,10,0,Johnston,2022-11-20
0,4,1,3,0,Johnston,2023-04-07
0,2,1,1,0,Johnston,2023-05-05
0,1,1,0,0,Jones,2022-11-08
0,1,1,0,0,Jones,2022-11-11
0,1,1,0,0,Jones,2022-11-22
0,1,1,0,0,Jones,2022-12-01
0,3,1,2,0,Jones,2022-12-06
0,4,1,3,0,Jones,2022-12-21
0,2,1,1,0,Jones,2022-12-24
0,2,1,1,0,Jones,2023-01-19
0,2,1,1,0,Jones,2023-02-03
0,3,1,2,0,Jones,2023-02-15
0,1,1,0,0,Jones,2023-03-14
0,1,1,0,0,Jones,2023-03-22
0,1,1,0,0,Jones,2023-04-20
0,1,1,0,0,Lee,2022-11-13
0,3,1,2,0,Lee,2022-11-23
0,4,1,3,0,Lee,2022-11-26
0,3,1,2,0,Lee,2022-12-24
0,6,1,5,0,Lee,2023-01-20
0,2,1,1,0,Lee,2023-02-01
0,5,1,4,0,Lee,2023-02-03
0,7,1,6,0,Lee,2023-02-05
0,2,1,1,0,Lee,2023-03-03
0,3,1,2,0,Lee,2023-03-10
0,2,1,1,0,Lee,2023-03-20
0,3,1,2,0,Lee,2023-03-21
0,4,1,3,0,Lee,2023-03-27
0,2,1,1,0,Lee,2023-03-30
0,1,1,0,0,Lee,2023-04-05
0,3,1,2,0,Lee,2023-04-07
0,2,1,1,0,Lee,2023-04-08
0,1,1,0,0,Lee,2023-04-09
0,2,1,1,0,Lee,2023-04-10
0,2,1,1,0,Lee,2023-04-20
0,1,1,0,0,Lee,2023-05-05
0,3,1,2,0,Lenoir,2022-11-13
0,2,1,1,0,Lenoir,2022-11-22
0,2,1,1,0,Lenoir,2022-12-03
0,5,1,4,0,Lenoir,2022-12-11
0,2,1,1,0,Lenoir,2023-03-12
0,5,1,4,0,Lenoir,2023-03-15
0,1,1,0,0,Lenoir,2023-03-24
0,2,1,1,0,Lenoir,2023-04-07
0,2,1,1,0,Lenoir,2023-04-10
0,2,1,1,0,Lenoir,2023-04-12
0,3,1,2,0,Lenoir,2023-04-27
0,4,1,3,0,Lincoln,2023-03-11
0,3,1,2,0,Lincoln,2023-03-28
0,3,1,2,0,Lincoln,2023-04-01
0,2,1,1,0,Lincoln,2023-04-09
0,3,1,2,0,Lincoln,2023-04-10
0,2,1,1,0,Lincoln,2023-04-23
0,2,1,1,0,Lincoln,2023-04-24
0,5,1,4,0,Lincoln,2023-04-29
0,1,1,0,0,Lincoln,2023-05-01
0,4,1,3,0,Macon,2022-11-22
0,3,1,2,0,Macon,2022-11-23
0,8,1,7,0,Macon,2022-12-19
0,3,1,2,0,Macon,2022-12-31
0,4,1,3,0,Macon,2023-01-05
0,2,1,1,0,Macon,2023-01-12
0,3,1,2,0,Macon,2023-01-21
0,2,1,1,0,Macon,2023-01-27
0,2,1,1,0,Macon,2023-02-01
0,1,1,0,0,Macon,2023-02-28
0,3,1,2,0,Macon,2023-03-03
0,1,1,0,0,Macon,2023-03-17
0,1,1,0,0,Macon,2023-05-03
0,2,1,1,0,Macon,2023-05-06
0,1,1,0,0,Madison,2022-11-15
0,2,1,1,0,Madison,2022-11-17
0,3,1,2,0,Madison,2022-12-06
0,2,1,1,0,Madison,2022-12-09
0,1,1,0,0,Madison,2022-12-23
0,1,1,0,0,Madison,2023-01-01
0,2,1,1,0,Madison,2023-01-04
0,2,1,1,0,Madison,2023-01-06
0,1,1,0,0,Madison,2023-01-26
0,2,1,1,0,Madison,2023-02-05
0,1,1,0,0,Madison,2023-02-12
0,2,1,1,0,Madison,2023-02-27
0,2,1,1,0,Madison,2023-03-13
0,1,1,0,0,Madison,2023-03-22
0,1,1,0,0,Madison,2023-03-28
0,2,1,1,0,Madison,2023-03-29
0,1,1,0,0,Madison,2023-04-04
0,2,1,1,0,Madison,2023-04-11
0,1,1,0,0,Madison,2023-04-19
0,2,1,1,0,Madison,2023-04-24
0,1,1,0,0,Madison,2023-04-25
0,1,1,0,0,Martin,2023-03-28
0,1,1,0,0,Martin,2023-04-29
0,6,1,5,0,McDowell,2022-11-19
0,1,1,0,0,McDowell,2022-12-25
0,3,1,2,0,McDowell,2023-01-15
0,5,1,4,0,McDowell,2023-01-22
0,2,1,1,0,McDowell,2023-02-27
0,5,1,4,0,McDowell,2023-03-03
0,1,1,0,0,McDowell,2023-03-15
0,3,1,2,0,McDowell,2023-04-17
0,1,1,0,0,McDowell,2023-04-24
0,1,1,0,0,McDowell,2023-04-27
0,2,1,1,0,Mitchell,2022-11-09
0,1,1,0,0,Mitchell,2022-11-10
0,2,1,1,0,Mitchell,2022-11-11
0,1,1,0,0,Mitchell,2022-11-14
0,1,1,0,0,Mitchell,2022-11-28
0,2,1,1,0,Mitchell,2022-11-29
0,3,1,2,0,Mitchell,2022-12-02
0,1,1,0,0,Mitchell,2022-12-13
0,2,1,1,0,Mitchell,2022-12-14
0,2,1,1,0,Mitchell,2022-12-17
0,1,1,0,0,Mitchell,2022-12-30
0,3,1,2,0,Mitchell,2023-01-08
0,3,1,2,0,Mitchell,2023-01-12
0,1,1,0,0,Mitchell,2023-01-28
0,3,1,2,0,Mitchell,2023-02-09
0,1,1,0,0,Mitchell,2023-02-27
0,1,1,0,0,Mitchell,2023-03-02
0,1,1,0,0,Mitchell,2023-03-09
0,1,1,0,0,Mitchell,2023-03-20
0,1,1,0,0,Mitchell,2023-03-21
0,3,1,2,0,Mitchell,2023-04-06
0,1,1,0,0,Mitchell,2023-04-13
0,1,1,0,0,Mitchell,2023-04-18
0,2,1,1,0,Mitchell,2023-04-28
0,2,1,1,0,Mitchell,2023-05-03
0,2,1,1,0,Montgomery,2022-11-29
0,1,1,0,0,Montgomery,2022-11-30
0,5,1,4,0,Montgomery,2022-12-05
0,1,1,0,0,Montgomery,2022-12-09
0,3,1,2,0,Montgomery,2022-12-25
0,5,1,4,0,Montgomery,2023-01-13
0,4,1,3,0,Montgomery,2023-02-02
0,2,1,1,0,Montgomery,2023-02-05
0,6,1,5,0,Montgomery,2023-02-07
0,3,1,2,0,Montgomery,2023-02-08
0,1,1,0,0,Montgomery,2023-02-11
0,4,1,3,0,Montgomery,2023-02-23
0,3,1,2,0,Montgomery,2023-03-05
0,2,1,1,0,Montgomery,2023-03-07
0,1,1,0,0,Montgomery,2023-03-09
0,1,1,0,0,Montgomery,2023-03-13
0,1,1,0,0,Montgomery,2023-03-30
0,2,1,1,0,Montgomery,2023-04-01
0,1,1,0,0,Montgomery,2023-04-17
0,1,1,0,0,Montgomery,2023-04-23
0,2,1,1,0,Montgomery,2023-04-24
0,1,1,0,0,Montgomery,2023-04-25
0,9,1,8,0,Moore,2022-11-22
0,11,1,10,0,Moore,2022-12-06
0,12,1,11,0,Moore,2023-02-12
0,4,1,3,0,Moore,2023-02-26
0,3,1,2,0,Moore,2023-03-08
0,3,1,2,0,Moore,2023-03-09
0,6,1,5,0,Moore,2023-03-23
0,3,1,2,0,Moore,2023-04-12
0,2,1,1,0,Moore,2023-04-19
0,2,1,1,0,Moore,2023-04-23
0,2,1,1,0,Moore,2023-04-30
0,1,1,0,0,Moore,2023-05-01
0,6,1,5,0,Moore,2023-05-05
0,3,1,2,0,Nash,2022-11-10
0,4,1,3,0,Nash,2022-11-14
0,3,1,2,0,Nash,2022-11-23
0,7,1,6,0,Nash,2023-01-28
0,3,1,2,0,Nash,2023-02-26
0,2,1,1,0,Nash,2023-03-04
0,1,1,0,0,Nash,2023-03-22
0,3,1,2,0,Nash,2023-03-24
0,3,1,2,0,Nash,2023-04-12
0,1,1,0,0,Nash,2023-04-15
0,2,1,1,0,Nash,2023-04-24
0,8,1,7,0,New Hanover,2023-03-03
0,8,1,7,0,New Hanover,2023-03-11
0,1,1,0,0,New Hanover,2023-04-02
0,3,1,2,0,New Hanover,2023-04-09
0,1,1,0,0,Northampton,2022-11-08
0,2,1,1,0,Northampton,2022-11-16
0,2,1,1,0,Northampton,2022-11-18
0,2,1,1,0,Northampton,2022-11-27
0,4,1,3,0,Northampton,2022-12-12
0,1,1,0,0,Northampton,2022-12-14
0,1,1,0,0,Northampton,2023-01-22
0,2,1,1,0,Northampton,2023-01-31
0,2,1,1,0,Northampton,2023-02-11
0,1,1,0,0,Northampton,2023-02-12
0,5,1,4,0,Northampton,2023-02-27
0,3,1,2,0,Northampton,2023-03-07
0,2,1,1,0,Northampton,2023-03-17
0,2,1,1,0,Northampton,2023-03-21
0,1,1,0,0,Northampton,2023-04-21
0,2,1,1,0,Northampton,2023-04-22
0,1,1,0,0,Northampton,2023-05-05
0,2,1,1,0,Onslow,2022-11-20
0,6,1,5,0,Onslow,2023-03-08
0,4,1,3,0,Onslow,2023-03-11
0,3,1,2,0,Onslow,2023-04-15
0,6,1,5,0,Onslow,2023-05-03
0,10,1,9,0,Orange,2022-11-15
0,15,1,14,0,Orange,2022-11-26
0,4,1,3,0,Orange,2023-03-20
0,11,1,10,0,Orange,2023-05-01
0,3,1,2,0,Pamlico,2022-11-14
0,1,1,0,0,Pamlico,2022-11-30
0,2,1,1,0,Pamlico,2022-12-05
0,4,1,3,0,Pamlico,2022-12-20
0,1,1,0,0,Pamlico,2022-12-23
0,2,1,1,0,Pamlico,2023-01-12
0,1,1,0,0,Pamlico,2023-01-14
0,2,1,1,0,Pamlico,2023-01-26
0,6,1,5,0,Pamlico,2023-01-27
0,2,1,1,0,Pamlico,2023-01-29
0,3,1,2,0,Pamlico,2023-01-31
0,1,1,0,0,Pamlico,2023-02-11
0,1,1,0,0,Pamlico,2023-02-14
0,1,1,0,0,Pamlico,2023-02-16
0,1,1,0,0,Pamlico,2023-02-23
0,1,1,0,0,Pamlico,2023-03-16
0,1,1,0,0,Pamlico,2023-03-29
0,1,1,0,0,Pamlico,2023-04-11
0,1,1,0,0,Pamlico,2023-04-12
0,1,1,0,0,Pamlico,2023-04-13
0,1,1,0,0,Pamlico,2023-04-25
0,1,1,0,0,Pasquotank,2022-11-16
0,2,1,1,0,Pasquotank,2022-11-17
0,4,1,3,0,Pasquotank,2022-11-21
0,3,1,2,0,Pasquotank,2022-11-22
0,3,1,2,0,Pasquotank,2022-11-25
0,2,1,1,0,Pasquotank,2022-12-04
0,1,1,0,0,Pasquotank,2022-12-07
0,3,1,2,0,Pasquotank,2022-12-11
0,3,1,2,0,Pasquotank,2023-01-15
0,2,1,1,0,Pasquotank,2023-01-31
0,3,1,2,0,Pasquotank,2023-02-04
0,7,1,6,0,Pasquotank,2023-02-14
0,1,1,0,0,Pasquotank,2023-02-15
0,3,1,2,0,Pasquotank,2023-02-25
0,1,1,0,0,Pasquotank,2023-03-02
0,3,1,2,0,Pasquotank,2023-03-04
0,1,1,0,0,Pasquotank,2023-03-18
0,1,1,0,0,Pasquotank,2023-03-26
0,1,1,0,0,Pasquotank,2023-03-31
0,2,1,1,0,Pasquotank,2023-04-01
0,1,1,0,0,Pasquotank,2023-04-09
0,1,1,0,0,Pasquotank,2023-04-11
0,1,1,0,0,Pasquotank,2023-04-14
0,2,1,1,0,Pasquotank,2023-04-15
0,1,1,0,0,Pasquotank,2023-04-17
0,1,1,0,0,Pasquotank,2023-04-18
0,1,1,0,0,Pasquotank,2023-04-21
0,1,1,0,0,Pasquotank,2023-04-22
0,1,1,0,0,Pasquotank,2023-04-27
0,1,1,0,0,Pasquotank,2023-04-28
0,3,1,2,0,Pasquotank,2023-04-29
0,3,1,2,0,Pender,2022-11-08
0,6,1,5,0,Pender,2022-11-16
0,3,1,2,0,Pender,2022-11-20
0,1,1,0,0,Pender,2022-12-07
0,6,1,5,0,Pender,2022-12-17
0,10,1,9,0,Pender,2022-12-18
0,6,1,5,0,Pender,2023-01-18
0,7,1,6,0,Pender,2023-01-19
0,5,1,4,0,Pender,2023-02-11
0,1,1,0,0,Pender,2023-02-18
0,2,1,1,0,Pender,2023-03-10
0,1,1,0,0,Pender,2023-03-27
0,3,1,2,0,Pender,2023-03-29
0,1,1,0,0,Pender,2023-03-31
0,3,1,2,0,Pender,2023-04-04
0,1,1,0,0,Pender,2023-04-07
0,2,1,1,0,Pender,2023-04-21
0,1,1,0,0,Perquimans,2022-11-08
0,1,1,0,0,Perquimans,2022-11-13
0,2,1,1,0,Perquimans,2022-11-16
0,1,1,0,0,Perquimans,2022-12-08
0,2,1,1,0,Perquimans,2022-12-16
0,2,1,1,0,Perquimans,2022-12-17
0,1,1,0,0,Perquimans,2023-01-01
0,1,1,0,0,Perquimans,2023-01-11
0,1,1,0,0,Perquimans,2023-01-15
0,2,1,1,0,Perquimans,2023-01-23
0,1,1,0,0,Perquimans,2023-01-28
0,3,1,2,0,Perquimans,2023-02-07
0,1,1,0,0,Perquimans,2023-02-26
0,2,1,1,0,Perquimans,2023-02-28
0,1,1,0,0,Perquimans,2023-03-07
0,2,1,1,0,Perquimans,2023-03-16
0,1,1,0,0,Perquimans,2023-03-19
0,3,1,2,0,Perquimans,2023-03-31
0,1,1,0,0,Perquimans,2023-04-06
0,1,1,0,0,Perquimans,2023-04-07
0,1,1,0,0,Perquimans,2023-04-10
0,4,1,3,0,Person,2022-11-13
0,3,1,2,0,Person,2022-11-18
0,9,1,8,0,Person,2022-11-28
0,2,1,1,0,Person,2022-12-01
0,6,1,5,0,Person,2022-12-02
0,3,1,2,0,Person,2022-12-03
0,8,1,7,0,Person,2022-12-14
0,5,1,4,0,Person,2022-12-31
0,2,1,1,0,Person,2023-01-08
0,3,1,2,0,Person,2023-01-12
0,4,1,3,0,Person,2023-01-13
0,4,1,3,0,Person,2023-01-16
0,4,1,3,0,Person,2023-01-25
0,3,1,2,0,Person,2023-02-07
0,2,1,1,0,Person,2023-03-03
0,1,1,0,0,Person,2023-03-04
0,4,1,3,0,Person,2023-03-05
0,2,1,1,0,Person,2023-03-13
0,3,1,2,0,Person,2023-03-19
0,1,1,0,0,Person,2023-04-14
0,1,1,0,0,Person,2023-04-15
0,2,1,1,0,Person,2023-04-21
0,4,1,3,0,Pitt,2023-04-04
0,5,1,4,0,Pitt,2023-04-08
0,1,1,0,0,Polk,2022-11-08
0,1,1,0,0,Polk,2022-11-09
0,2,1,1,0,Polk,2022-11-11
0,2,1,1,0,Polk,2022-11-20
0,1,1,0,0,Polk,2022-11-25
0,1,1,0,0,Polk,2022-11-26
0,1,1,0,0,Polk,2022-11-27
0,1,1,0,0,Polk,2022-12-02
0,1,1,0,0,Polk,2022-12-03
0,4,1,3,0,Polk,2022-12-11
0,1,1,0,0,Polk,2022-12-13
0,2,1,1,0,Polk,2022-12-17
0,2,1,1,0,Polk,2022-12-21
0,5,1,4,0,Polk,2022-12-30
0,1,1,0,0,Polk,2023-01-11
0,3,1,2,0,Polk,2023-01-15
0,3,1,2,0,Polk,2023-01-17
0,2,1,1,0,Polk,2023-01-21
0,1,1,0,0,Polk,2023-02-04
0,3,1,2,0,Polk,2023-02-10
0,2,1,1,0,Polk,2023-02-11
0,1,1,0,0,Polk,2023-02-14
0,2,1,1,0,Polk,2023-02-24
0,1,1,0,0,Polk,2023-03-11
0,1,1,0,0,Polk,2023-03-18
0,1,1,0,0,Polk,2023-04-04
0,1,1,0,0,Polk,2023-04-07
0,1,1,0,0,Polk,2023-04-14
0,1,1,0,0,Polk,2023-04-26
0,1,1,0,0,Randolph,2023-03-26
0,2,1,1,0,Randolph,2023-04-08
0,1,1,0,0,Randolph,2023-04-11
0,3,1,2,0,Randolph,2023-05-02
0,2,1,1,0,Randolph,2023-05-05
0,1,1,0,0,Richmond,2022-11-09
0,3,1,2,0,Richmond,2022-11-22
0,3,1,2,0,Richmond,2022-11-23
0,1,1,0,0,Richmond,2022-11-27
0,3,1,2,0,Richmond,2023-03-12
0,2,1,1,0,Richmond,2023-03-19
0,1,1,0,0,Richmond,2023-04-02
0,2,1,1,0,Richmond,2023-04-04
0,2,1,1,0,Richmond,2023-04-10
0,1,1,0,0,Richmond,2023-04-15
0,2,1,1,0,Richmond,2023-04-22
0,1,1,0,0,Richmond,2023-04-28
0,5,1,4,0,Robeson,2022-11-12
0,3,1,2,0,Robeson,2023-03-05
0,8,1,7,0,Rockingham,2022-11-18
0,1,1,0,0,Rockingham,2022-11-24
0,2,1,1,0,Rockingham,2023-02-05
0,7,1,6,0,Rockingham,2023-02-12
0,5,1,4,0,Rockingham,2023-02-18
0,5,1,4,0,Rockingham,2023-03-07
0,3,1,2,0,Rockingham,2023-03-08
0,1,1,0,0,Rockingham,2023-03-20
0,3,1,2,0,Rockingham,2023-03-23
0,3,1,2,0,Rockingham,2023-04-13
0,5,1,4,0,Rockingham,2023-05-02
0,4,1,3,0,Rowan,2022-11-13
0,1,1,0,0,Rowan,2023-04-04
0,1,1,0,0,Rowan,2023-04-27
0,3,1,2,0,Rowan,2023-04-28
0,4,1,3,0,Rutherford,2022-11-16
0,6,1,5,0,Rutherford,2022-11-20
0,3,1,2,0,Rutherford,2023-01-29
0,3,1,2,0,Rutherford,2023-03-01
0,2,1,1,0,Rutherford,2023-03-13
0,1,1,0,0,Rutherford,2023-03-24
0,2,1,1,0,Rutherford,2023-04-05
0,2,1,1,0,Rutherford,2023-04-07
0,6,1,5,0,Rutherford,2023-04-12
0,3,1,2,0,Rutherford,2023-04-15
0,1,1,0,0,Rutherford,2023-04-28
0,2,1,1,0,Rutherford,2023-05-02
0,2,1,1,0,Sampson,2022-11-10
0,3,1,2,0,Sampson,2022-11-23
0,3,1,2,0,Sampson,2022-12-25
0,1,1,0,0,Sampson,2023-02-25
0,2,1,1,0,Sampson,2023-03-12
0,1,1,0,0,Sampson,2023-04-01
0,1,1,0,0,Sampson,2023-04-02
0,3,1,2,0,Sampson,2023-04-06
0,1,1,0,0,Sampson,2023-04-13
0,1,1,0,0,Sampson,2023-04-15
0,3,1,2,0,Sampson,2023-04-18
0,1,1,0,0,Sampson,2023-04-26
0,1,1,0,0,Sampson,2023-04-28
0,1,1,0,0,Sampson,2023-04-29
0,2,1,1,0,Sampson,2023-05-01
0,1,1,0,0,Scotland,2022-11-13
0,1,1,0,0,Scotland,2022-11-15
0,2,1,1,0,Scotland,2022-11-27
0,2,1,1,0,Scotland,2022-12-05
0,3,1,2,0,Scotland,2022-12-07
0,6,1,5,0,Scotland,2023-01-22
0,1,1,0,0,Scotland,2023-02-11
0,1,1,0,0,Scotland,2023-02-25
0,1,1,0,0,Scotland,2023-03-18
0,3,1,2,0,Scotland,2023-03-23
0,2,1,1,0,Scotland,2023-03-30
0,2,1,1,0,Scotland,2023-04-04
0,2,1,1,0,Scotland,2023-04-05
0,1,1,0,0,Scotland,2023-04-11
0,2,1,1,0,Scotland,2023-04-20
0,6,1,5,0,Stanly,2022-11-08
0,5,1,4,0,Stanly,2022-11-09
0,3,1,2,0,Stanly,2023-03-03
0,3,1,2,0,Stanly,2023-03-15
0,4,1,3,0,Stokes,2022-11-24
0,2,1,1,0,Stokes,2023-01-22
0,1,1,0,0,Stokes,2023-02-05
0,3,1,2,0,Stokes,2023-03-08
0,1,1,0,0,Stokes,2023-03-19
0,3,1,2,0,Stokes,2023-04-07
0,3,1,2,0,Stokes,2023-04-20
0,4,1,3,0,Stokes,2023-04-21
0,2,1,1,0,Stokes,2023-05-05
0,3,1,2,0,Stokes,2023-05-06
0,3,1,2,0,Surry,2023-02-25
0,5,1,4,0,Surry,2023-03-08
0,3,1,2,0,Surry,2023-03-18
0,3,1,2,0,Surry,2023-03-23
0,2,1,1,0,Surry,2023-04-22
0,2,1,1,0,Surry,2023-05-06
0,1,1,0,0,Swain,2022-11-14
0,1,1,0,0,Swain,2022-11-16
0,1,1,0,0,Swain,2022-11-28
0,2,1,1,0,Swain,2022-12-01
0,1,1,0,0,Swain,2022-12-03
0,2,1,1,0,Swain,2022-12-16
0,1,1,0,0,Swain,2022-12-21
0,3,1,2,0,Swain,2022-12-22
0,1,1,0,0,Swain,2022-12-23
0,4,1,3,0,Swain,2023-01-05
0,2,1,1,0,Swain,2023-01-28
0,2,1,1,0,Swain,2023-01-31
0,3,1,2,0,Swain,2023-02-02
0,3,1,2,0,Swain,2023-02-16
0,1,1,0,0,Swain,2023-02-17
0,1,1,0,0,Swain,2023-02-21
0,2,1,1,0,Swain,2023-02-22
0,2,1,1,0,Swain,2023-03-01
0,2,1,1,0,Swain,2023-03-02
0,2,1,1,0,Swain,2023-03-03
0,1,1,0,0,Swain,2023-03-04
0,2,1,1,0,Swain,2023-03-14
0,2,1,1,0,Swain,2023-03-28
0,1,1,0,0,Swain,2023-03-31
0,1,1,0,0,Swain,2023-04-18
0,1,1,0,0,Swain,2023-04-28
0,1,1,0,0,Swain,2023-05-02
0,1,1,0,0,Transylvania,2022-11-10
0,4,1,3,0,Transylvania,2022-11-12
0,1,1,0,0,Transylvania,2022-11-13
0,3,1,2,0,Transylvania,2022-11-14
0,1,1,0,0,Transylvania,2022-11-16
0,4,1,3,0,Transylvania,2022-11-20
0,1,1,0,0,Transylvania,2022-11-26
0,3,1,2,0,Transylvania,2022-11-30
0,3,1,2,0,Transylvania,2022-12-01
0,6,1,5,0,Transylvania,2022-12-12
0,8,1,7,0,Transylvania,2023-01-02
0,6,1,5,0,Transylvania,2023-01-18
0,8,1,7,0,Transylvania,2023-01-20
0,2,1,1,0,Transylvania,2023-02-07
0,2,1,1,0,Transylvania,2023-02-20
0,2,1,1,0,Transylvania,2023-02-23
0,2,1,1,0,Transylvania,2023-02-26
0,2,1,1,0,Transylvania,2023-02-28
0,1,1,0,0,Transylvania,2023-03-10
0,3,1,2,0,Transylvania,2023-03-15
0,3,1,2,0,Transylvania,2023-03-21
0,1,1,0,0,Transylvania,2023-03-23
0,4,1,3,0,Transylvania,2023-03-24
0,1,1,0,0,Transylvania,2023-04-10
0,3,1,2,0,Transylvania,2023-04-14
0,1,1,0,0,Transylvania,2023-04-15
0,2,1,1,0,Transylvania,2023-04-18
0,3,1,2,0,Transylvania,2023-04-25
0,1,1,0,0,Transylvania,2023-05-05
0,2,1,1,0,Tyrrell,2022-12-15
0,1,1,0,0,Tyrrell,2022-12-27
0,1,1,0,0,Tyrrell,2022-12-30
0,1,1,0,0,Tyrrell,2023-01-03
0,1,1,0,0,Tyrrell,2023-01-06
0,1,1,0,0,Tyrrell,2023-01-17
0,1,1,0,0,Tyrrell,2023-02-02
0,1,1,0,0,Tyrrell,2023-03-02
0,9,1,8,0,Union,2022-11-12
0,11,1,10,0,Union,2023-03-03
0,6,1,5,0,Union,2023-03-04
0,4,1,3,0,Union,2023-04-02
0,7,1,6,0,Union,2023-04-28
0,2,1,1,0,Vance,2022-11-18
0,4,1,3,0,Vance,2022-11-21
0,2,1,1,0,Vance,2022-11-26
0,4,1,3,0,Vance,2022-12-01
0,6,1,5,0,Vance,2022-12-03
0,2,1,1,0,Vance,2023-02-18
0,3,1,2,0,Vance,2023-02-19
0,1,1,0,0,Vance,2023-02-26
0,4,1,3,0,Vance,2023-03-07
0,1,1,0,0,Vance,2023-03-12
0,3,1,2,0,Vance,2023-03-19
0,10,1,9,0,Vance,2023-03-20
0,3,1,2,0,Vance,2023-03-28
0,2,1,1,0,Vance,2023-03-29
0,2,1,1,0,Vance,2023-04-17
0,2,1,1,0,Vance,2023-04-23
0,2,1,1,0,Vance,2023-05-03
0,1,1,0,0,Vance,2023-05-05
0,1,1,0,0,Vance,2023-05-06
0,1,1,0,0,Warren,2022-11-15
0,1,1,0,0,Warren,2022-11-16
0,1,1,0,0,Warren,2022-11-18
0,3,1,2,0,Warren,2022-12-02
0,1,1,0,0,Warren,2022-12-05
0,1,1,0,0,Warren,2022-12-10
0,7,1,6,0,Warren,2022-12-18
0,1,1,0,0,Warren,2022-12-23
0,4,1,3,0,Warren,2022-12-30
0,6,1,5,0,Warren,2023-01-02
0,4,1,3,0,Warren,2023-01-12
0,3,1,2,0,Warren,2023-01-19
0,1,1,0,0,Warren,2023-02-12
0,7,1,6,0,Warren,2023-02-16
0,2,1,1,0,Warren,2023-02-23
0,1,1,0,0,Warren,2023-03-24
0,1,1,0,0,Warren,2023-04-05
0,1,1,0,0,Warren,2023-04-06
0,1,1,0,0,Warren,2023-04-12
0,1,1,0,0,Warren,2023-04-18
0,2,1,1,0,Washington,2022-12-15
0,2,1,1,0,Washington,2023-01-23
0,4,1,3,0,Washington,2023-01-25
0,6,1,5,0,Washington,2023-01-26
0,2,1,1,0,Washington,2023-02-10
0,2,1,1,0,Washington,2023-03-01
0,2,1,1,0,Washington,2023-03-15
0,1,1,0,0,Washington,2023-03-30
0,1,1,0,0,Washington,2023-04-25
0,6,1,5,0,Watauga,2022-11-09
0,6,1,5,0,Watauga,2022-11-11
0,3,1,2,0,Watauga,2022-11-12
0,4,1,3,0,Watauga,2022-11-13
0,4,1,3,0,Watauga,2022-12-02
0,8,1,7,0,Watauga,2022-12-25
0,9,1,8,0,Watauga,2022-12-27
0,4,1,3,0,Watauga,2023-01-10
0,7,1,6,0,Watauga,2023-01-18
0,2,1,1,0,Watauga,2023-01-21
0,9,1,8,0,Watauga,2023-02-06
0,1,1,0,0,Watauga,2023-02-11
0,5,1,4,0,Watauga,2023-02-15
0,1,1,0,0,Watauga,2023-02-18
0,3,1,2,0,Watauga,2023-02-19
0,1,1,0,0,Watauga,2023-03-03
0,3,1,2,0,Watauga,2023-03-06
0,2,1,1,0,Watauga,2023-03-14
0,1,1,0,0,Watauga,2023-03-16
0,4,1,3,0,Watauga,2023-03-20
0,1,1,0,0,Watauga,2023-03-22
0,1,1,0,0,Watauga,2023-03-26
0,1,1,0,0,Watauga,2023-03-27
0,4,1,3,0,Watauga,2023-03-28
0,3,1,2,0,Watauga,2023-03-29
0,2,1,1,0,Watauga,2023-04-10
0,1,1,0,0,Watauga,2023-04-16
0,1,1,0,0,Watauga,2023-04-17
0,2,1,1,0,Watauga,2023-04-24
0,5,1,4,0,Watauga,2023-04-26
0,2,1,1,0,Watauga,2023-04-28
0,1,1,0,0,Watauga,2023-05-01
0,2,1,1,0,Watauga,2023-05-03
0,1,1,0,0,Watauga,2023-05-06
0,5,1,4,0,Wayne,2023-03-19
0,3,1,2,0,Wayne,2023-04-18
0,2,1,1,0,Wayne,2023-04-24
0,1,1,0,0,Wayne,2023-05-02
0,4,1,3,0,Wilkes,2022-11-10
0,1,1,0,0,Wilkes,2022-11-17
0,2,1,1,0,Wilkes,2022-11-22
0,2,1,1,0,Wilkes,2023-03-06
0,1,1,0,0,Wilkes,2023-03-08
0,2,1,1,0,Wilkes,2023-03-17
0,2,1,1,0,Wilkes,2023-03-24
0,1,1,0,0,Wilkes,2023-03-29
0,5,1,4,0,Wilkes,2023-04-14
0,5,1,4,0,Wilkes,2023-04-15
0,1,1,0,0,Wilkes,2023-04-18
0,2,1,1,0,Wilkes,2023-04-27
0,3,1,2,0,Wilson,2022-11-20
0,3,1,2,0,Wilson,2022-11-23
0,2,1,1,0,Wilson,2022-12-25
0,2,1,1,0,Wilson,2023-04-03
0,3,1,2,0,Wilson,2023-04-06
0,2,1,1,0,Wilson,2023-04-13
0,1,1,0,0,Wilson,2023-04-20
0,1,1,0,0,Wilson,2023-04-24
0,1,1,0,0,Wilson,2023-05-03
0,6,1,5,0,Yadkin,2022-11-10
0,3,1,2,0,Yadkin,2022-11-14
0,2,1,1,0,Yadkin,2022-12-04
0,6,1,5,0,Yadkin,2022-12-07
0,3,1,2,0,Yadkin,2023-03-02
0,1,1,0,0,Yadkin,2023-03-16
0,1,1,0,0,Yadkin,2023-03-18
0,3,1,2,0,Yadkin,2023-04-04
0,2,1,1,0,Yadkin,2023-04-24
0,2,1,1,0,Yancey,2022-11-22
0,2,1,1,0,Yancey,2022-11-26
0,4,1,3,0,Yancey,2022-11-29
0,2,1,1,0,Yancey,2022-12-01
0,1,1,0,0,Yancey,2022-12-10
0,2,1,1,0,Yancey,2022-12-12
0,2,1,1,0,Yancey,2022-12-16
0,3,1,2,0,Yancey,2022-12-20
0,1,1,0,0,Yancey,2022-12-23
0,2,1,1,0,Yancey,2022-12-31
0,2,1,1,0,Yancey,2023-01-24
0,3,1,2,0,Yancey,2023-02-01
0,1,1,0,0,Yancey,2023-02-02
0,4,1,3,0,Yancey,2023-02-06
0,1,1,0,0,Yancey,2023-02-24
0,1,1,0,0,Yancey,2023-03-05
0,1,1,0,0,Yancey,2023-03-27
0,2,1,1,0,Yancey,2023-03-28
0,1,1,0,0,Yancey,2023-04-05
0,2,2,0,0,Alamance,2023-04-16
0,7,2,5,0,Alamance,2023-04-24
0,5,2,3,0,Alamance,2023-04-28
0,6,2,4,0,Alexander,2022-11-22
0,2,2,0,0,Alexander,2023-01-07
0,3,2,1,0,Alexander,2023-01-20
0,2,2,0,0,Alexander,2023-03-13
0,2,2,0,0,Alexander,2023-04-17
0,2,2,0,0,Alleghany,2022-11-09
0,2,2,0,0,Alleghany,2023-01-01
0,2,2,0,0,Alleghany,2023-01-10
0,2,2,0,0,Alleghany,2023-01-23
0,2,2,0,0,Alleghany,2023-02-01
0,2,2,0,0,Alleghany,2023-02-14
0,3,2,1,0,Alleghany,2023-02-15
0,2,2,0,0,Alleghany,2023-03-29
0,7,2,5,0,Anson,2022-12-14
0,7,2,5,0,Anson,2022-12-27
0,2,2,0,0,Anson,2023-03-09
0,2,2,0,0,Ashe,2022-11-09
0,4,2,2,0,Ashe,2022-12-09
0,8,2,6,0,Ashe,2022-12-27
0,5,2,3,0,Ashe,2022-12-29
0,4,2,2,0,Ashe,2022-12-30
0,4,2,2,0,Ashe,2023-01-16
0,2,2,0,0,Ashe,2023-01-28
0,3,2,1,0,Ashe,2023-02-07
0,2,2,0,0,Ashe,2023-03-15
0,2,2,0,0,Ashe,2023-04-24
0,3,2,1,0,Avery,2022-11-12
0,2,2,0,0,Avery,2023-01-19
0,4,2,2,0,Avery,2023-02-22
0,6,2,4,0,Beaufort,2022-12-07
0,4,2,2,0,Beaufort,2022-12-24
0,11,2,9,0,Beaufort,2022-12-29
0,5,2,3,0,Beaufort,2023-01-15
0,2,2,0,0,Beaufort,2023-03-10
0,3,2,1,0,Beaufort,2023-03-29
0,2,2,0,0,Beaufort,2023-04-07
0,2,2,0,0,Bladen,2023-03-16
0,6,2,4,0,Brunswick,2023-04-06
0,5,2,3,0,Brunswick,2023-04-14
0,6,2,4,0,Buncombe,2023-03-26
0,9,2,7,0,Buncombe,2023-03-28
0,5,2,3,0,Burke,2023-03-24
0,3,2,1,0,Cabarrus,2023-04-07
0,7,2,5,0,Caldwell,2022-12-10
0,5,2,3,0,Caldwell,2023-03-02
0,4,2,2,0,Caldwell,2023-03-30
0,4,2,2,0,Caldwell,2023-05-02
0,2,2,0,0,Camden,2022-12-05
0,2,2,0,0,Camden,2022-12-06
0,2,2,0,0,Camden,2023-01-13
0,3,2,1,0,Camden,2023-04-04
0,3,2,1,0,Carteret,2022-11-17
0,2,2,0,0,Carteret,2023-03-03
0,2,2,0,0,Carteret,2023-03-13
0,3,2,1,0,Carteret,2023-03-17
0,6,2,4,0,Carteret,2023-03-23
0,3,2,1,0,Carteret,2023-04-18
0,2,2,0,0,Carteret,2023-04-21
0,3,2,1,0,Caswell,2022-12-26
0,4,2,2,0,Caswell,2023-01-20
0,4,2,2,0,Caswell,2023-03-10
0,11,2,9,0,Catawba,2023-02-19
0,4,2,2,0,Catawba,2023-04-07
0,2,2,0,0,Catawba,2023-04-22
0,2,2,0,0,Chatham,2022-11-19
0,9,2,7,0,Chatham,2023-02-28
0,4,2,2,0,Chatham,2023-03-12
0,4,2,2,0,Chatham,2023-03-13
0,5,2,3,0,Chatham,2023-03-18
0,3,2,1,0,Chatham,2023-03-23
0,4,2,2,0,Cherokee,2022-11-20
0,11,2,9,0,Cherokee,2022-12-29
0,3,2,1,0,Cherokee,2023-01-24
0,3,2,1,0,Cherokee,2023-01-26
0,6,2,4,0,Cherokee,2023-01-27
0,3,2,1,0,Cherokee,2023-01-29
0,4,2,2,0,Cherokee,2023-02-18
0,8,2,6,0,Chowan,2023-01-27
0,5,2,3,0,Chowan,2023-02-06
0,2,2,0,0,Clay,2022-12-13
0,6,2,4,0,Clay,2023-01-08
0,6,2,4,0,Clay,2023-01-10
0,3,2,1,0,Clay,2023-01-24
0,7,2,5,0,Cleveland,2022-11-18
0,3,2,1,0,Columbus,2023-04-25
0,4,2,2,0,Craven,2023-01-28
0,6,2,4,0,Craven,2023-03-20
0,4,2,2,0,Craven,2023-03-27
0,5,2,3,0,Craven,2023-04-05
0,3,2,1,0,Craven,2023-04-24
0,3,2,1,0,Craven,2023-05-03
0,3,2,1,0,Cumberland,2023-04-08
0,5,2,3,0,Currituck,2022-12-05
0,3,2,1,0,Currituck,2023-02-17
0,2,2,0,0,Currituck,2023-02-26
0,2,2,0,0,Currituck,2023-03-11
0,3,2,1,0,Davidson,2022-11-19
0,8,2,6,0,Davidson,2022-11-20
0,14,2,12,0,Davidson,2022-11-24
0,4,2,2,0,Davidson,2023-04-16
0,6,2,4,0,Davidson,2023-05-03
0,7,2,5,0,Davie,2023-02-09
0,2,2,0,0,Davie,2023-02-10
0,2,2,0,0,Davie,2023-03-08
0,2,2,0,0,Duplin,2023-04-26
0,5,2,3,0,Franklin,2023-01-29
0,9,2,7,0,Franklin,2023-03-29
0,3,2,1,0,Franklin,2023-04-17
0,2,2,0,0,Franklin,2023-05-04
0,5,2,3,0,Gaston,2023-04-08
0,3,2,1,0,Gaston,2023-04-09
0,3,2,1,0,Gates,2023-01-03
0,2,2,0,0,Graham,2022-11-15
0,2,2,0,0,Graham,2022-11-23
0,2,2,0,0,Graham,2022-11-28
0,3,2,1,0,Graham,2022-12-06
0,2,2,0,0,Graham,2022-12-19
0,3,2,1,0,Graham,2023-01-10
0,2,2,0,0,Graham,2023-02-08
0,4,2,2,0,Granville,2023-02-05
0,5,2,3,0,Granville,2023-03-25
0,3,2,1,0,Granville,2023-03-26
0,2,2,0,0,Granville,2023-05-01
0,4,2,2,0,Greene,2022-12-15
0,7,2,5,0,Greene,2023-02-01
0,8,2,6,0,Halifax,2023-02-28
0,7,2,5,0,Harnett,2023-02-05
0,2,2,0,0,Harnett,2023-04-16
0,4,2,2,0,Harnett,2023-04-20
0,6,2,4,0,Haywood,2022-12-17
0,3,2,1,0,Haywood,2023-02-24
0,2,2,0,0,Haywood,2023-03-11
0,5,2,3,0,Haywood,2023-03-20
0,2,2,0,0,Haywood,2023-03-28
0,4,2,2,0,Haywood,2023-04-05
0,6,2,4,0,Henderson,2022-11-12
0,4,2,2,0,Henderson,2023-04-04
0,6,2,4,0,Henderson,2023-04-22
0,4,2,2,0,Henderson,2023-04-26
0,5,2,3,0,Henderson,2023-04-29
0,2,2,0,0,Hertford,2022-11-10
0,4,2,2,0,Hertford,2022-12-06
0,4,2,2,0,Hertford,2022-12-14
0,2,2,0,0,Hertford,2022-12-15
0,5,2,3,0,Hertford,2022-12-21
0,4,2,2,0,Hertford,2023-01-12
0,3,2,1,0,Hertford,2023-02-03
0,5,2,3,0,Hertford,2023-02-10
0,3,2,1,0,Hertford,2023-02-17
0,3,2,1,0,Hoke,2022-11-11
0,7,2,5,0,Hoke,2022-12-01
0,4,2,2,0,Hoke,2023-03-01
0,4,2,2,0,Hoke,2023-03-22
0,2,2,0,0,Hoke,2023-03-31
0,10,2,8,0,Iredell,2022-11-24
0,4,2,2,0,Iredell,2023-04-01
0,3,2,1,0,Iredell,2023-04-15
0,2,2,0,0,Jackson,2022-11-22
0,2,2,0,0,Jackson,2022-12-25
0,3,2,1,0,Jackson,2023-01-02
0,4,2,2,0,Jackson,2023-01-15
0,3,2,1,0,Jackson,2023-02-25
0,2,2,0,0,Jackson,2023-03-14
0,2,2,0,0,Jackson,2023-03-15
0,4,2,2,0,Jackson,2023-03-21
0,2,2,0,0,Jackson,2023-03-23
0,4,2,2,0,Jackson,2023-04-26
0,2,2,0,0,Jackson,2023-05-03
0,10,2,8,0,Johnston,2023-03-09
0,4,2,2,0,Johnston,2023-05-03
0,3,2,1,0,Jones,2022-11-09
0,2,2,0,0,Jones,2022-11-21
0,3,2,1,0,Jones,2022-12-14
0,2,2,0,0,Jones,2022-12-25
0,2,2,0,0,Jones,2023-01-31
0,3,2,1,0,Jones,2023-02-02
0,2,2,0,0,Jones,2023-02-16
0,3,2,1,0,Lee,2022-11-24
0,5,2,3,0,Lee,2022-12-01
0,8,2,6,0,Lee,2022-12-09
0,6,2,4,0,Lee,2023-01-13
0,7,2,5,0,Lee,2023-01-27
0,9,2,7,0,Lee,2023-01-28
0,4,2,2,0,Lee,2023-02-08
0,2,2,0,0,Lee,2023-02-26
0,6,2,4,0,Lee,2023-02-27
0,3,2,1,0,Lee,2023-03-14
0,3,2,1,0,Lee,2023-03-17
0,5,2,3,0,Lee,2023-03-24
0,3,2,1,0,Lee,2023-04-13
0,2,2,0,0,Lee,2023-05-01
0,4,2,2,0,Lenoir,2022-12-17
0,4,2,2,0,Lenoir,2023-03-02
0,5,2,3,0,Lincoln,2022-11-11
0,5,2,3,0,Lincoln,2023-03-07
0,7,2,5,0,Lincoln,2023-03-13
0,2,2,0,0,Lincoln,2023-03-31
0,3,2,1,0,Lincoln,2023-04-13
0,3,2,1,0,Lincoln,2023-04-14
0,3,2,1,0,Macon,2023-01-20
0,2,2,0,0,Macon,2023-01-24
0,3,2,1,0,Madison,2022-11-21
0,2,2,0,0,Madison,2022-12-02
0,3,2,1,0,Madison,2022-12-17
0,4,2,2,0,Madison,2022-12-26
0,2,2,0,0,Madison,2023-01-08
0,5,2,3,0,Madison,2023-01-10
0,5,2,3,0,Madison,2023-01-11
0,2,2,0,0,Madison,2023-01-12
0,3,2,1,0,Madison,2023-02-02
0,4,2,2,0,Madison,2023-03-02
0,2,2,0,0,Madison,2023-04-02
0,4,2,2,0,Martin,2023-03-16
0,2,2,0,0,McDowell,2023-05-02
0,4,2,2,0,Mitchell,2022-12-15
0,3,2,1,0,Mitchell,2022-12-21
0,3,2,1,0,Mitchell,2023-01-09
0,3,2,1,0,Mitchell,2023-03-17
0,4,2,2,0,Montgomery,2023-01-20
0,4,2,2,0,Montgomery,2023-03-01
0,4,2,2,0,Moore,2022-11-17
0,6,2,4,0,Moore,2023-03-19
0,2,2,0,0,Moore,2023-04-08
0,3,2,1,0,Moore,2023-04-25
0,4,2,2,0,Nash,2022-12-03
0,5,2,3,0,Nash,2023-01-21
0,4,2,2,0,Nash,2023-02-28
0,4,2,2,0,Nash,2023-03-30
0,2,2,0,0,Nash,2023-05-01
0,6,2,4,0,New Hanover,2023-04-07
0,8,2,6,0,New Hanover,2023-04-18
0,3,2,1,0,New Hanover,2023-04-23
0,4,2,2,0,Northampton,2022-12-02
0,6,2,4,0,Northampton,2022-12-28
0,3,2,1,0,Northampton,2023-01-11
0,3,2,1,0,Northampton,2023-01-24
0,4,2,2,0,Northampton,2023-02-22
0,2,2,0,0,Northampton,2023-03-15
0,13,2,11,0,Onslow,2022-11-22
0,11,2,9,0,Orange,2023-03-01
0,11,2,9,0,Orange,2023-03-09
0,6,2,4,0,Pamlico,2022-12-27
0,3,2,1,0,Pamlico,2023-01-06
0,3,2,1,0,Pamlico,2023-02-08
0,4,2,2,0,Pamlico,2023-02-28
0,4,2,2,0,Pasquotank,2022-11-18
0,3,2,1,0,Pasquotank,2022-11-23
0,7,2,5,0,Pasquotank,2022-11-30
0,6,2,4,0,Pasquotank,2022-12-01
0,2,2,0,0,Pasquotank,2022-12-03
0,4,2,2,0,Pasquotank,2022-12-25
0,3,2,1,0,Pasquotank,2023-01-16
0,2,2,0,0,Pasquotank,2023-02-18
0,3,2,1,0,Pasquotank,2023-02-19
0,3,2,1,0,Pasquotank,2023-02-28
0,3,2,1,0,Pasquotank,2023-03-08
0,2,2,0,0,Pasquotank,2023-03-30
0,2,2,0,0,Pasquotank,2023-04-16
0,2,2,0,0,Pender,2022-11-13
0,8,2,6,0,Pender,2022-12-08
0,10,2,8,0,Pender,2023-01-14
0,10,2,8,0,Pender,2023-02-01
0,3,2,1,0,Perquimans,2023-01-04
0,2,2,0,0,Perquimans,2023-01-14
0,4,2,2,0,Perquimans,2023-02-04
0,2,2,0,0,Perquimans,2023-02-05
0,3,2,1,0,Perquimans,2023-03-22
0,2,2,0,0,Perquimans,2023-04-24
0,5,2,3,0,Person,2022-11-30
0,6,2,4,0,Person,2023-02-10
0,3,2,1,0,Person,2023-03-07
0,2,2,0,0,Person,2023-04-10
0,2,2,0,0,Person,2023-04-20
0,12,2,10,0,Pitt,2023-02-05
0,5,2,3,0,Pitt,2023-02-12
0,8,2,6,0,Pitt,2023-05-01
0,2,2,0,0,Polk,2022-11-12
0,2,2,0,0,Polk,2022-11-24
0,3,2,1,0,Polk,2022-11-28
0,6,2,4,0,Polk,2022-11-29
0,2,2,0,0,Polk,2022-12-01
0,2,2,0,0,Polk,2022-12-04
0,4,2,2,0,Polk,2023-02-01
0,3,2,1,0,Polk,2023-02-16
0,3,2,1,0,Polk,2023-02-20
0,2,2,0,0,Polk,2023-03-01
0,3,2,1,0,Polk,2023-04-17
0,2,2,0,0,Polk,2023-04-21
0,8,2,6,0,Randolph,2022-11-12
0,5,2,3,0,Randolph,2023-03-31
0,3,2,1,0,Randolph,2023-04-10
0,2,2,0,0,Richmond,2022-11-26
0,3,2,1,0,Richmond,2023-03-18
0,5,2,3,0,Richmond,2023-03-24
0,3,2,1,0,Robeson,2023-04-19
0,8,2,6,0,Rockingham,2022-11-17
0,8,2,6,0,Rockingham,2022-12-10
0,10,2,8,0,Rockingham,2023-02-28
0,3,2,1,0,Rockingham,2023-03-24
0,2,2,0,0,Rockingham,2023-04-24
0,4,2,2,0,Rowan,2023-03-11
0,5,2,3,0,Rowan,2023-03-26
0,5,2,3,0,Rutherford,2022-11-08
0,5,2,3,0,Rutherford,2023-02-06
0,3,2,1,0,Rutherford,2023-02-23
0,2,2,0,0,Rutherford,2023-03-03
0,4,2,2,0,Rutherford,2023-04-24
0,5,2,3,0,Sampson,2022-11-12
0,2,2,0,0,Sampson,2023-03-04
0,2,2,0,0,Sampson,2023-03-05
0,3,2,1,0,Sampson,2023-03-18
0,2,2,0,0,Sampson,2023-03-19
0,2,2,0,0,Sampson,2023-03-26
0,2,2,0,0,Sampson,2023-04-20
0,2,2,0,0,Scotland,2022-11-23
0,2,2,0,0,Scotland,2022-11-24
0,5,2,3,0,Scotland,2023-01-07
0,4,2,2,0,Scotland,2023-02-26
0,2,2,0,0,Scotland,2023-03-01
0,2,2,0,0,Scotland,2023-03-20
0,2,2,0,0,Scotland,2023-04-08
0,3,2,1,0,Scotland,2023-04-14
0,2,2,0,0,Scotland,2023-04-16
0,2,2,0,0,Scotland,2023-05-04
0,8,2,6,0,Stokes,2022-11-18
0,2,2,0,0,Stokes,2023-02-19
0,2,2,0,0,Stokes,2023-03-05
0,7,2,5,0,Surry,2023-02-18
0,7,2,5,0,Surry,2023-03-03
0,5,2,3,0,Surry,2023-04-09
0,4,2,2,0,Surry,2023-05-04
0,2,2,0,0,Swain,2022-11-08
0,3,2,1,0,Swain,2022-11-12
0,2,2,0,0,Swain,2022-11-29
0,6,2,4,0,Swain,2022-12-04
0,2,2,0,0,Swain,2022-12-09
0,2,2,0,0,Swain,2022-12-14
0,3,2,1,0,Swain,2022-12-19
0,5,2,3,0,Swain,2022-12-24
0,2,2,0,0,Swain,2023-01-22
0,5,2,3,0,Swain,2023-01-30
0,2,2,0,0,Swain,2023-02-19
0,2,2,0,0,Swain,2023-03-11
0,2,2,0,0,Swain,2023-04-03
0,3,2,1,0,Swain,2023-04-25
0,4,2,2,0,Transylvania,2022-12-02
0,8,2,6,0,Transylvania,2022-12-10
0,13,2,11,0,Transylvania,2022-12-19
0,7,2,5,0,Transylvania,2022-12-22
0,3,2,1,0,Transylvania,2023-01-12
0,2,2,0,0,Transylvania,2023-01-17
0,8,2,6,0,Transylvania,2023-01-21
0,4,2,2,0,Transylvania,2023-01-27
0,7,2,5,0,Transylvania,2023-02-03
0,5,2,3,0,Transylvania,2023-02-19
0,4,2,2,0,Transylvania,2023-02-27
0,2,2,0,0,Tyrrell,2023-01-11
0,8,2,6,0,Union,2023-04-27
0,6,2,4,0,Vance,2022-11-23
0,9,2,7,0,Vance,2022-12-12
0,9,2,7,0,Vance,2022-12-18
0,8,2,6,0,Vance,2023-02-04
0,3,2,1,0,Vance,2023-03-09
0,2,2,0,0,Vance,2023-03-15
0,5,2,3,0,Vance,2023-03-17
0,4,2,2,0,Vance,2023-04-08
0,3,2,1,0,Vance,2023-04-13
0,3,2,1,0,Warren,2022-11-09
0,2,2,0,0,Warren,2022-11-24
0,2,2,0,0,Warren,2023-03-07
0,3,2,1,0,Washington,2022-12-17
0,3,2,1,0,Washington,2022-12-24
0,3,2,1,0,Watauga,2022-11-20
0,4,2,2,0,Watauga,2022-11-25
0,4,2,2,0,Watauga,2022-12-31
0,6,2,4,0,Watauga,2023-01-15
0,12,2,10,0,Watauga,2023-01-23
0,6,2,4,0,Watauga,2023-02-20
0,4,2,2,0,Watauga,2023-02-24
0,3,2,1,0,Watauga,2023-03-12
0,2,2,0,0,Watauga,2023-03-17
0,6,2,4,0,Watauga,2023-03-24
0,2,2,0,0,Watauga,2023-04-15
0,4,2,2,0,Wayne,2022-11-19
0,6,2,4,0,Wayne,2023-02-19
0,4,2,2,0,Wayne,2023-05-03
0,3,2,1,0,Wilkes,2022-11-24
0,7,2,5,0,Wilkes,2023-01-24
0,4,2,2,0,Wilkes,2023-02-26
0,3,2,1,0,Wilkes,2023-04-04
0,3,2,1,0,Wilkes,2023-04-24
0,3,2,1,0,Wilkes,2023-04-26
0,7,2,5,0,Wilson,2023-02-25
0,7,2,5,0,Wilson,2023-02-26
0,4,2,2,0,Wilson,2023-03-08
0,4,2,2,0,Wilson,2023-03-17
0,3,2,1,0,Wilson,2023-03-18
0,2,2,0,0,Wilson,2023-03-22
0,3,2,1,0,Wilson,2023-04-11
0,4,2,2,0,Wilson,2023-04-22
0,6,2,4,0,Yadkin,2022-11-23
0,7,2,5,0,Yadkin,2022-12-02
0,9,2,7,0,Yadkin,2022-12-03
0,3,2,1,0,Yadkin,2023-03-13
0,4,2,2,0,Yancey,2022-12-15
0,3,2,1,0,Yancey,2023-01-03
0,2,2,0,0,Yancey,2023-01-10
0,3,2,1,0,Yancey,2023-01-27
0,6,2,4,0,Yancey,2023-02-07
0,3,2,1,0,Yancey,2023-03-01
0,4,3,1,0,Alexander,2023-02-22
0,4,3,1,0,Alleghany,2022-12-20
0,4,3,1,0,Alleghany,2022-12-22
0,5,3,2,0,Alleghany,2023-01-06
0,6,3,3,0,Ashe,2022-12-08
0,4,3,1,0,Ashe,2023-02-20
0,4,3,1,0,Avery,2023-01-04
0,10,3,7,0,Beaufort,2023-02-03
0,7,3,4,0,Beaufort,2023-03-09
0,3,3,0,0,Bertie,2023-05-01
0,7,3,4,0,Brunswick,2023-02-12
0,9,3,6,0,Brunswick,2023-02-28
0,12,3,9,0,Buncombe,2023-02-05
0,9,3,6,0,Buncombe,2023-03-17
0,5,3,2,0,Buncombe,2023-05-03
0,10,3,7,0,Burke,2022-11-27
0,4,3,1,0,Burke,2023-03-05
0,4,3,1,0,Burke,2023-03-23
0,5,3,2,0,Burke,2023-04-20
0,4,3,1,0,Camden,2022-12-28
0,3,3,0,0,Camden,2023-01-31
0,3,3,0,0,Camden,2023-02-11
0,4,3,1,0,Camden,2023-02-17
0,3,3,0,0,Camden,2023-02-28
0,5,3,2,0,Carteret,2022-11-22
0,4,3,1,0,Carteret,2022-11-23
0,6,3,3,0,Carteret,2022-12-14
0,3,3,0,0,Carteret,2023-01-29
0,6,3,3,0,Carteret,2023-02-10
0,6,3,3,0,Carteret,2023-02-13
0,4,3,1,0,Carteret,2023-02-26
0,4,3,1,0,Carteret,2023-04-04
0,5,3,2,0,Catawba,2023-04-29
0,13,3,10,0,Chatham,2022-11-14
0,13,3,10,0,Chatham,2022-12-31
0,5,3,2,0,Chatham,2023-02-19
0,10,3,7,0,Cherokee,2023-02-08
0,5,3,2,0,Cherokee,2023-02-16
0,9,3,6,0,Chowan,2023-01-23
0,6,3,3,0,Columbus,2022-11-17
0,6,3,3,0,Craven,2023-01-21
0,3,3,0,0,Davidson,2023-04-15
0,6,3,3,0,Davie,2022-11-08
0,3,3,0,0,Davie,2023-02-12
0,4,3,1,0,Davie,2023-03-04
0,5,3,2,0,Duplin,2022-11-10
0,10,3,7,0,Duplin,2022-12-08
0,6,3,3,0,Duplin,2022-12-18
0,9,3,6,0,Duplin,2022-12-24
0,4,3,1,0,Duplin,2023-03-13
0,3,3,0,0,Franklin,2022-12-25
0,7,3,4,0,Gaston,2023-04-02
0,3,3,0,0,Graham,2022-11-30
0,5,3,2,0,Granville,2023-01-15
0,5,3,2,0,Granville,2023-04-05
0,9,3,6,0,Greene,2022-12-27
0,4,3,1,0,Harnett,2023-04-27
0,8,3,5,0,Haywood,2022-11-30
0,7,3,4,0,Haywood,2022-12-05
0,5,3,2,0,Haywood,2023-01-22
0,7,3,4,0,Haywood,2023-02-10
0,4,3,1,0,Haywood,2023-03-15
0,3,3,0,0,Haywood,2023-05-05
0,9,3,6,0,Henderson,2023-02-05
0,9,3,6,0,Henderson,2023-03-24
0,8,3,5,0,Henderson,2023-03-28
0,9,3,6,0,Hertford,2022-12-02
0,7,3,4,0,Hertford,2022-12-05
0,3,3,0,0,Hoke,2023-03-12
0,6,3,3,0,Hoke,2023-03-21
0,7,3,4,0,Iredell,2023-03-14
0,9,3,6,0,Iredell,2023-03-24
0,4,3,1,0,Jackson,2022-11-11
0,8,3,5,0,Jackson,2023-02-10
0,4,3,1,0,Jackson,2023-03-20
0,5,3,2,0,Jones,2022-12-26
0,5,3,2,0,Jones,2023-01-05
0,5,3,2,0,Jones,2023-01-06
0,5,3,2,0,Lee,2022-12-03
0,5,3,2,0,Lee,2022-12-10
0,7,3,4,0,Lenoir,2022-12-02
0,8,3,5,0,Macon,2022-12-05
0,5,3,2,0,Macon,2023-01-02
0,3,3,0,0,Madison,2022-11-29
0,3,3,0,0,Madison,2023-03-07
0,3,3,0,0,Madison,2023-03-14
0,3,3,0,0,Madison,2023-03-30
0,10,3,7,0,McDowell,2022-11-27
0,6,3,3,0,McDowell,2022-12-24
0,8,3,5,0,McDowell,2023-02-28
0,3,3,0,0,Mitchell,2022-11-08
0,4,3,1,0,Mitchell,2022-12-08
0,3,3,0,0,Mitchell,2022-12-16
0,3,3,0,0,Mitchell,2022-12-24
0,4,3,1,0,Mitchell,2022-12-29
0,3,3,0,0,Mitchell,2023-01-15
0,4,3,1,0,Montgomery,2022-12-17
0,6,3,3,0,Montgomery,2023-01-29
0,14,3,11,0,New Hanover,2023-02-25
0,4,3,1,0,New Hanover,2023-04-08
0,3,3,0,0,Northampton,2023-02-19
0,3,3,0,0,Northampton,2023-03-03
0,20,3,17,0,Orange,2022-12-18
0,8,3,5,0,Orange,2023-03-23
0,5,3,2,0,Pamlico,2022-12-30
0,5,3,2,0,Pamlico,2023-02-02
0,3,3,0,0,Pamlico,2023-02-06
0,6,3,3,0,Pamlico,2023-02-10
0,3,3,0,0,Pamlico,2023-02-27
0,6,3,3,0,Pasquotank,2022-12-19
0,5,3,2,0,Pasquotank,2023-01-20
0,5,3,2,0,Pasquotank,2023-02-02
0,3,3,0,0,Pasquotank,2023-02-27
0,9,3,6,0,Pender,2023-01-12
0,4,3,1,0,Perquimans,2023-04-02
0,12,3,9,0,Pitt,2023-03-07
0,3,3,0,0,Polk,2022-12-07
0,3,3,0,0,Polk,2022-12-24
0,4,3,1,0,Polk,2023-01-05
0,5,3,2,0,Polk,2023-01-06
0,4,3,1,0,Polk,2023-01-10
0,6,3,3,0,Polk,2023-01-18
0,3,3,0,0,Randolph,2023-03-05
0,3,3,0,0,Randolph,2023-04-05
0,3,3,0,0,Randolph,2023-04-18
0,3,3,0,0,Richmond,2022-11-10
0,6,3,3,0,Richmond,2022-12-08
0,3,3,0,0,Robeson,2023-03-31
0,7,3,4,0,Rockingham,2022-11-12
0,4,3,1,0,Rockingham,2023-04-07
0,5,3,2,0,Rowan,2023-04-16
0,7,3,4,0,Rowan,2023-04-21
0,10,3,7,0,Rutherford,2023-01-27
0,4,3,1,0,Sampson,2022-11-13
0,4,3,1,0,Sampson,2022-11-27
0,3,3,0,0,Sampson,2022-12-23
0,3,3,0,0,Sampson,2023-02-11
0,3,3,0,0,Sampson,2023-02-26
0,7,3,4,0,Sampson,2023-02-27
0,4,3,1,0,Sampson,2023-03-21
0,3,3,0,0,Sampson,2023-03-23
0,3,3,0,0,Sampson,2023-03-24
0,6,3,3,0,Scotland,2022-12-09
0,5,3,2,0,Scotland,2023-01-08
0,4,3,1,0,Scotland,2023-02-17
0,5,3,2,0,Scotland,2023-03-02
0,4,3,1,0,Scotland,2023-03-16
0,4,3,1,0,Scotland,2023-03-27
0,4,3,1,0,Scotland,2023-04-15
0,4,3,1,0,Scotland,2023-04-18
0,4,3,1,0,Stokes,2023-02-26
0,8,3,5,0,Surry,2023-03-31
0,5,3,2,0,Swain,2022-12-26
0,4,3,1,0,Swain,2022-12-27
0,8,3,5,0,Swain,2023-01-03
0,5,3,2,0,Swain,2023-01-07
0,5,3,2,0,Swain,2023-01-13
0,3,3,0,0,Swain,2023-04-29
0,4,3,1,0,Transylvania,2023-02-17
0,6,3,3,0,Union,2023-04-05
0,9,3,6,0,Vance,2022-11-17
0,3,3,0,0,Vance,2023-04-10
0,6,3,3,0,Warren,2023-01-31
0,11,3,8,0,Watauga,2022-11-14
0,7,3,4,0,Watauga,2022-12-18
0,10,3,7,0,Watauga,2022-12-30
0,10,3,7,0,Watauga,2023-01-03
0,6,3,3,0,Watauga,2023-01-07
0,4,3,1,0,Watauga,2023-01-16
0,12,3,9,0,Watauga,2023-02-07
0,7,3,4,0,Wayne,2022-11-26
0,7,3,4,0,Wayne,2022-11-27
0,7,3,4,0,Wayne,2023-02-25
0,5,3,2,0,Wayne,2023-04-19
0,9,3,6,0,Wilkes,2023-01-25
0,6,3,3,0,Wilkes,2023-03-01
0,4,3,1,0,Wilkes,2023-03-07
0,9,3,6,0,Wilkes,2023-03-22
0,4,3,1,0,Wilkes,2023-04-19
0,7,3,4,0,Wilson,2023-02-23
0,7,3,4,0,Wilson,2023-03-24
0,4,3,1,0,Wilson,2023-05-04
0,5,3,2,0,Yadkin,2022-11-17
0,12,3,9,0,Yadkin,2022-12-05
0,5,3,2,0,Yadkin,2022-12-09
0,4,3,1,0,Yancey,2023-01-04
0,3,3,0,0,Yancey,2023-02-20
0,3,3,0,0,Yancey,2023-04-08
0,3,3,0,0,Yancey,2023-04-13
0,7,4,3,0,Alexander,2022-12-12
0,5,4,1,0,Alexander,2023-02-14
0,5,4,1,0,Alleghany,2023-01-04
0,5,4,1,0,Ashe,2022-12-06
0,8,4,4,0,Brunswick,2023-04-27
0,15,4,11,0,Buncombe,2023-03-14
0,6,4,2,0,Buncombe,2023-03-16
0,10,4,6,0,Cabarrus,2023-03-16
0,7,4,3,0,Carteret,2023-02-14
0,4,4,0,0,Carteret,2023-03-26
0,5,4,1,0,Catawba,2023-03-04
0,12,4,8,0,Catawba,2023-04-04
0,12,4,8,0,Chatham,2023-02-15
0,8,4,4,0,Cherokee,2022-12-08
0,4,4,0,0,Cleveland,2023-05-01
0,5,4,1,0,Craven,2022-11-17
0,15,4,11,0,Craven,2023-01-20
0,5,4,1,0,Craven,2023-05-02
0,6,4,2,0,Cumberland,2023-04-13
0,15,4,11,0,Davie,2022-12-23
0,9,4,5,0,Durham,2023-04-22
0,6,4,2,0,Franklin,2022-12-24
0,10,4,6,0,Gaston,2023-03-04
0,5,4,1,0,Graham,2023-01-09
0,7,4,3,0,Granville,2022-11-29
0,8,4,4,0,Halifax,2023-03-14
0,5,4,1,0,Haywood,2022-11-12
0,4,4,0,0,Haywood,2023-03-26
0,5,4,1,0,Haywood,2023-03-27
0,6,4,2,0,Henderson,2023-03-11
0,8,4,4,0,Henderson,2023-03-17
0,8,4,4,0,Henderson,2023-03-26
0,9,4,5,0,Henderson,2023-04-07
0,14,4,10,0,Iredell,2022-11-18
0,9,4,5,0,Iredell,2023-04-13
0,6,4,2,0,Jackson,2022-12-10
0,6,4,2,0,Jackson,2022-12-19
0,9,4,5,0,Johnston,2023-03-25
0,4,4,0,0,Jones,2023-01-04
0,6,4,2,0,Macon,2022-12-08
0,8,4,4,0,Macon,2022-12-23
0,13,4,9,0,Macon,2022-12-28
0,4,4,0,0,Madison,2022-12-30
0,5,4,1,0,Madison,2023-02-15
0,4,4,0,0,McDowell,2023-03-09
0,10,4,6,0,Moore,2023-02-27
0,6,4,2,0,Nash,2023-02-21
0,8,4,4,0,New Hanover,2023-03-19
0,5,4,1,0,Pamlico,2022-12-06
0,8,4,4,0,Pasquotank,2022-12-12
0,4,4,0,0,Pasquotank,2023-03-06
0,5,4,1,0,Pitt,2023-03-16
0,6,4,2,0,Polk,2023-01-27
0,10,4,6,0,Randolph,2022-11-09
0,6,4,2,0,Randolph,2023-05-04
0,10,4,6,0,Robeson,2023-04-04
0,7,4,3,0,Rockingham,2022-12-03
0,22,4,18,0,Rockingham,2022-12-05
0,4,4,0,0,Rutherford,2023-05-04
0,4,4,0,0,Sampson,2022-11-22
0,9,4,5,0,Sampson,2022-12-14
0,5,4,1,0,Sampson,2023-03-07
0,5,4,1,0,Sampson,2023-03-14
0,4,4,0,0,Scotland,2022-11-28
0,6,4,2,0,Stokes,2022-12-04
0,5,4,1,0,Surry,2023-04-26
0,4,4,0,0,Swain,2022-12-06
0,4,4,0,0,Swain,2023-02-09
0,6,4,2,0,Transylvania,2022-11-25
0,11,4,7,0,Transylvania,2022-12-26
0,8,4,4,0,Transylvania,2023-01-04
0,5,4,1,0,Transylvania,2023-02-13
0,14,4,10,0,Union,2022-11-20
0,8,4,4,0,Warren,2022-12-29
0,4,4,0,0,Warren,2023-02-17
0,7,4,3,0,Watauga,2022-12-04
0,7,4,3,0,Watauga,2022-12-21
0,13,4,9,0,Watauga,2023-02-01
0,8,4,4,0,Wayne,2023-02-11
0,13,4,9,0,Wilkes,2023-01-12
0,4,4,0,0,Wilson,2023-03-16
0,5,4,1,0,Yancey,2023-04-12
0,4,4,0,0,Yancey,2023-04-17
0,7,5,2,0,Alleghany,2022-12-21
0,5,5,0,0,Alleghany,2023-01-18
0,9,5,4,0,Caldwell,2023-03-03
0,7,5,2,0,Carteret,2022-12-08
0,6,5,1,0,Clay,2022-12-23
0,9,5,4,0,Craven,2022-11-21
0,25,5,20,0,Davidson,2022-12-02
0,12,5,7,0,Davie,2022-12-16
0,6,5,1,0,Halifax,2023-04-24
0,10,5,5,0,Haywood,2022-12-15
0,6,5,1,0,Haywood,2023-02-28
0,11,5,6,0,Henderson,2023-02-17
0,12,5,7,0,Henderson,2023-02-21
0,8,5,3,0,Henderson,2023-03-03
0,8,5,3,0,Iredell,2023-04-27
0,14,5,9,0,Johnston,2023-03-10
0,9,5,4,0,Macon,2022-12-13
0,7,5,2,0,McDowell,2022-11-18
0,8,5,3,0,McDowell,2023-04-14
0,5,5,0,0,Mitchell,2022-12-06
0,5,5,0,0,Montgomery,2023-03-23
0,8,5,3,0,Pasquotank,2023-02-05
0,6,5,1,0,Sampson,2023-01-15
0,6,5,1,0,Sampson,2023-03-20
0,7,5,2,0,Scotland,2022-12-18
0,8,5,3,0,Scotland,2023-01-15
0,9,5,4,0,Watauga,2023-03-01
0,6,5,1,0,Wilson,2022-11-22
0,6,6,0,0,Alleghany,2023-03-22
0,18,6,12,0,Cabarrus,2023-03-14
0,15,6,9,0,Cumberland,2023-03-19
0,13,6,7,0,Davie,2023-01-13
0,10,6,4,0,Haywood,2022-11-10
0,7,6,1,0,Jackson,2022-12-02
0,11,6,5,0,Jackson,2023-01-03
0,10,6,4,0,Northampton,2022-12-16
0,8,6,2,0,Pasquotank,2023-01-27
0,6,6,0,0,Polk,2023-01-29
0,11,6,5,0,Randolph,2022-11-17
0,16,6,10,0,Randolph,2023-01-28
0,13,6,7,0,Rockingham,2023-01-20
0,6,6,0,0,Tyrrell,2023-02-09
0,13,6,7,0,Wilson,2023-02-03
0,8,6,2,0,Wilson,2023-03-20
0,11,7,4,0,Alexander,2023-01-06
0,7,7,0,0,Alleghany,2023-01-12
0,11,7,4,0,Buncombe,2023-03-06
0,19,7,12,0,Burke,2022-12-26
0,13,7,6,0,Cabarrus,2023-03-24
0,12,7,5,0,Catawba,2022-12-04
0,8,7,1,0,Haywood,2023-01-27
0,16,7,9,0,Henderson,2022-11-30
0,14,7,7,0,Henderson,2023-01-22
0,7,7,0,0,Madison,2022-11-30
0,13,7,6,0,New Hanover,2023-05-04
0,14,7,7,0,Vance,2023-01-16
0,12,7,5,0,Watauga,2023-01-22
0,13,7,6,0,Wayne,2023-03-09
0,15,8,7,0,Catawba,2023-03-28
0,11,9,2,0,Sampson,2022-12-05
0,11,9,2,0,Scotland,2023-01-30
0,16,9,7,0,Watauga,2022-12-20
0,14,10,4,0,Catawba,2023-02-18
0,11,10,1,0,Jackson,2023-02-17
0,17,10,7,0,Watauga,2022-12-19
1,6,0,6,0,Alamance,2023-03-11
1,3,0,3,0,Alamance,2023-04-02
1,1,0,1,0,Alexander,2022-11-20
1,2,0,2,0,Alexander,2022-12-02
1,2,0,2,0,Alexander,2022-12-10
1,1,0,1,0,Alexander,2022-12-11
1,7,0,7,0,Alexander,2023-02-17
1,1,0,1,0,Alexander,2023-03-04
1,1,0,1,0,Alexander,2023-03-21
1,2,0,2,0,Alleghany,2022-11-27
1,2,0,2,0,Alleghany,2022-12-17
1,1,0,1,0,Alleghany,2023-01-08
1,2,0,2,0,Alleghany,2023-01-26
1,1,0,1,0,Alleghany,2023-02-19
1,2,0,2,0,Anson,2022-11-15
1,3,0,3,0,Anson,2022-11-17
1,1,0,1,0,Anson,2022-11-19
1,2,0,2,0,Anson,2022-11-23
1,1,0,1,0,Anson,2022-11-24
1,4,0,4,0,Anson,2022-11-30
1,1,0,1,0,Anson,2022-12-03
1,2,0,2,0,Anson,2022-12-10
1,2,0,2,0,Anson,2022-12-15
1,4,0,4,0,Anson,2023-01-21
1,5,0,5,0,Anson,2023-01-29
1,2,0,2,0,Anson,2023-02-01
1,4,0,4,0,Anson,2023-02-03
1,4,0,4,0,Anson,2023-02-07
1,4,0,4,0,Anson,2023-02-08
1,2,0,2,0,Anson,2023-02-13
1,4,0,4,0,Anson,2023-02-14
1,3,0,3,0,Anson,2023-02-18
1,2,0,2,0,Anson,2023-02-21
1,2,0,2,0,Anson,2023-02-22
1,1,0,1,0,Anson,2023-03-18
1,2,0,2,0,Anson,2023-03-19
1,2,0,2,0,Anson,2023-03-29
1,2,0,2,0,Anson,2023-04-01
1,1,0,1,0,Anson,2023-04-02
1,1,0,1,0,Anson,2023-04-03
1,1,0,1,0,Anson,2023-04-19
1,2,0,2,0,Anson,2023-04-20
1,2,0,2,0,Ashe,2022-11-15
1,3,0,3,0,Ashe,2022-11-28
1,7,0,7,0,Ashe,2022-12-10
1,2,0,2,0,Ashe,2022-12-21
1,5,0,5,0,Ashe,2023-01-24
1,3,0,3,0,Ashe,2023-01-25
1,4,0,4,0,Ashe,2023-01-29
1,3,0,3,0,Ashe,2023-02-05
1,1,0,1,0,Ashe,2023-02-12
1,3,0,3,0,Ashe,2023-02-23
1,1,0,1,0,Ashe,2023-02-24
1,8,0,8,0,Avery,2022-12-12
1,3,0,3,0,Avery,2022-12-26
1,4,0,4,0,Avery,2022-12-27
1,1,0,1,0,Avery,2023-01-09
1,1,0,1,0,Avery,2023-01-25
1,3,0,3,0,Avery,2023-02-01
1,1,0,1,0,Avery,2023-02-09
1,1,0,1,0,Avery,2023-02-10
1,1,0,1,0,Avery,2023-02-15
1,3,0,3,0,Avery,2023-02-24
1,3,0,3,0,Avery,2023-03-05
1,1,0,1,0,Avery,2023-03-22
1,1,0,1,0,Avery,2023-04-04
1,2,0,2,0,Beaufort,2022-11-11
1,2,0,2,0,Beaufort,2022-11-13
1,3,0,3,0,Beaufort,2022-11-25
1,3,0,3,0,Beaufort,2022-11-27
1,4,0,4,0,Beaufort,2022-12-02
1,5,0,5,0,Beaufort,2022-12-05
1,2,0,2,0,Beaufort,2023-01-01
1,5,0,5,0,Beaufort,2023-01-07
1,5,0,5,0,Beaufort,2023-01-08
1,3,0,3,0,Beaufort,2023-01-14
1,4,0,4,0,Beaufort,2023-01-21
1,4,0,4,0,Beaufort,2023-01-22
1,5,0,5,0,Beaufort,2023-01-27
1,4,0,4,0,Beaufort,2023-02-18
1,3,0,3,0,Beaufort,2023-02-19
1,2,0,2,0,Beaufort,2023-03-05
1,2,0,2,0,Beaufort,2023-03-16
1,1,0,1,0,Beaufort,2023-04-20
1,1,0,1,0,Beaufort,2023-04-25
1,1,0,1,0,Beaufort,2023-05-01
1,1,0,1,0,Bertie,2022-11-17
1,3,0,3,0,Bertie,2022-11-22
1,3,0,3,0,Bertie,2022-11-23
1,2,0,2,0,Bertie,2022-11-27
1,2,0,2,0,Bertie,2022-11-28
1,3,0,3,0,Bertie,2022-12-02
1,1,0,1,0,Bertie,2022-12-04
1,3,0,3,0,Bertie,2022-12-18
1,3,0,3,0,Bertie,2022-12-24
1,5,0,5,0,Bertie,2022-12-28
1,5,0,5,0,Bertie,2023-01-09
1,4,0,4,0,Bertie,2023-01-12
1,1,0,1,0,Bertie,2023-01-15
1,2,0,2,0,Bertie,2023-01-16
1,2,0,2,0,Bertie,2023-01-22
1,2,0,2,0,Bertie,2023-01-26
1,2,0,2,0,Bertie,2023-01-31
1,7,0,7,0,Bertie,2023-02-01
1,2,0,2,0,Bertie,2023-02-03
1,3,0,3,0,Bertie,2023-02-04
1,4,0,4,0,Bertie,2023-02-09
1,5,0,5,0,Bertie,2023-02-10
1,4,0,4,0,Bertie,2023-02-15
1,3,0,3,0,Bertie,2023-02-28
1,2,0,2,0,Bertie,2023-03-06
1,2,0,2,0,Bertie,2023-03-08
1,1,0,1,0,Bertie,2023-03-10
1,1,0,1,0,Bertie,2023-03-11
1,1,0,1,0,Bertie,2023-03-12
1,2,0,2,0,Bertie,2023-03-24
1,3,0,3,0,Bertie,2023-03-27
1,1,0,1,0,Bertie,2023-03-30
1,1,0,1,0,Bertie,2023-04-29
1,5,0,5,0,Bladen,2022-11-09
1,5,0,5,0,Bladen,2022-11-17
1,3,0,3,0,Bladen,2022-11-21
1,4,0,4,0,Bladen,2022-12-04
1,3,0,3,0,Bladen,2022-12-24
1,4,0,4,0,Bladen,2023-01-15
1,4,0,4,0,Bladen,2023-02-04
1,3,0,3,0,Bladen,2023-02-08
1,4,0,4,0,Bladen,2023-02-19
1,5,0,5,0,Bladen,2023-02-21
1,6,0,6,0,Bladen,2023-03-02
1,2,0,2,0,Bladen,2023-03-07
1,3,0,3,0,Bladen,2023-03-14
1,4,0,4,0,Bladen,2023-03-17
1,2,0,2,0,Bladen,2023-03-19
1,2,0,2,0,Bladen,2023-03-22
1,1,0,1,0,Bladen,2023-03-30
1,5,0,5,0,Bladen,2023-04-27
1,1,0,1,0,Bladen,2023-04-30
1,5,0,5,0,Brunswick,2023-03-23
1,5,0,5,0,Brunswick,2023-03-30
1,2,0,2,0,Brunswick,2023-04-15
1,7,0,7,0,Brunswick,2023-04-18
1,6,0,6,0,Burke,2022-11-11
1,9,0,9,0,Burke,2022-11-19
1,3,0,3,0,Burke,2023-02-19
1,9,0,9,0,Burke,2023-02-24
1,3,0,3,0,Burke,2023-03-17
1,3,0,3,0,Burke,2023-03-19
1,3,0,3,0,Burke,2023-03-27
1,1,0,1,0,Burke,2023-03-31
1,3,0,3,0,Burke,2023-04-02
1,1,0,1,0,Burke,2023-04-07
1,4,0,4,0,Burke,2023-04-08
1,1,0,1,0,Burke,2023-04-13
1,2,0,2,0,Burke,2023-04-17
1,3,0,3,0,Cabarrus,2023-04-09
1,2,0,2,0,Cabarrus,2023-04-20
1,5,0,5,0,Cabarrus,2023-04-29
1,3,0,3,0,Cabarrus,2023-04-30
1,4,0,4,0,Cabarrus,2023-05-04
1,4,0,4,0,Caldwell,2022-11-13
1,4,0,4,0,Caldwell,2022-11-22
1,5,0,5,0,Caldwell,2023-04-02
1,5,0,5,0,Caldwell,2023-04-04
1,7,0,7,0,Caldwell,2023-04-07
1,8,0,8,0,Caldwell,2023-04-15
1,4,0,4,0,Caldwell,2023-04-24
1,3,0,3,0,Caldwell,2023-04-27
1,1,0,1,0,Camden,2022-11-13
1,1,0,1,0,Camden,2023-01-18
1,2,0,2,0,Camden,2023-02-15
1,1,0,1,0,Camden,2023-03-20
1,1,0,1,0,Camden,2023-04-08
1,4,0,4,0,Carteret,2022-11-09
1,2,0,2,0,Carteret,2022-11-14
1,3,0,3,0,Carteret,2023-01-26
1,3,0,3,0,Carteret,2023-02-16
1,1,0,1,0,Carteret,2023-03-01
1,1,0,1,0,Carteret,2023-03-06
1,1,0,1,0,Carteret,2023-03-11
1,2,0,2,0,Carteret,2023-03-19
1,1,0,1,0,Carteret,2023-04-05
1,1,0,1,0,Carteret,2023-04-11
1,1,0,1,0,Caswell,2022-11-08
1,4,0,4,0,Caswell,2022-11-09
1,4,0,4,0,Caswell,2022-11-17
1,3,0,3,0,Caswell,2022-11-21
1,3,0,3,0,Caswell,2022-11-26
1,5,0,5,0,Caswell,2022-12-05
1,1,0,1,0,Caswell,2022-12-06
1,3,0,3,0,Caswell,2022-12-07
1,5,0,5,0,Caswell,2022-12-10
1,6,0,6,0,Caswell,2022-12-22
1,4,0,4,0,Caswell,2023-01-11
1,4,0,4,0,Caswell,2023-01-16
1,4,0,4,0,Caswell,2023-01-28
1,2,0,2,0,Caswell,2023-01-31
1,3,0,3,0,Caswell,2023-02-05
1,2,0,2,0,Caswell,2023-02-09
1,2,0,2,0,Caswell,2023-02-11
1,1,0,1,0,Caswell,2023-02-15
1,2,0,2,0,Caswell,2023-02-18
1,1,0,1,0,Caswell,2023-03-16
1,3,0,3,0,Caswell,2023-03-21
1,3,0,3,0,Caswell,2023-03-24
1,2,0,2,0,Caswell,2023-03-27
1,2,0,2,0,Caswell,2023-04-27
1,1,0,1,0,Caswell,2023-05-01
1,1,0,1,0,Caswell,2023-05-02
1,6,0,6,0,Catawba,2022-11-12
1,2,0,2,0,Catawba,2023-04-16
1,2,0,2,0,Catawba,2023-05-04
1,8,0,8,0,Chatham,2022-11-16
1,6,0,6,0,Chatham,2022-12-04
1,10,0,10,0,Chatham,2022-12-09
1,4,0,4,0,Chatham,2022-12-25
1,4,0,4,0,Chatham,2023-03-10
1,4,0,4,0,Chatham,2023-03-28
1,2,0,2,0,Chatham,2023-04-05
1,1,0,1,0,Chatham,2023-04-06
1,3,0,3,0,Chatham,2023-04-07
1,2,0,2,0,Chatham,2023-04-18
1,2,0,2,0,Cherokee,2022-11-18
1,2,0,2,0,Cherokee,2022-12-04
1,1,0,1,0,Cherokee,2022-12-11
1,5,0,5,0,Cherokee,2022-12-22
1,5,0,5,0,Cherokee,2023-01-13
1,6,0,6,0,Cherokee,2023-01-15
1,2,0,2,0,Cherokee,2023-02-11
1,1,0,1,0,Cherokee,2023-03-12
1,2,0,2,0,Cherokee,2023-03-14
1,1,0,1,0,Cherokee,2023-03-17
1,1,0,1,0,Cherokee,2023-03-19
1,4,0,4,0,Cherokee,2023-03-28
1,1,0,1,0,Cherokee,2023-03-31
1,1,0,1,0,Cherokee,2023-04-02
1,2,0,2,0,Cherokee,2023-04-04
1,1,0,1,0,Cherokee,2023-04-13
1,2,0,2,0,Cherokee,2023-04-19
1,1,0,1,0,Cherokee,2023-05-03
1,5,0,5,0,Chowan,2022-11-11
1,2,0,2,0,Chowan,2022-11-21
1,1,0,1,0,Chowan,2022-11-23
1,5,0,5,0,Chowan,2022-11-28
1,1,0,1,0,Chowan,2022-12-02
1,6,0,6,0,Chowan,2022-12-13
1,3,0,3,0,Chowan,2022-12-14
1,7,0,7,0,Chowan,2022-12-16
1,1,0,1,0,Chowan,2022-12-18
1,4,0,4,0,Chowan,2022-12-22
1,3,0,3,0,Chowan,2022-12-25
1,4,0,4,0,Chowan,2023-01-02
1,1,0,1,0,Chowan,2023-01-15
1,9,0,9,0,Chowan,2023-01-17
1,1,0,1,0,Chowan,2023-02-05
1,6,0,6,0,Chowan,2023-02-08
1,1,0,1,0,Chowan,2023-02-13
1,2,0,2,0,Chowan,2023-02-16
1,1,0,1,0,Chowan,2023-02-25
1,2,0,2,0,Chowan,2023-03-03
1,2,0,2,0,Chowan,2023-03-06
1,1,0,1,0,Chowan,2023-03-25
1,1,0,1,0,Chowan,2023-03-29
1,1,0,1,0,Chowan,2023-04-04
1,1,0,1,0,Chowan,2023-04-12
1,2,0,2,0,Chowan,2023-04-17
1,2,0,2,0,Clay,2022-11-14
1,8,0,8,0,Clay,2022-12-15
1,6,0,6,0,Clay,2022-12-16
1,4,0,4,0,Clay,2022-12-20
1,2,0,2,0,Clay,2023-01-15
1,1,0,1,0,Clay,2023-01-27
1,2,0,2,0,Clay,2023-03-22
1,1,0,1,0,Clay,2023-03-31
1,1,0,1,0,Clay,2023-04-02
1,10,0,10,0,Cleveland,2022-12-25
1,3,0,3,0,Cleveland,2023-03-03
1,2,0,2,0,Cleveland,2023-03-12
1,3,0,3,0,Cleveland,2023-03-15
1,3,0,3,0,Cleveland,2023-03-18
1,1,0,1,0,Cleveland,2023-03-19
1,3,0,3,0,Cleveland,2023-03-21
1,3,0,3,0,Cleveland,2023-03-27
1,6,0,6,0,Cleveland,2023-03-29
1,1,0,1,0,Cleveland,2023-04-01
1,2,0,2,0,Cleveland,2023-04-02
1,3,0,3,0,Cleveland,2023-04-07
1,2,0,2,0,Cleveland,2023-04-10
1,1,0,1,0,Cleveland,2023-04-24
1,2,0,2,0,Cleveland,2023-04-27
1,5,0,5,0,Columbus,2022-11-12
1,5,0,5,0,Columbus,2022-11-18
1,2,0,2,0,Columbus,2022-11-23
1,2,0,2,0,Columbus,2022-11-24
1,6,0,6,0,Columbus,2022-11-27
1,6,0,6,0,Columbus,2022-12-17
1,4,0,4,0,Columbus,2022-12-18
1,7,0,7,0,Columbus,2023-02-04
1,4,0,4,0,Columbus,2023-02-07
1,6,0,6,0,Columbus,2023-02-17
1,3,0,3,0,Columbus,2023-02-25
1,5,0,5,0,Columbus,2023-03-04
1,2,0,2,0,Columbus,2023-03-05
1,2,0,2,0,Columbus,2023-03-11
1,4,0,4,0,Columbus,2023-03-12
1,4,0,4,0,Columbus,2023-03-13
1,1,0,1,0,Columbus,2023-03-26
1,1,0,1,0,Columbus,2023-04-07
1,2,0,2,0,Columbus,2023-04-14
1,1,0,1,0,Columbus,2023-04-27
1,3,0,3,0,Craven,2022-11-26
1,2,0,2,0,Craven,2023-04-09
1,6,0,6,0,Craven,2023-04-13
1,1,0,1,0,Craven,2023-04-23
1,3,0,3,0,Craven,2023-04-29
1,1,0,1,0,Currituck,2022-11-12
1,5,0,5,0,Currituck,2022-11-18
1,1,0,1,0,Currituck,2022-11-22
1,1,0,1,0,Currituck,2022-11-26
1,4,0,4,0,Currituck,2022-11-27
1,3,0,3,0,Currituck,2022-12-09
1,3,0,3,0,Currituck,2022-12-15
1,3,0,3,0,Currituck,2022-12-22
1,4,0,4,0,Currituck,2022-12-29
1,6,0,6,0,Currituck,2023-01-05
1,3,0,3,0,Currituck,2023-01-14
1,1,0,1,0,Currituck,2023-01-15
1,4,0,4,0,Currituck,2023-01-20
1,5,0,5,0,Currituck,2023-01-24
1,2,0,2,0,Currituck,2023-01-26
1,2,0,2,0,Currituck,2023-02-11
1,3,0,3,0,Currituck,2023-02-12
1,1,0,1,0,Currituck,2023-02-23
1,2,0,2,0,Currituck,2023-03-23
1,1,0,1,0,Currituck,2023-03-26
1,3,0,3,0,Currituck,2023-04-04
1,1,0,1,0,Currituck,2023-04-13
1,4,0,4,0,Dare,2022-11-09
1,4,0,4,0,Dare,2022-11-11
1,4,0,4,0,Dare,2022-11-16
1,5,0,5,0,Dare,2022-11-19
1,2,0,2,0,Dare,2022-11-20
1,1,0,1,0,Dare,2022-11-23
1,8,0,8,0,Dare,2022-11-27
1,7,0,7,0,Dare,2022-11-28
1,2,0,2,0,Dare,2022-12-01
1,2,0,2,0,Dare,2022-12-09
1,7,0,7,0,Dare,2022-12-23
1,1,0,1,0,Dare,2022-12-25
1,7,0,7,0,Dare,2022-12-26
1,7,0,7,0,Dare,2022-12-28
1,5,0,5,0,Dare,2023-01-07
1,2,0,2,0,Dare,2023-01-13
1,3,0,3,0,Dare,2023-01-16
1,6,0,6,0,Dare,2023-01-17
1,8,0,8,0,Dare,2023-01-25
1,3,0,3,0,Dare,2023-02-02
1,5,0,5,0,Dare,2023-02-04
1,3,0,3,0,Dare,2023-02-07
1,5,0,5,0,Dare,2023-02-13
1,5,0,5,0,Dare,2023-02-18
1,1,0,1,0,Dare,2023-02-19
1,2,0,2,0,Dare,2023-03-07
1,1,0,1,0,Dare,2023-03-19
1,2,0,2,0,Dare,2023-03-20
1,4,0,4,0,Dare,2023-03-22
1,1,0,1,0,Dare,2023-03-27
1,2,0,2,0,Dare,2023-03-29
1,2,0,2,0,Dare,2023-04-05
1,1,0,1,0,Dare,2023-04-08
1,1,0,1,0,Dare,2023-04-26
1,7,0,7,0,Davidson,2022-11-13
1,3,0,3,0,Davidson,2023-03-18
1,2,0,2,0,Davidson,2023-04-02
1,5,0,5,0,Davidson,2023-04-06
1,5,0,5,0,Davidson,2023-04-12
1,2,0,2,0,Davidson,2023-04-27
1,1,0,1,0,Davidson,2023-04-28
1,2,0,2,0,Davidson,2023-04-30
1,1,0,1,0,Davidson,2023-05-05
1,2,0,2,0,Davie,2022-11-12
1,2,0,2,0,Davie,2022-11-24
1,8,0,8,0,Davie,2022-12-31
1,4,0,4,0,Davie,2023-01-01
1,1,0,1,0,Davie,2023-03-14
1,3,0,3,0,Davie,2023-03-17
1,1,0,1,0,Davie,2023-03-31
1,1,0,1,0,Davie,2023-04-11
1,1,0,1,0,Davie,2023-04-13
1,3,0,3,0,Davie,2023-04-20
1,5,0,5,0,Duplin,2022-11-09
1,4,0,4,0,Duplin,2022-12-17
1,3,0,3,0,Duplin,2023-02-18
1,1,0,1,0,Duplin,2023-03-15
1,1,0,1,0,Duplin,2023-03-22
1,1,0,1,0,Duplin,2023-03-28
1,3,0,3,0,Duplin,2023-03-29
1,1,0,1,0,Duplin,2023-04-04
1,1,0,1,0,Duplin,2023-04-11
1,1,0,1,0,Duplin,2023-04-16
1,2,0,2,0,Duplin,2023-04-18
1,7,0,7,0,Durham,2023-04-09
1,7,0,7,0,Durham,2023-04-12
1,9,0,9,0,Durham,2023-04-20
1,3,0,3,0,Durham,2023-04-23
1,2,0,2,0,Edgecombe,2022-11-11
1,1,0,1,0,Edgecombe,2022-11-16
1,1,0,1,0,Edgecombe,2022-11-20
1,4,0,4,0,Edgecombe,2022-11-21
1,1,0,1,0,Edgecombe,2022-11-24
1,4,0,4,0,Edgecombe,2022-11-30
1,2,0,2,0,Edgecombe,2022-12-03
1,5,0,5,0,Edgecombe,2022-12-17
1,7,0,7,0,Edgecombe,2022-12-25
1,3,0,3,0,Edgecombe,2023-02-11
1,3,0,3,0,Edgecombe,2023-02-25
1,3,0,3,0,Edgecombe,2023-02-28
1,1,0,1,0,Edgecombe,2023-03-04
1,3,0,3,0,Edgecombe,2023-03-05
1,3,0,3,0,Edgecombe,2023-03-07
1,1,0,1,0,Edgecombe,2023-03-11
1,1,0,1,0,Edgecombe,2023-03-14
1,1,0,1,0,Edgecombe,2023-03-18
1,1,0,1,0,Edgecombe,2023-03-20
1,2,0,2,0,Edgecombe,2023-03-27
1,2,0,2,0,Edgecombe,2023-03-28
1,2,0,2,0,Edgecombe,2023-03-29
1,4,0,4,0,Edgecombe,2023-03-30
1,3,0,3,0,Edgecombe,2023-04-03
1,4,0,4,0,Edgecombe,2023-04-17
1,2,0,2,0,Edgecombe,2023-04-24
1,3,0,3,0,Edgecombe,2023-04-30
1,1,0,1,0,Edgecombe,2023-05-02
1,7,0,7,0,Franklin,2022-11-20
1,4,0,4,0,Franklin,2023-02-11
1,9,0,9,0,Franklin,2023-02-17
1,1,0,1,0,Franklin,2023-03-24
1,3,0,3,0,Franklin,2023-03-31
1,2,0,2,0,Franklin,2023-04-07
1,1,0,1,0,Franklin,2023-04-11
1,2,0,2,0,Franklin,2023-04-21
1,1,0,1,0,Franklin,2023-05-02
1,3,0,3,0,Gaston,2023-04-27
1,1,0,1,0,Gates,2022-12-06
1,2,0,2,0,Gates,2022-12-23
1,1,0,1,0,Gates,2023-01-18
1,2,0,2,0,Gates,2023-01-20
1,4,0,4,0,Gates,2023-02-03
1,2,0,2,0,Gates,2023-02-08
1,2,0,2,0,Gates,2023-03-29
1,1,0,1,0,Graham,2022-11-16
1,2,0,2,0,Graham,2022-12-25
1,1,0,1,0,Graham,2023-01-01
1,1,0,1,0,Graham,2023-02-28
1,5,0,5,0,Granville,2022-11-10
1,6,0,6,0,Granville,2022-11-15
1,4,0,4,0,Granville,2023-02-19
1,6,0,6,0,Granville,2023-02-26
1,4,0,4,0,Granville,2023-03-03
1,7,0,7,0,Granville,2023-03-09
1,1,0,1,0,Granville,2023-03-10
1,2,0,2,0,Granville,2023-03-11
1,3,0,3,0,Granville,2023-03-14
1,1,0,1,0,Granville,2023-03-17
1,6,0,6,0,Granville,2023-03-30
1,2,0,2,0,Granville,2023-04-02
1,4,0,4,0,Granville,2023-04-24
1,2,0,2,0,Granville,2023-04-26
1,1,0,1,0,Granville,2023-04-27
1,3,0,3,0,Greene,2022-11-21
1,3,0,3,0,Greene,2022-11-28
1,1,0,1,0,Greene,2022-11-29
1,3,0,3,0,Greene,2022-11-30
1,3,0,3,0,Greene,2022-12-24
1,5,0,5,0,Greene,2022-12-26
1,3,0,3,0,Greene,2023-01-01
1,8,0,8,0,Greene,2023-01-05
1,1,0,1,0,Greene,2023-01-07
1,8,0,8,0,Greene,2023-01-10
1,2,0,2,0,Greene,2023-01-15
1,4,0,4,0,Greene,2023-02-06
1,1,0,1,0,Greene,2023-02-10
1,3,0,3,0,Greene,2023-02-12
1,3,0,3,0,Greene,2023-02-16
1,5,0,5,0,Greene,2023-02-20
1,2,0,2,0,Greene,2023-02-28
1,3,0,3,0,Greene,2023-03-02
1,1,0,1,0,Greene,2023-03-03
1,1,0,1,0,Greene,2023-03-13
1,1,0,1,0,Greene,2023-03-20
1,1,0,1,0,Greene,2023-03-24
1,1,0,1,0,Greene,2023-03-25
1,1,0,1,0,Greene,2023-03-28
1,2,0,2,0,Greene,2023-04-12
1,1,0,1,0,Greene,2023-05-04
1,5,0,5,0,Halifax,2022-11-16
1,2,0,2,0,Halifax,2023-02-08
1,3,0,3,0,Halifax,2023-02-17
1,2,0,2,0,Halifax,2023-02-19
1,2,0,2,0,Halifax,2023-02-24
1,1,0,1,0,Halifax,2023-03-19
1,3,0,3,0,Halifax,2023-03-26
1,1,0,1,0,Halifax,2023-03-28
1,3,0,3,0,Harnett,2022-11-12
1,7,0,7,0,Harnett,2023-02-12
1,4,0,4,0,Harnett,2023-03-05
1,2,0,2,0,Harnett,2023-04-19
1,5,0,5,0,Harnett,2023-04-21
1,1,0,1,0,Harnett,2023-04-24
1,1,0,1,0,Harnett,2023-04-28
1,6,0,6,0,Harnett,2023-05-01
1,1,0,1,0,Harnett,2023-05-05
1,3,0,3,0,Haywood,2022-12-02
1,7,0,7,0,Haywood,2023-02-05
1,2,0,2,0,Haywood,2023-02-25
1,2,0,2,0,Haywood,2023-03-31
1,2,0,2,0,Haywood,2023-04-07
1,4,0,4,0,Henderson,2023-03-06
1,3,0,3,0,Henderson,2023-03-29
1,4,0,4,0,Henderson,2023-04-01
1,2,0,2,0,Hertford,2022-11-20
1,1,0,1,0,Hertford,2022-11-30
1,1,0,1,0,Hertford,2022-12-04
1,2,0,2,0,Hertford,2023-01-22
1,4,0,4,0,Hertford,2023-01-26
1,3,0,3,0,Hertford,2023-01-28
1,3,0,3,0,Hertford,2023-02-08
1,1,0,1,0,Hertford,2023-02-14
1,1,0,1,0,Hertford,2023-02-26
1,3,0,3,0,Hertford,2023-03-15
1,1,0,1,0,Hertford,2023-03-22
1,2,0,2,0,Hertford,2023-03-31
1,2,0,2,0,Hoke,2022-11-19
1,3,0,3,0,Hoke,2022-11-27
1,4,0,4,0,Hoke,2022-12-04
1,6,0,6,0,Hoke,2023-01-22
1,9,0,9,0,Hoke,2023-01-25
1,2,0,2,0,Hoke,2023-02-23
1,3,0,3,0,Hoke,2023-02-25
1,3,0,3,0,Hoke,2023-03-19
1,2,0,2,0,Hoke,2023-03-30
1,2,0,2,0,Hoke,2023-04-17
1,1,0,1,0,Hoke,2023-04-18
1,1,0,1,0,Hoke,2023-04-20
1,1,0,1,0,Hoke,2023-04-25
1,2,0,2,0,Hoke,2023-04-28
1,1,0,1,0,Hyde,2022-12-02
1,3,0,3,0,Hyde,2022-12-12
1,1,0,1,0,Hyde,2022-12-15
1,3,0,3,0,Hyde,2023-01-06
1,2,0,2,0,Hyde,2023-01-08
1,2,0,2,0,Hyde,2023-01-11
1,1,0,1,0,Hyde,2023-01-14
1,2,0,2,0,Hyde,2023-01-18
1,4,0,4,0,Hyde,2023-01-29
1,3,0,3,0,Hyde,2023-01-30
1,1,0,1,0,Hyde,2023-02-25
1,1,0,1,0,Hyde,2023-02-26
1,2,0,2,0,Hyde,2023-03-04
1,3,0,3,0,Hyde,2023-04-12
1,1,0,1,0,Iredell,2023-04-29
1,3,0,3,0,Jackson,2022-11-12
1,3,0,3,0,Jackson,2022-11-19
1,4,0,4,0,Jackson,2022-11-27
1,2,0,2,0,Jackson,2022-12-04
1,2,0,2,0,Jackson,2022-12-09
1,2,0,2,0,Jackson,2023-01-22
1,2,0,2,0,Jackson,2023-02-19
1,1,0,1,0,Jackson,2023-03-31
1,1,0,1,0,Jackson,2023-04-01
1,1,0,1,0,Jackson,2023-05-02
1,2,0,2,0,Johnston,2023-04-09
1,2,0,2,0,Johnston,2023-04-22
1,9,0,9,0,Johnston,2023-04-28
1,2,0,2,0,Jones,2022-12-31
1,3,0,3,0,Jones,2023-01-01
1,1,0,1,0,Jones,2023-01-07
1,1,0,1,0,Jones,2023-01-10
1,1,0,1,0,Jones,2023-01-16
1,1,0,1,0,Jones,2023-01-18
1,3,0,3,0,Jones,2023-01-24
1,1,0,1,0,Jones,2023-01-25
1,1,0,1,0,Jones,2023-02-04
1,1,0,1,0,Jones,2023-02-11
1,1,0,1,0,Jones,2023-02-17
1,1,0,1,0,Jones,2023-03-06
1,1,0,1,0,Jones,2023-03-16
1,1,0,1,0,Jones,2023-03-31
1,1,0,1,0,Jones,2023-05-01
1,3,0,3,0,Lee,2022-11-12
1,5,0,5,0,Lee,2022-11-18
1,2,0,2,0,Lee,2022-11-22
1,2,0,2,0,Lee,2023-01-14
1,5,0,5,0,Lee,2023-01-19
1,4,0,4,0,Lee,2023-03-02
1,3,0,3,0,Lee,2023-03-08
1,2,0,2,0,Lee,2023-03-12
1,5,0,5,0,Lee,2023-03-23
1,2,0,2,0,Lee,2023-04-04
1,3,0,3,0,Lee,2023-04-12
1,1,0,1,0,Lee,2023-04-15
1,1,0,1,0,Lee,2023-04-22
1,1,0,1,0,Lee,2023-04-24
1,4,0,4,0,Lenoir,2022-11-08
1,2,0,2,0,Lenoir,2022-11-19
1,3,0,3,0,Lenoir,2022-11-23
1,5,0,5,0,Lenoir,2022-11-26
1,3,0,3,0,Lenoir,2022-12-25
1,2,0,2,0,Lenoir,2023-01-07
1,2,0,2,0,Lenoir,2023-02-26
1,2,0,2,0,Lenoir,2023-03-04
1,4,0,4,0,Lenoir,2023-03-08
1,4,0,4,0,Lenoir,2023-03-14
1,2,0,2,0,Lenoir,2023-03-23
1,2,0,2,0,Lenoir,2023-03-29
1,2,0,2,0,Lenoir,2023-04-02
1,1,0,1,0,Lenoir,2023-04-05
1,2,0,2,0,Lenoir,2023-04-28
1,10,0,10,0,Lincoln,2022-11-08
1,4,0,4,0,Lincoln,2022-11-09
1,3,0,3,0,Lincoln,2022-11-16
1,8,0,8,0,Lincoln,2022-11-27
1,5,0,5,0,Lincoln,2023-01-08
1,5,0,5,0,Lincoln,2023-02-18
1,5,0,5,0,Lincoln,2023-03-09
1,5,0,5,0,Lincoln,2023-03-10
1,6,0,6,0,Lincoln,2023-03-14
1,3,0,3,0,Lincoln,2023-03-15
1,2,0,2,0,Lincoln,2023-03-19
1,3,0,3,0,Lincoln,2023-03-20
1,3,0,3,0,Lincoln,2023-03-26
1,1,0,1,0,Lincoln,2023-03-30
1,3,0,3,0,Lincoln,2023-04-04
1,5,0,5,0,Lincoln,2023-04-12
1,2,0,2,0,Lincoln,2023-04-16
1,3,0,3,0,Lincoln,2023-04-19
1,2,0,2,0,Lincoln,2023-04-27
1,4,0,4,0,Lincoln,2023-05-04
1,3,0,3,0,Lincoln,2023-05-05
1,1,0,1,0,Macon,2022-11-12
1,5,0,5,0,Macon,2022-11-14
1,3,0,3,0,Macon,2022-12-01
1,4,0,4,0,Macon,2022-12-02
1,6,0,6,0,Macon,2022-12-10
1,9,0,9,0,Macon,2022-12-26
1,2,0,2,0,Macon,2023-01-13
1,1,0,1,0,Macon,2023-01-22
1,2,0,2,0,Macon,2023-01-29
1,2,0,2,0,Macon,2023-02-03
1,3,0,3,0,Macon,2023-02-04
1,2,0,2,0,Macon,2023-02-07
1,4,0,4,0,Macon,2023-02-12
1,4,0,4,0,Macon,2023-02-26
1,3,0,3,0,Macon,2023-02-27
1,1,0,1,0,Macon,2023-03-04
1,2,0,2,0,Macon,2023-03-21
1,2,0,2,0,Macon,2023-03-28
1,1,0,1,0,Macon,2023-04-18
1,1,0,1,0,Madison,2022-11-23
1,2,0,2,0,Madison,2022-12-14
1,2,0,2,0,Madison,2022-12-29
1,3,0,3,0,Madison,2023-02-07
1,3,0,3,0,Madison,2023-02-17
1,2,0,2,0,Madison,2023-03-04
1,1,0,1,0,Madison,2023-03-08
1,2,0,2,0,Martin,2022-11-15
1,3,0,3,0,Martin,2022-11-29
1,1,0,1,0,Martin,2022-12-09
1,1,0,1,0,Martin,2022-12-12
1,3,0,3,0,Martin,2022-12-14
1,1,0,1,0,Martin,2022-12-16
1,4,0,4,0,Martin,2022-12-22
1,1,0,1,0,Martin,2022-12-23
1,2,0,2,0,Martin,2022-12-29
1,2,0,2,0,Martin,2023-01-03
1,3,0,3,0,Martin,2023-01-14
1,1,0,1,0,Martin,2023-01-15
1,5,0,5,0,Martin,2023-01-17
1,5,0,5,0,Martin,2023-01-18
1,3,0,3,0,Martin,2023-01-26
1,1,0,1,0,Martin,2023-01-27
1,2,0,2,0,Martin,2023-02-01
1,2,0,2,0,Martin,2023-02-02
1,4,0,4,0,Martin,2023-02-03
1,3,0,3,0,Martin,2023-02-07
1,3,0,3,0,Martin,2023-02-08
1,1,0,1,0,Martin,2023-02-10
1,2,0,2,0,Martin,2023-02-13
1,1,0,1,0,Martin,2023-02-16
1,1,0,1,0,Martin,2023-02-22
1,2,0,2,0,Martin,2023-02-23
1,2,0,2,0,Martin,2023-02-28
1,2,0,2,0,Martin,2023-03-31
1,1,0,1,0,Martin,2023-05-01
1,3,0,3,0,McDowell,2022-11-11
1,6,0,6,0,McDowell,2022-11-26
1,6,0,6,0,McDowell,2023-01-14
1,5,0,5,0,McDowell,2023-02-04
1,2,0,2,0,McDowell,2023-03-17
1,2,0,2,0,McDowell,2023-03-19
1,2,0,2,0,McDowell,2023-03-31
1,3,0,3,0,McDowell,2023-04-07
1,2,0,2,0,McDowell,2023-04-10
1,1,0,1,0,McDowell,2023-04-22
1,1,0,1,0,Mitchell,2023-01-07
1,2,0,2,0,Mitchell,2023-01-19
1,1,0,1,0,Mitchell,2023-03-06
1,1,0,1,0,Mitchell,2023-04-04
1,1,0,1,0,Mitchell,2023-04-22
1,3,0,3,0,Montgomery,2022-11-28
1,2,0,2,0,Montgomery,2022-12-11
1,3,0,3,0,Montgomery,2023-02-19
1,1,0,1,0,Montgomery,2023-04-20
1,1,0,1,0,Montgomery,2023-05-03
1,4,0,4,0,Moore,2022-11-13
1,6,0,6,0,Moore,2023-02-04
1,5,0,5,0,Moore,2023-03-04
1,5,0,5,0,Moore,2023-03-06
1,1,0,1,0,Moore,2023-04-06
1,4,0,4,0,Moore,2023-04-13
1,2,0,2,0,Moore,2023-04-16
1,1,0,1,0,Moore,2023-04-29
1,1,0,1,0,Moore,2023-05-02
1,1,0,1,0,Moore,2023-05-04
1,8,0,8,0,Nash,2022-11-27
1,10,0,10,0,Nash,2022-11-29
1,2,0,2,0,Nash,2023-02-12
1,4,0,4,0,Nash,2023-03-19
1,2,0,2,0,Nash,2023-03-26
1,2,0,2,0,Nash,2023-03-29
1,3,0,3,0,Nash,2023-04-08
1,2,0,2,0,Nash,2023-04-13
1,1,0,1,0,Nash,2023-04-16
1,1,0,1,0,Nash,2023-04-30
1,3,0,3,0,Nash,2023-05-02
1,1,0,1,0,Nash,2023-05-03
1,4,0,4,0,New Hanover,2022-11-13
1,10,0,10,0,New Hanover,2022-11-18
1,3,0,3,0,New Hanover,2023-04-26
1,1,0,1,0,New Hanover,2023-05-06
1,2,0,2,0,Northampton,2022-11-09
1,2,0,2,0,Northampton,2022-11-15
1,2,0,2,0,Northampton,2022-11-17
1,2,0,2,0,Northampton,2022-11-25
1,5,0,5,0,Northampton,2022-12-19
1,3,0,3,0,Northampton,2022-12-23
1,2,0,2,0,Northampton,2022-12-24
1,3,0,3,0,Northampton,2022-12-31
1,1,0,1,0,Northampton,2023-01-01
1,5,0,5,0,Northampton,2023-01-16
1,1,0,1,0,Northampton,2023-01-26
1,3,0,3,0,Northampton,2023-01-28
1,3,0,3,0,Northampton,2023-01-29
1,5,0,5,0,Northampton,2023-02-21
1,2,0,2,0,Northampton,2023-02-23
1,2,0,2,0,Northampton,2023-03-02
1,1,0,1,0,Northampton,2023-03-10
1,1,0,1,0,Northampton,2023-03-11
1,1,0,1,0,Northampton,2023-03-14
1,5,0,5,0,Onslow,2022-11-17
1,6,0,6,0,Onslow,2023-02-05
1,5,0,5,0,Onslow,2023-02-12
1,2,0,2,0,Onslow,2023-03-04
1,11,0,11,0,Onslow,2023-03-21
1,8,0,8,0,Onslow,2023-03-25
1,9,0,9,0,Onslow,2023-04-02
1,5,0,5,0,Onslow,2023-04-06
1,4,0,4,0,Onslow,2023-04-12
1,5,0,5,0,Onslow,2023-04-20
1,5,0,5,0,Onslow,2023-04-21
1,5,0,5,0,Onslow,2023-04-25
1,2,0,2,0,Onslow,2023-04-28
1,3,0,3,0,Onslow,2023-04-30
1,4,0,4,0,Onslow,2023-05-02
1,12,0,12,0,Orange,2022-11-11
1,8,0,8,0,Orange,2022-11-17
1,16,0,16,0,Orange,2022-11-22
1,4,0,4,0,Orange,2023-02-26
1,2,0,2,0,Orange,2023-04-04
1,3,0,3,0,Orange,2023-04-12
1,6,0,6,0,Orange,2023-04-19
1,4,0,4,0,Orange,2023-04-25
1,6,0,6,0,Orange,2023-04-27
1,5,0,5,0,Orange,2023-05-02
1,7,0,7,0,Orange,2023-05-03
1,1,0,1,0,Pamlico,2022-11-16
1,2,0,2,0,Pamlico,2022-11-17
1,1,0,1,0,Pamlico,2022-12-09
1,2,0,2,0,Pamlico,2023-01-01
1,8,0,8,0,Pamlico,2023-01-02
1,2,0,2,0,Pamlico,2023-01-18
1,1,0,1,0,Pamlico,2023-04-17
1,2,0,2,0,Pamlico,2023-04-26
1,1,0,1,0,Pamlico,2023-04-27
1,3,0,3,0,Pasquotank,2022-11-08
1,4,0,4,0,Pasquotank,2022-11-11
1,3,0,3,0,Pasquotank,2023-01-12
1,1,0,1,0,Pasquotank,2023-02-16
1,1,0,1,0,Pasquotank,2023-03-10
1,1,0,1,0,Pasquotank,2023-03-11
1,2,0,2,0,Pasquotank,2023-03-22
1,1,0,1,0,Pasquotank,2023-04-19
1,5,0,5,0,Pender,2022-11-14
1,1,0,1,0,Pender,2022-11-17
1,4,0,4,0,Pender,2022-11-22
1,1,0,1,0,Pender,2022-11-24
1,3,0,3,0,Pender,2022-11-27
1,4,0,4,0,Pender,2022-11-28
1,6,0,6,0,Pender,2022-11-29
1,8,0,8,0,Pender,2022-12-21
1,12,0,12,0,Pender,2022-12-26
1,5,0,5,0,Pender,2023-01-07
1,2,0,2,0,Pender,2023-02-03
1,3,0,3,0,Pender,2023-02-12
1,2,0,2,0,Pender,2023-02-23
1,2,0,2,0,Pender,2023-02-24
1,1,0,1,0,Pender,2023-03-05
1,4,0,4,0,Pender,2023-03-06
1,4,0,4,0,Pender,2023-03-09
1,1,0,1,0,Pender,2023-03-12
1,2,0,2,0,Pender,2023-03-13
1,1,0,1,0,Pender,2023-03-15
1,2,0,2,0,Pender,2023-03-22
1,2,0,2,0,Pender,2023-03-25
1,1,0,1,0,Pender,2023-05-01
1,2,0,2,0,Pender,2023-05-06
1,2,0,2,0,Perquimans,2022-11-10
1,1,0,1,0,Perquimans,2022-11-21
1,3,0,3,0,Perquimans,2022-11-28
1,3,0,3,0,Perquimans,2022-12-06
1,2,0,2,0,Perquimans,2022-12-12
1,3,0,3,0,Perquimans,2023-01-13
1,3,0,3,0,Perquimans,2023-01-18
1,3,0,3,0,Perquimans,2023-01-20
1,2,0,2,0,Perquimans,2023-01-30
1,1,0,1,0,Perquimans,2023-02-08
1,2,0,2,0,Perquimans,2023-02-24
1,2,0,2,0,Perquimans,2023-03-09
1,1,0,1,0,Perquimans,2023-03-13
1,2,0,2,0,Perquimans,2023-04-05
1,1,0,1,0,Person,2022-11-08
1,1,0,1,0,Person,2022-11-12
1,3,0,3,0,Person,2022-11-22
1,2,0,2,0,Person,2022-12-08
1,2,0,2,0,Person,2022-12-17
1,5,0,5,0,Person,2023-01-05
1,5,0,5,0,Person,2023-01-19
1,2,0,2,0,Person,2023-02-02
1,4,0,4,0,Person,2023-02-08
1,4,0,4,0,Person,2023-02-14
1,1,0,1,0,Person,2023-02-19
1,5,0,5,0,Person,2023-02-28
1,3,0,3,0,Person,2023-03-21
1,1,0,1,0,Person,2023-03-22
1,2,0,2,0,Person,2023-03-27
1,3,0,3,0,Person,2023-03-28
1,1,0,1,0,Person,2023-04-12
1,3,0,3,0,Pitt,2022-11-24
1,6,0,6,0,Pitt,2023-03-18
1,2,0,2,0,Pitt,2023-04-01
1,1,0,1,0,Pitt,2023-04-09
1,8,0,8,0,Pitt,2023-04-10
1,1,0,1,0,Pitt,2023-04-16
1,3,0,3,0,Pitt,2023-04-30
1,1,0,1,0,Polk,2023-02-15
1,1,0,1,0,Polk,2023-03-24
1,1,0,1,0,Polk,2023-03-28
1,1,0,1,0,Polk,2023-03-29
1,6,0,6,0,Randolph,2022-11-24
1,2,0,2,0,Randolph,2023-04-21
1,1,0,1,0,Randolph,2023-04-23
1,1,0,1,0,Randolph,2023-04-25
1,2,0,2,0,Randolph,2023-04-27
1,1,0,1,0,Richmond,2022-11-19
1,2,0,2,0,Richmond,2022-12-01
1,9,0,9,0,Richmond,2022-12-30
1,10,0,10,0,Richmond,2023-02-17
1,2,0,2,0,Richmond,2023-02-23
1,4,0,4,0,Richmond,2023-03-02
1,6,0,6,0,Richmond,2023-03-10
1,4,0,4,0,Richmond,2023-03-13
1,1,0,1,0,Richmond,2023-03-26
1,2,0,2,0,Richmond,2023-04-06
1,2,0,2,0,Richmond,2023-04-12
1,1,0,1,0,Richmond,2023-04-19
1,2,0,2,0,Richmond,2023-05-04
1,6,0,6,0,Robeson,2022-11-13
1,2,0,2,0,Robeson,2022-11-24
1,1,0,1,0,Robeson,2023-04-09
1,2,0,2,0,Robeson,2023-04-23
1,3,0,3,0,Rockingham,2022-11-20
1,4,0,4,0,Rockingham,2023-03-28
1,6,0,6,0,Rockingham,2023-03-29
1,2,0,2,0,Rockingham,2023-04-29
1,6,0,6,0,Rowan,2022-11-19
1,5,0,5,0,Rowan,2023-03-12
1,7,0,7,0,Rowan,2023-03-24
1,2,0,2,0,Rowan,2023-04-08
1,10,0,10,0,Rowan,2023-04-11
1,2,0,2,0,Rowan,2023-04-24
1,3,0,3,0,Rowan,2023-05-06
1,3,0,3,0,Rutherford,2023-02-07
1,2,0,2,0,Rutherford,2023-03-02
1,3,0,3,0,Rutherford,2023-03-12
1,1,0,1,0,Rutherford,2023-03-18
1,5,0,5,0,Rutherford,2023-03-20
1,1,0,1,0,Rutherford,2023-04-02
1,2,0,2,0,Rutherford,2023-04-14
1,1,0,1,0,Rutherford,2023-04-16
1,1,0,1,0,Rutherford,2023-05-06
1,2,0,2,0,Sampson,2023-03-25
1,2,0,2,0,Sampson,2023-03-31
1,3,0,3,0,Sampson,2023-04-07
1,2,0,2,0,Scotland,2022-11-09
1,1,0,1,0,Scotland,2022-11-11
1,1,0,1,0,Scotland,2023-03-07
1,4,0,4,0,Stanly,2022-11-12
1,6,0,6,0,Stanly,2022-11-17
1,8,0,8,0,Stanly,2022-11-25
1,16,0,16,0,Stanly,2022-11-30
1,11,0,11,0,Stanly,2022-12-14
1,11,0,11,0,Stanly,2023-02-19
1,5,0,5,0,Stanly,2023-02-25
1,3,0,3,0,Stanly,2023-03-02
1,3,0,3,0,Stanly,2023-03-08
1,3,0,3,0,Stanly,2023-03-19
1,5,0,5,0,Stanly,2023-03-20
1,3,0,3,0,Stanly,2023-03-23
1,3,0,3,0,Stanly,2023-03-25
1,2,0,2,0,Stanly,2023-03-28
1,4,0,4,0,Stanly,2023-03-29
1,2,0,2,0,Stanly,2023-04-02
1,2,0,2,0,Stanly,2023-04-05
1,1,0,1,0,Stanly,2023-04-09
1,2,0,2,0,Stanly,2023-04-15
1,2,0,2,0,Stanly,2023-04-18
1,2,0,2,0,Stanly,2023-04-19
1,3,0,3,0,Stanly,2023-04-24
1,3,0,3,0,Stanly,2023-05-04
1,3,0,3,0,Stokes,2023-03-06
1,4,0,4,0,Stokes,2023-03-09
1,3,0,3,0,Stokes,2023-03-11
1,1,0,1,0,Stokes,2023-03-12
1,3,0,3,0,Stokes,2023-03-13
1,2,0,2,0,Stokes,2023-03-28
1,3,0,3,0,Stokes,2023-04-11
1,1,0,1,0,Stokes,2023-04-13
1,1,0,1,0,Stokes,2023-04-30
1,3,0,3,0,Stokes,2023-05-02
1,1,0,1,0,Stokes,2023-05-03
1,4,0,4,0,Surry,2022-11-12
1,9,0,9,0,Surry,2022-11-13
1,4,0,4,0,Surry,2023-02-19
1,3,0,3,0,Surry,2023-02-26
1,4,0,4,0,Surry,2023-03-12
1,5,0,5,0,Surry,2023-03-13
1,1,0,1,0,Surry,2023-03-17
1,6,0,6,0,Surry,2023-04-01
1,1,0,1,0,Surry,2023-04-02
1,2,0,2,0,Surry,2023-04-20
1,2,0,2,0,Surry,2023-04-24
1,1,0,1,0,Surry,2023-04-28
1,3,0,3,0,Swain,2022-11-25
1,4,0,4,0,Swain,2022-11-26
1,3,0,3,0,Swain,2023-03-13
1,2,0,2,0,Swain,2023-03-23
1,1,0,1,0,Swain,2023-04-13
1,1,0,1,0,Swain,2023-04-23
1,2,0,2,0,Transylvania,2022-11-22
1,2,0,2,0,Transylvania,2022-11-27
1,4,0,4,0,Transylvania,2022-12-03
1,7,0,7,0,Transylvania,2022-12-30
1,4,0,4,0,Transylvania,2023-01-15
1,4,0,4,0,Transylvania,2023-01-23
1,4,0,4,0,Transylvania,2023-01-24
1,5,0,5,0,Transylvania,2023-02-01
1,1,0,1,0,Transylvania,2023-02-12
1,2,0,2,0,Transylvania,2023-02-16
1,1,0,1,0,Transylvania,2023-02-18
1,1,0,1,0,Transylvania,2023-02-25
1,2,0,2,0,Transylvania,2023-03-18
1,3,0,3,0,Transylvania,2023-04-02
1,1,0,1,0,Transylvania,2023-04-03
1,1,0,1,0,Transylvania,2023-04-21
1,3,0,3,0,Tyrrell,2022-12-13
1,1,0,1,0,Tyrrell,2022-12-21
1,1,0,1,0,Tyrrell,2023-02-06
1,1,0,1,0,Tyrrell,2023-03-23
1,1,0,1,0,Tyrrell,2023-03-30
1,1,0,1,0,Tyrrell,2023-04-03
1,6,0,6,0,Union,2023-03-18
1,6,0,6,0,Union,2023-04-21
1,4,0,4,0,Vance,2022-11-28
1,6,0,6,0,Vance,2023-01-29
1,2,0,2,0,Vance,2023-03-11
1,3,0,3,0,Vance,2023-03-27
1,1,0,1,0,Vance,2023-03-31
1,3,0,3,0,Vance,2023-04-05
1,1,0,1,0,Vance,2023-04-20
1,2,0,2,0,Vance,2023-04-22
1,5,0,5,0,Warren,2022-11-14
1,1,0,1,0,Warren,2022-11-19
1,5,0,5,0,Warren,2022-12-09
1,3,0,3,0,Warren,2023-01-22
1,1,0,1,0,Warren,2023-01-29
1,1,0,1,0,Warren,2023-02-11
1,1,0,1,0,Warren,2023-02-19
1,1,0,1,0,Warren,2023-03-05
1,1,0,1,0,Warren,2023-03-10
1,1,0,1,0,Warren,2023-03-29
1,1,0,1,0,Washington,2022-11-23
1,1,0,1,0,Washington,2022-11-26
1,2,0,2,0,Washington,2022-11-27
1,1,0,1,0,Washington,2022-12-03
1,2,0,2,0,Washington,2022-12-06
1,2,0,2,0,Washington,2022-12-07
1,2,0,2,0,Washington,2022-12-16
1,2,0,2,0,Washington,2022-12-19
1,3,0,3,0,Washington,2022-12-23
1,3,0,3,0,Washington,2023-01-09
1,2,0,2,0,Washington,2023-01-27
1,1,0,1,0,Washington,2023-02-12
1,2,0,2,0,Washington,2023-03-13
1,1,0,1,0,Washington,2023-03-19
1,1,0,1,0,Washington,2023-04-04
1,10,0,10,0,Watauga,2022-11-30
1,1,0,1,0,Watauga,2023-01-13
1,4,0,4,0,Watauga,2023-01-29
1,11,0,11,0,Watauga,2023-01-31
1,4,0,4,0,Watauga,2023-02-05
1,7,0,7,0,Watauga,2023-02-16
1,3,0,3,0,Watauga,2023-03-07
1,3,0,3,0,Watauga,2023-04-05
1,3,0,3,0,Watauga,2023-04-21
1,2,0,2,0,Watauga,2023-04-30
1,2,0,2,0,Wayne,2023-03-11
1,2,0,2,0,Wayne,2023-04-26
1,1,0,1,0,Wayne,2023-04-29
1,1,0,1,0,Wayne,2023-05-01
1,3,0,3,0,Wilkes,2023-03-10
1,2,0,2,0,Wilkes,2023-04-01
1,3,0,3,0,Wilkes,2023-04-02
1,3,0,3,0,Wilkes,2023-04-05
1,2,0,2,0,Wilkes,2023-04-09
1,1,0,1,0,Wilkes,2023-04-29
1,10,0,10,0,Wilson,2023-01-21
1,7,0,7,0,Wilson,2023-02-12
1,3,0,3,0,Wilson,2023-03-09
1,4,0,4,0,Yadkin,2022-11-12
1,10,0,10,0,Yadkin,2023-01-01
1,4,0,4,0,Yadkin,2023-01-20
1,5,0,5,0,Yadkin,2023-01-27
1,3,0,3,0,Yadkin,2023-01-29
1,2,0,2,0,Yadkin,2023-02-24
1,2,0,2,0,Yadkin,2023-02-25
1,1,0,1,0,Yadkin,2023-02-26
1,5,0,5,0,Yadkin,2023-03-01
1,1,0,1,0,Yadkin,2023-03-05
1,4,0,4,0,Yadkin,2023-03-12
1,2,0,2,0,Yadkin,2023-03-15
1,4,0,4,0,Yadkin,2023-03-17
1,1,0,1,0,Yadkin,2023-03-19
1,1,0,1,0,Yadkin,2023-03-22
1,3,0,3,0,Yadkin,2023-03-28
1,3,0,3,0,Yadkin,2023-03-31
1,4,0,4,0,Yadkin,2023-04-12
1,3,0,3,0,Yadkin,2023-04-14
1,1,0,1,0,Yadkin,2023-04-21
1,1,0,1,0,Yadkin,2023-04-23
1,2,0,2,0,Yadkin,2023-04-25
1,1,0,1,0,Yadkin,2023-04-26
1,1,0,1,0,Yadkin,2023-05-02
1,4,0,4,0,Yadkin,2023-05-03
1,5,0,5,0,Yadkin,2023-05-04
1,1,0,1,0,Yancey,2022-11-17
1,2,0,2,0,Yancey,2022-11-18
1,1,0,1,0,Yancey,2022-11-24
1,1,0,1,0,Yancey,2022-12-18
1,1,0,1,0,Yancey,2022-12-26
1,2,0,2,0,Yancey,2023-01-23
1,1,0,1,0,Yancey,2023-02-12
1,1,0,1,0,Yancey,2023-03-10
1,15,1,14,0,Alamance,2022-11-16
1,3,1,2,0,Alamance,2023-03-25
1,5,1,4,0,Alamance,2023-04-03
1,6,1,5,0,Alamance,2023-04-20
1,8,1,7,0,Alamance,2023-04-27
1,4,1,3,0,Alexander,2022-11-25
1,9,1,8,0,Alexander,2022-11-30
1,4,1,3,0,Alexander,2022-12-01
1,3,1,2,0,Alexander,2022-12-03
1,4,1,3,0,Alexander,2022-12-17
1,3,1,2,0,Alexander,2023-02-15
1,2,1,1,0,Alexander,2023-02-28
1,2,1,1,0,Alexander,2023-03-09
1,1,1,0,0,Alexander,2023-03-15
1,3,1,2,0,Alexander,2023-03-20
1,2,1,1,0,Alexander,2023-04-10
1,1,1,0,0,Alexander,2023-04-11
1,2,1,1,0,Alexander,2023-04-14
1,1,1,0,0,Alexander,2023-04-21
1,2,1,1,0,Alexander,2023-04-27
1,1,1,0,0,Alleghany,2022-11-10
1,1,1,0,0,Alleghany,2022-11-18
1,2,1,1,0,Alleghany,2022-12-03
1,2,1,1,0,Alleghany,2023-01-13
1,2,1,1,0,Alleghany,2023-01-16
1,3,1,2,0,Alleghany,2023-01-20
1,3,1,2,0,Alleghany,2023-02-02
1,4,1,3,0,Alleghany,2023-02-03
1,4,1,3,0,Alleghany,2023-02-27
1,2,1,1,0,Alleghany,2023-03-20
1,4,1,3,0,Alleghany,2023-03-21
1,1,1,0,0,Alleghany,2023-04-03
1,1,1,0,0,Alleghany,2023-04-05
1,3,1,2,0,Anson,2022-11-09
1,3,1,2,0,Anson,2022-11-18
1,4,1,3,0,Anson,2022-12-07
1,5,1,4,0,Anson,2023-01-12
1,4,1,3,0,Anson,2023-01-13
1,3,1,2,0,Anson,2023-02-24
1,1,1,0,0,Anson,2023-03-10
1,2,1,1,0,Anson,2023-03-20
1,2,1,1,0,Anson,2023-04-07
1,7,1,6,0,Anson,2023-04-14
1,2,1,1,0,Anson,2023-04-28
1,2,1,1,0,Anson,2023-05-05
1,3,1,2,0,Ashe,2022-12-15
1,4,1,3,0,Ashe,2022-12-20
1,1,1,0,0,Ashe,2022-12-23
1,6,1,5,0,Ashe,2023-01-05
1,5,1,4,0,Ashe,2023-01-06
1,3,1,2,0,Ashe,2023-02-03
1,3,1,2,0,Ashe,2023-02-21
1,2,1,1,0,Ashe,2023-03-01
1,4,1,3,0,Ashe,2023-03-07
1,2,1,1,0,Ashe,2023-03-13
1,2,1,1,0,Ashe,2023-03-21
1,1,1,0,0,Ashe,2023-03-29
1,2,1,1,0,Ashe,2023-03-30
1,3,1,2,0,Ashe,2023-04-05
1,1,1,0,0,Ashe,2023-04-09
1,1,1,0,0,Ashe,2023-04-25
1,1,1,0,0,Avery,2022-11-10
1,1,1,0,0,Avery,2022-11-14
1,2,1,1,0,Avery,2023-01-07
1,1,1,0,0,Avery,2023-01-23
1,1,1,0,0,Avery,2023-03-15
1,2,1,1,0,Avery,2023-03-21
1,1,1,0,0,Avery,2023-04-05
1,2,1,1,0,Avery,2023-04-12
1,1,1,0,0,Avery,2023-04-13
1,3,1,2,0,Beaufort,2022-11-16
1,4,1,3,0,Beaufort,2022-11-21
1,6,1,5,0,Beaufort,2022-11-26
1,2,1,1,0,Beaufort,2022-12-03
1,4,1,3,0,Beaufort,2022-12-04
1,8,1,7,0,Beaufort,2022-12-10
1,6,1,5,0,Beaufort,2022-12-23
1,5,1,4,0,Beaufort,2023-02-08
1,3,1,2,0,Beaufort,2023-02-23
1,4,1,3,0,Beaufort,2023-03-22
1,3,1,2,0,Beaufort,2023-03-23
1,3,1,2,0,Beaufort,2023-04-10
1,3,1,2,0,Beaufort,2023-04-11
1,1,1,0,0,Beaufort,2023-04-27
1,3,1,2,0,Bertie,2022-11-09
1,4,1,3,0,Bertie,2022-11-14
1,1,1,0,0,Bertie,2022-11-26
1,4,1,3,0,Bertie,2022-11-29
1,6,1,5,0,Bertie,2022-12-08
1,3,1,2,0,Bertie,2022-12-09
1,3,1,2,0,Bertie,2022-12-15
1,4,1,3,0,Bertie,2022-12-26
1,4,1,3,0,Bertie,2023-01-05
1,2,1,1,0,Bertie,2023-01-29
1,8,1,7,0,Bertie,2023-02-13
1,3,1,2,0,Bertie,2023-02-17
1,2,1,1,0,Bertie,2023-04-12
1,3,1,2,0,Bladen,2022-11-11
1,2,1,1,0,Bladen,2022-11-22
1,2,1,1,0,Bladen,2022-11-25
1,2,1,1,0,Bladen,2022-11-30
1,8,1,7,0,Bladen,2023-01-16
1,6,1,5,0,Bladen,2023-01-27
1,6,1,5,0,Bladen,2023-02-18
1,4,1,3,0,Bladen,2023-02-27
1,1,1,0,0,Bladen,2023-03-09
1,1,1,0,0,Bladen,2023-03-25
1,2,1,1,0,Bladen,2023-04-03
1,1,1,0,0,Bladen,2023-04-05
1,5,1,4,0,Bladen,2023-04-25
1,2,1,1,0,Bladen,2023-04-26
1,1,1,0,0,Bladen,2023-05-06
1,7,1,6,0,Brunswick,2022-11-12
1,9,1,8,0,Brunswick,2022-11-13
1,5,1,4,0,Brunswick,2022-11-17
1,11,1,10,0,Brunswick,2023-02-24
1,10,1,9,0,Brunswick,2023-04-01
1,3,1,2,0,Brunswick,2023-04-02
1,5,1,4,0,Brunswick,2023-04-07
1,14,1,13,0,Brunswick,2023-04-10
1,5,1,4,0,Brunswick,2023-04-26
1,3,1,2,0,Brunswick,2023-04-28
1,3,1,2,0,Brunswick,2023-05-03
1,7,1,6,0,Brunswick,2023-05-04
1,8,1,7,0,Buncombe,2023-03-18
1,6,1,5,0,Burke,2022-11-12
1,3,1,2,0,Burke,2022-11-13
1,15,1,14,0,Burke,2022-11-21
1,6,1,5,0,Burke,2023-02-05
1,10,1,9,0,Burke,2023-02-11
1,4,1,3,0,Burke,2023-02-26
1,2,1,1,0,Burke,2023-04-04
1,1,1,0,0,Burke,2023-04-23
1,5,1,4,0,Burke,2023-04-28
1,3,1,2,0,Burke,2023-04-30
1,8,1,7,0,Cabarrus,2023-04-13
1,8,1,7,0,Cabarrus,2023-04-16
1,16,1,15,0,Caldwell,2022-11-08
1,5,1,4,0,Caldwell,2022-11-12
1,14,1,13,0,Caldwell,2023-01-01
1,5,1,4,0,Caldwell,2023-04-10
1,6,1,5,0,Caldwell,2023-04-12
1,3,1,2,0,Caldwell,2023-04-23
1,3,1,2,0,Caldwell,2023-05-03
1,2,1,1,0,Camden,2022-11-29
1,2,1,1,0,Camden,2022-12-14
1,2,1,1,0,Camden,2022-12-24
1,2,1,1,0,Camden,2022-12-27
1,2,1,1,0,Camden,2023-01-17
1,2,1,1,0,Camden,2023-01-26
1,1,1,0,0,Camden,2023-03-11
1,1,1,0,0,Camden,2023-03-24
1,1,1,0,0,Carteret,2022-11-21
1,3,1,2,0,Carteret,2022-11-30
1,3,1,2,0,Carteret,2022-12-03
1,3,1,2,0,Carteret,2022-12-11
1,6,1,5,0,Carteret,2023-01-08
1,6,1,5,0,Carteret,2023-02-11
1,6,1,5,0,Carteret,2023-03-02
1,2,1,1,0,Carteret,2023-03-04
1,2,1,1,0,Carteret,2023-03-07
1,2,1,1,0,Carteret,2023-03-14
1,2,1,1,0,Carteret,2023-04-15
1,1,1,0,0,Carteret,2023-04-20
1,3,1,2,0,Caswell,2022-12-14
1,4,1,3,0,Caswell,2022-12-23
1,3,1,2,0,Caswell,2022-12-24
1,3,1,2,0,Caswell,2023-01-01
1,5,1,4,0,Caswell,2023-01-13
1,4,1,3,0,Caswell,2023-01-18
1,2,1,1,0,Caswell,2023-01-26
1,6,1,5,0,Caswell,2023-02-10
1,1,1,0,0,Caswell,2023-02-20
1,2,1,1,0,Caswell,2023-03-05
1,3,1,2,0,Caswell,2023-03-14
1,4,1,3,0,Chatham,2022-11-17
1,6,1,5,0,Chatham,2023-01-01
1,8,1,7,0,Chatham,2023-01-29
1,9,1,8,0,Chatham,2023-02-10
1,3,1,2,0,Chatham,2023-02-11
1,8,1,7,0,Chatham,2023-02-12
1,2,1,1,0,Chatham,2023-03-17
1,3,1,2,0,Chatham,2023-03-24
1,5,1,4,0,Chatham,2023-04-13
1,3,1,2,0,Chatham,2023-04-15
1,2,1,1,0,Chatham,2023-04-23
1,5,1,4,0,Cherokee,2022-11-08
1,1,1,0,0,Cherokee,2022-11-11
1,6,1,5,0,Cherokee,2022-11-22
1,2,1,1,0,Cherokee,2022-11-30
1,3,1,2,0,Cherokee,2022-12-10
1,9,1,8,0,Cherokee,2022-12-12
1,5,1,4,0,Cherokee,2022-12-19
1,7,1,6,0,Cherokee,2022-12-21
1,5,1,4,0,Cherokee,2022-12-23
1,8,1,7,0,Cherokee,2022-12-26
1,6,1,5,0,Cherokee,2022-12-31
1,7,1,6,0,Cherokee,2023-01-20
1,5,1,4,0,Cherokee,2023-01-23
1,1,1,0,0,Cherokee,2023-03-29
1,3,1,2,0,Cherokee,2023-04-03
1,3,1,2,0,Chowan,2022-12-07
1,6,1,5,0,Chowan,2022-12-26
1,3,1,2,0,Chowan,2022-12-27
1,3,1,2,0,Chowan,2023-01-08
1,12,1,11,0,Chowan,2023-01-13
1,3,1,2,0,Chowan,2023-01-14
1,5,1,4,0,Chowan,2023-02-10
1,1,1,0,0,Chowan,2023-03-04
1,2,1,1,0,Chowan,2023-03-27
1,1,1,0,0,Clay,2022-11-22
1,2,1,1,0,Clay,2022-11-28
1,2,1,1,0,Clay,2023-02-16
1,1,1,0,0,Clay,2023-02-25
1,2,1,1,0,Clay,2023-03-21
1,1,1,0,0,Cleveland,2023-03-24
1,2,1,1,0,Cleveland,2023-03-31
1,3,1,2,0,Cleveland,2023-04-04
1,4,1,3,0,Cleveland,2023-04-05
1,1,1,0,0,Cleveland,2023-04-15
1,3,1,2,0,Cleveland,2023-05-04
1,3,1,2,0,Columbus,2022-11-19
1,6,1,5,0,Columbus,2022-12-09
1,9,1,8,0,Columbus,2022-12-23
1,8,1,7,0,Columbus,2023-01-14
1,9,1,8,0,Columbus,2023-01-20
1,2,1,1,0,Columbus,2023-01-22
1,2,1,1,0,Columbus,2023-03-27
1,1,1,0,0,Columbus,2023-04-11
1,1,1,0,0,Columbus,2023-04-18
1,2,1,1,0,Columbus,2023-05-03
1,3,1,2,0,Craven,2022-11-20
1,8,1,7,0,Craven,2023-01-29
1,8,1,7,0,Craven,2023-02-05
1,3,1,2,0,Craven,2023-02-28
1,2,1,1,0,Craven,2023-03-10
1,3,1,2,0,Craven,2023-03-18
1,2,1,1,0,Craven,2023-03-19
1,4,1,3,0,Cumberland,2023-04-14
1,1,1,0,0,Cumberland,2023-04-23
1,4,1,3,0,Currituck,2022-12-08
1,7,1,6,0,Currituck,2022-12-27
1,3,1,2,0,Currituck,2023-01-09
1,2,1,1,0,Currituck,2023-02-04
1,3,1,2,0,Currituck,2023-02-07
1,4,1,3,0,Currituck,2023-02-09
1,2,1,1,0,Currituck,2023-02-10
1,4,1,3,0,Currituck,2023-02-18
1,4,1,3,0,Currituck,2023-02-24
1,3,1,2,0,Currituck,2023-03-02
1,3,1,2,0,Currituck,2023-03-25
1,1,1,0,0,Currituck,2023-03-30
1,4,1,3,0,Dare,2022-12-04
1,17,1,16,0,Dare,2022-12-27
1,10,1,9,0,Dare,2022-12-31
1,4,1,3,0,Dare,2023-01-21
1,4,1,3,0,Dare,2023-02-22
1,6,1,5,0,Dare,2023-03-03
1,2,1,1,0,Dare,2023-03-13
1,3,1,2,0,Dare,2023-04-29
1,6,1,5,0,Davidson,2023-03-24
1,3,1,2,0,Davidson,2023-04-07
1,3,1,2,0,Davie,2023-01-15
1,2,1,1,0,Davie,2023-01-28
1,4,1,3,0,Davie,2023-02-01
1,6,1,5,0,Davie,2023-02-22
1,5,1,4,0,Davie,2023-02-26
1,4,1,3,0,Davie,2023-04-12
1,2,1,1,0,Davie,2023-04-21
1,2,1,1,0,Davie,2023-04-26
1,1,1,0,0,Davie,2023-04-29
1,2,1,1,0,Davie,2023-05-03
1,2,1,1,0,Duplin,2022-11-11
1,3,1,2,0,Duplin,2022-11-18
1,6,1,5,0,Duplin,2023-03-20
1,3,1,2,0,Duplin,2023-04-02
1,2,1,1,0,Duplin,2023-04-09
1,1,1,0,0,Duplin,2023-04-20
1,6,1,5,0,Durham,2023-04-16
1,4,1,3,0,Durham,2023-05-04
1,6,1,5,0,Durham,2023-05-05
1,3,1,2,0,Edgecombe,2022-11-08
1,5,1,4,0,Edgecombe,2022-11-14
1,14,1,13,0,Edgecombe,2022-12-19
1,9,1,8,0,Edgecombe,2022-12-20
1,7,1,6,0,Edgecombe,2023-01-01
1,5,1,4,0,Edgecombe,2023-01-27
1,3,1,2,0,Edgecombe,2023-02-15
1,4,1,3,0,Edgecombe,2023-02-26
1,2,1,1,0,Edgecombe,2023-03-21
1,2,1,1,0,Edgecombe,2023-04-04
1,2,1,1,0,Edgecombe,2023-04-11
1,2,1,1,0,Edgecombe,2023-04-26
1,6,1,5,0,Franklin,2022-11-12
1,6,1,5,0,Franklin,2022-11-14
1,5,1,4,0,Franklin,2022-11-22
1,6,1,5,0,Franklin,2022-12-02
1,3,1,2,0,Franklin,2022-12-03
1,5,1,4,0,Franklin,2022-12-05
1,8,1,7,0,Franklin,2022-12-10
1,10,1,9,0,Franklin,2023-01-08
1,4,1,3,0,Franklin,2023-03-08
1,6,1,5,0,Franklin,2023-03-09
1,6,1,5,0,Franklin,2023-03-21
1,5,1,4,0,Franklin,2023-03-30
1,1,1,0,0,Franklin,2023-04-30
1,3,1,2,0,Franklin,2023-05-01
1,7,1,6,0,Gaston,2023-04-20
1,4,1,3,0,Gaston,2023-04-28
1,6,1,5,0,Gaston,2023-05-03
1,2,1,1,0,Gates,2022-12-07
1,1,1,0,0,Gates,2023-01-04
1,1,1,0,0,Gates,2023-01-07
1,4,1,3,0,Gates,2023-01-09
1,2,1,1,0,Gates,2023-02-02
1,2,1,1,0,Gates,2023-02-13
1,2,1,1,0,Gates,2023-02-28
1,3,1,2,0,Gates,2023-03-17
1,1,1,0,0,Graham,2022-11-08
1,1,1,0,0,Graham,2022-11-27
1,1,1,0,0,Graham,2022-12-07
1,1,1,0,0,Graham,2023-01-16
1,1,1,0,0,Graham,2023-01-21
1,1,1,0,0,Graham,2023-01-26
1,1,1,0,0,Graham,2023-02-01
1,1,1,0,0,Graham,2023-02-07
1,3,1,2,0,Graham,2023-03-13
1,1,1,0,0,Graham,2023-03-28
1,13,1,12,0,Granville,2022-11-09
1,6,1,5,0,Granville,2022-11-22
1,2,1,1,0,Granville,2022-12-03
1,5,1,4,0,Granville,2022-12-17
1,3,1,2,0,Granville,2023-01-29
1,4,1,3,0,Granville,2023-03-08
1,4,1,3,0,Granville,2023-03-15
1,5,1,4,0,Granville,2023-03-23
1,5,1,4,0,Granville,2023-03-28
1,2,1,1,0,Granville,2023-04-01
1,1,1,0,0,Granville,2023-04-09
1,7,1,6,0,Granville,2023-04-11
1,5,1,4,0,Granville,2023-04-12
1,5,1,4,0,Granville,2023-04-20
1,4,1,3,0,Greene,2022-12-05
1,5,1,4,0,Greene,2022-12-08
1,4,1,3,0,Greene,2022-12-20
1,3,1,2,0,Greene,2022-12-23
1,2,1,1,0,Greene,2023-01-02
1,6,1,5,0,Greene,2023-01-31
1,2,1,1,0,Greene,2023-03-18
1,1,1,0,0,Greene,2023-03-21
1,8,1,7,0,Guilford,2023-04-29
1,1,1,0,0,Halifax,2022-11-20
1,4,1,3,0,Halifax,2022-11-21
1,4,1,3,0,Halifax,2022-12-17
1,1,1,0,0,Halifax,2023-04-08
1,1,1,0,0,Halifax,2023-04-16
1,2,1,1,0,Halifax,2023-04-18
1,3,1,2,0,Halifax,2023-04-21
1,2,1,1,0,Halifax,2023-05-02
1,4,1,3,0,Harnett,2022-11-24
1,6,1,5,0,Harnett,2023-02-04
1,3,1,2,0,Harnett,2023-03-11
1,5,1,4,0,Harnett,2023-03-15
1,2,1,1,0,Harnett,2023-04-01
1,3,1,2,0,Harnett,2023-04-15
1,4,1,3,0,Haywood,2022-11-16
1,3,1,2,0,Haywood,2022-11-20
1,5,1,4,0,Haywood,2022-11-23
1,3,1,2,0,Haywood,2022-11-24
1,4,1,3,0,Haywood,2022-12-18
1,9,1,8,0,Haywood,2022-12-25
1,2,1,1,0,Haywood,2023-02-26
1,1,1,0,0,Haywood,2023-03-12
1,1,1,0,0,Haywood,2023-03-29
1,4,1,3,0,Haywood,2023-04-02
1,2,1,1,0,Haywood,2023-04-04
1,1,1,0,0,Haywood,2023-04-08
1,1,1,0,0,Haywood,2023-04-16
1,2,1,1,0,Haywood,2023-04-22
1,1,1,0,0,Haywood,2023-04-25
1,6,1,5,0,Henderson,2022-11-24
1,3,1,2,0,Henderson,2023-02-18
1,5,1,4,0,Henderson,2023-03-01
1,10,1,9,0,Henderson,2023-03-22
1,11,1,10,0,Henderson,2023-04-02
1,6,1,5,0,Henderson,2023-04-19
1,4,1,3,0,Henderson,2023-04-20
1,2,1,1,0,Hertford,2022-11-08
1,4,1,3,0,Hertford,2022-11-22
1,2,1,1,0,Hertford,2022-12-03
1,6,1,5,0,Hertford,2022-12-12
1,3,1,2,0,Hertford,2023-03-01
1,1,1,0,0,Hertford,2023-04-03
1,4,1,3,0,Hoke,2022-11-12
1,6,1,5,0,Hoke,2022-11-29
1,11,1,10,0,Hoke,2023-02-20
1,3,1,2,0,Hoke,2023-04-03
1,1,1,0,0,Hoke,2023-04-23
1,4,1,3,0,Hoke,2023-04-27
1,1,1,0,0,Hoke,2023-05-04
1,1,1,0,0,Hyde,2023-01-04
1,4,1,3,0,Hyde,2023-01-13
1,7,1,6,0,Iredell,2022-11-12
1,6,1,5,0,Iredell,2023-03-04
1,4,1,3,0,Iredell,2023-04-16
1,6,1,5,0,Iredell,2023-04-21
1,4,1,3,0,Iredell,2023-04-28
1,5,1,4,0,Iredell,2023-05-05
1,2,1,1,0,Iredell,2023-05-06
1,4,1,3,0,Jackson,2022-11-18
1,3,1,2,0,Jackson,2022-11-20
1,2,1,1,0,Jackson,2022-12-08
1,5,1,4,0,Jackson,2022-12-12
1,6,1,5,0,Jackson,2023-01-01
1,5,1,4,0,Jackson,2023-02-02
1,4,1,3,0,Jackson,2023-03-13
1,3,1,2,0,Jackson,2023-03-18
1,2,1,1,0,Jackson,2023-03-28
1,1,1,0,0,Jackson,2023-04-15
1,7,1,6,0,Johnston,2022-11-19
1,10,1,9,0,Johnston,2023-03-03
1,12,1,11,0,Johnston,2023-03-14
1,3,1,2,0,Johnston,2023-04-02
1,3,1,2,0,Johnston,2023-04-08
1,3,1,2,0,Johnston,2023-04-15
1,3,1,2,0,Johnston,2023-04-27
1,6,1,5,0,Johnston,2023-05-02
1,8,1,7,0,Johnston,2023-05-06
1,1,1,0,0,Jones,2022-11-30
1,2,1,1,0,Jones,2022-12-16
1,4,1,3,0,Jones,2022-12-20
1,1,1,0,0,Jones,2022-12-22
1,1,1,0,0,Jones,2023-03-01
1,1,1,0,0,Jones,2023-04-18
1,7,1,6,0,Lee,2022-11-08
1,6,1,5,0,Lee,2022-11-17
1,3,1,2,0,Lee,2022-12-25
1,6,1,5,0,Lee,2023-01-06
1,10,1,9,0,Lee,2023-01-31
1,2,1,1,0,Lee,2023-03-01
1,4,1,3,0,Lee,2023-03-15
1,1,1,0,0,Lee,2023-03-28
1,2,1,1,0,Lee,2023-03-29
1,3,1,2,0,Lee,2023-04-06
1,2,1,1,0,Lee,2023-04-23
1,7,1,6,0,Lenoir,2022-11-15
1,2,1,1,0,Lenoir,2022-12-04
1,5,1,4,0,Lenoir,2023-01-14
1,4,1,3,0,Lenoir,2023-01-15
1,5,1,4,0,Lenoir,2023-01-29
1,3,1,2,0,Lenoir,2023-03-07
1,7,1,6,0,Lenoir,2023-03-13
1,6,1,5,0,Lenoir,2023-03-22
1,2,1,1,0,Lenoir,2023-04-06
1,3,1,2,0,Lenoir,2023-04-11
1,2,1,1,0,Lenoir,2023-04-29
1,1,1,0,0,Lenoir,2023-05-01
1,3,1,2,0,Lincoln,2022-11-20
1,5,1,4,0,Lincoln,2022-11-26
1,3,1,2,0,Lincoln,2023-01-15
1,2,1,1,0,Lincoln,2023-02-26
1,6,1,5,0,Lincoln,2023-03-21
1,4,1,3,0,Lincoln,2023-04-18
1,2,1,1,0,Lincoln,2023-04-25
1,3,1,2,0,Macon,2023-02-21
1,4,1,3,0,Macon,2023-03-02
1,3,1,2,0,Macon,2023-03-07
1,1,1,0,0,Macon,2023-03-15
1,2,1,1,0,Macon,2023-03-22
1,2,1,1,0,Macon,2023-04-11
1,1,1,0,0,Macon,2023-05-01
1,1,1,0,0,Madison,2022-11-20
1,2,1,1,0,Madison,2022-11-26
1,1,1,0,0,Madison,2022-12-03
1,4,1,3,0,Madison,2022-12-31
1,3,1,2,0,Madison,2023-01-27
1,2,1,1,0,Madison,2023-01-29
1,1,1,0,0,Madison,2023-02-03
1,2,1,1,0,Madison,2023-02-19
1,2,1,1,0,Madison,2023-02-21
1,2,1,1,0,Madison,2023-02-28
1,1,1,0,0,Madison,2023-03-09
1,2,1,1,0,Madison,2023-03-21
1,1,1,0,0,Madison,2023-04-21
1,1,1,0,0,Martin,2022-11-09
1,5,1,4,0,Martin,2022-12-07
1,2,1,1,0,Martin,2023-01-05
1,2,1,1,0,Martin,2023-01-13
1,2,1,1,0,Martin,2023-01-31
1,1,1,0,0,Martin,2023-03-23
1,2,1,1,0,Martin,2023-04-06
1,6,1,5,0,McDowell,2022-11-10
1,9,1,8,0,McDowell,2022-12-14
1,8,1,7,0,McDowell,2023-01-24
1,6,1,5,0,McDowell,2023-01-27
1,3,1,2,0,McDowell,2023-02-05
1,4,1,3,0,McDowell,2023-02-18
1,6,1,5,0,McDowell,2023-02-23
1,4,1,3,0,McDowell,2023-03-07
1,2,1,1,0,McDowell,2023-03-10
1,3,1,2,0,McDowell,2023-03-24
1,1,1,0,0,McDowell,2023-03-30
1,2,1,1,0,McDowell,2023-04-20
1,2,1,1,0,McDowell,2023-04-28
1,2,1,1,0,Mitchell,2022-11-23
1,1,1,0,0,Mitchell,2022-12-01
1,1,1,0,0,Mitchell,2022-12-23
1,2,1,1,0,Mitchell,2023-01-03
1,4,1,3,0,Mitchell,2023-01-13
1,4,1,3,0,Mitchell,2023-01-24
1,1,1,0,0,Mitchell,2023-02-16
1,1,1,0,0,Mitchell,2023-04-17
1,1,1,0,0,Mitchell,2023-04-20
1,2,1,1,0,Montgomery,2022-11-08
1,6,1,5,0,Montgomery,2022-11-15
1,3,1,2,0,Montgomery,2022-12-02
1,2,1,1,0,Montgomery,2022-12-08
1,4,1,3,0,Montgomery,2022-12-13
1,7,1,6,0,Montgomery,2023-01-26
1,3,1,2,0,Montgomery,2023-02-06
1,3,1,2,0,Montgomery,2023-02-12
1,8,1,7,0,Montgomery,2023-02-16
1,5,1,4,0,Montgomery,2023-02-27
1,6,1,5,0,Montgomery,2023-03-02
1,3,1,2,0,Montgomery,2023-03-03
1,1,1,0,0,Montgomery,2023-03-14
1,3,1,2,0,Montgomery,2023-03-24
1,1,1,0,0,Montgomery,2023-03-28
1,2,1,1,0,Montgomery,2023-04-27
1,1,1,0,0,Montgomery,2023-05-04
1,8,1,7,0,Moore,2022-11-27
1,4,1,3,0,Moore,2022-12-03
1,6,1,5,0,Moore,2022-12-04
1,3,1,2,0,Moore,2023-02-18
1,6,1,5,0,Moore,2023-03-02
1,5,1,4,0,Moore,2023-03-07
1,5,1,4,0,Moore,2023-03-18
1,7,1,6,0,Moore,2023-03-24
1,5,1,4,0,Moore,2023-04-04
1,4,1,3,0,Moore,2023-04-11
1,5,1,4,0,Moore,2023-04-17
1,2,1,1,0,Moore,2023-04-28
1,2,1,1,0,Nash,2023-02-04
1,5,1,4,0,Nash,2023-02-19
1,4,1,3,0,Nash,2023-03-02
1,7,1,6,0,Nash,2023-03-11
1,7,1,6,0,Nash,2023-03-17
1,1,1,0,0,Nash,2023-03-25
1,5,1,4,0,Nash,2023-04-03
1,4,1,3,0,Nash,2023-04-10
1,2,1,1,0,Nash,2023-04-17
1,2,1,1,0,Nash,2023-04-18
1,2,1,1,0,Nash,2023-04-19
1,4,1,3,0,Nash,2023-04-29
1,4,1,3,0,New Hanover,2023-03-08
1,4,1,3,0,New Hanover,2023-03-12
1,3,1,2,0,New Hanover,2023-04-04
1,7,1,6,0,New Hanover,2023-04-25
1,3,1,2,0,New Hanover,2023-04-29
1,5,1,4,0,Northampton,2022-11-29
1,2,1,1,0,Northampton,2022-12-09
1,1,1,0,0,Northampton,2022-12-11
1,7,1,6,0,Northampton,2022-12-20
1,3,1,2,0,Northampton,2023-02-10
1,3,1,2,0,Northampton,2023-02-15
1,2,1,1,0,Northampton,2023-02-16
1,4,1,3,0,Northampton,2023-02-17
1,3,1,2,0,Northampton,2023-02-24
1,4,1,3,0,Northampton,2023-03-01
1,3,1,2,0,Northampton,2023-03-08
1,1,1,0,0,Northampton,2023-05-02
1,3,1,2,0,Northampton,2023-05-03
1,2,1,1,0,Northampton,2023-05-04
1,12,1,11,0,Onslow,2022-12-18
1,13,1,12,0,Onslow,2022-12-24
1,10,1,9,0,Onslow,2023-02-24
1,10,1,9,0,Onslow,2023-04-10
1,3,1,2,0,Onslow,2023-04-16
1,6,1,5,0,Onslow,2023-04-26
1,2,1,1,0,Onslow,2023-04-27
1,8,1,7,0,Orange,2023-02-12
1,13,1,12,0,Orange,2023-03-08
1,8,1,7,0,Orange,2023-03-18
1,14,1,13,0,Orange,2023-03-22
1,2,1,1,0,Orange,2023-03-26
1,6,1,5,0,Orange,2023-04-02
1,9,1,8,0,Orange,2023-04-11
1,6,1,5,0,Orange,2023-04-14
1,4,1,3,0,Orange,2023-04-15
1,4,1,3,0,Orange,2023-04-18
1,7,1,6,0,Orange,2023-04-21
1,7,1,6,0,Orange,2023-04-26
1,2,1,1,0,Pamlico,2022-12-18
1,3,1,2,0,Pamlico,2023-01-05
1,1,1,0,0,Pamlico,2023-01-19
1,1,1,0,0,Pamlico,2023-03-07
1,3,1,2,0,Pasquotank,2022-11-26
1,2,1,1,0,Pasquotank,2022-11-27
1,5,1,4,0,Pasquotank,2022-11-28
1,4,1,3,0,Pasquotank,2022-12-24
1,5,1,4,0,Pasquotank,2023-01-13
1,2,1,1,0,Pasquotank,2023-02-26
1,3,1,2,0,Pasquotank,2023-03-07
1,1,1,0,0,Pasquotank,2023-03-19
1,2,1,1,0,Pasquotank,2023-04-02
1,2,1,1,0,Pasquotank,2023-04-20
1,1,1,0,0,Pender,2022-11-15
1,4,1,3,0,Pender,2022-11-23
1,10,1,9,0,Pender,2022-12-06
1,7,1,6,0,Pender,2022-12-10
1,10,1,9,0,Pender,2022-12-25
1,5,1,4,0,Pender,2023-01-13
1,7,1,6,0,Pender,2023-02-20
1,2,1,1,0,Pender,2023-02-26
1,2,1,1,0,Pender,2023-03-26
1,2,1,1,0,Pender,2023-04-24
1,3,1,2,0,Perquimans,2022-12-29
1,6,1,5,0,Perquimans,2023-01-02
1,5,1,4,0,Perquimans,2023-01-03
1,2,1,1,0,Perquimans,2023-01-31
1,3,1,2,0,Perquimans,2023-02-09
1,1,1,0,0,Perquimans,2023-02-12
1,4,1,3,0,Perquimans,2023-02-16
1,1,1,0,0,Perquimans,2023-02-18
1,2,1,1,0,Perquimans,2023-02-22
1,2,1,1,0,Perquimans,2023-02-23
1,4,1,3,0,Person,2022-11-21
1,5,1,4,0,Person,2022-12-05
1,2,1,1,0,Person,2022-12-10
1,4,1,3,0,Person,2022-12-11
1,4,1,3,0,Person,2023-01-07
1,2,1,1,0,Person,2023-01-22
1,2,1,1,0,Person,2023-01-28
1,4,1,3,0,Person,2023-02-15
1,3,1,2,0,Person,2023-02-27
1,1,1,0,0,Person,2023-03-26
1,2,1,1,0,Person,2023-03-31
1,2,1,1,0,Pitt,2022-11-19
1,11,1,10,0,Pitt,2022-11-27
1,9,1,8,0,Pitt,2022-12-03
1,6,1,5,0,Pitt,2023-03-31
1,5,1,4,0,Pitt,2023-04-05
1,5,1,4,0,Pitt,2023-04-07
1,5,1,4,0,Pitt,2023-04-12
1,3,1,2,0,Pitt,2023-04-19
1,3,1,2,0,Pitt,2023-04-22
1,6,1,5,0,Pitt,2023-04-28
1,5,1,4,0,Pitt,2023-05-02
1,1,1,0,0,Pitt,2023-05-06
1,1,1,0,0,Polk,2022-11-10
1,2,1,1,0,Polk,2022-11-23
1,5,1,4,0,Polk,2022-12-22
1,1,1,0,0,Polk,2022-12-25
1,4,1,3,0,Polk,2023-01-08
1,2,1,1,0,Polk,2023-01-19
1,7,1,6,0,Polk,2023-01-24
1,1,1,0,0,Polk,2023-02-08
1,2,1,1,0,Polk,2023-02-28
1,1,1,0,0,Polk,2023-03-10
1,1,1,0,0,Polk,2023-04-20
1,4,1,3,0,Randolph,2022-11-13
1,1,1,0,0,Randolph,2023-04-14
1,2,1,1,0,Randolph,2023-04-15
1,2,1,1,0,Randolph,2023-04-19
1,4,1,3,0,Randolph,2023-04-20
1,4,1,3,0,Randolph,2023-04-29
1,6,1,5,0,Richmond,2022-11-14
1,2,1,1,0,Richmond,2022-11-17
1,1,1,0,0,Richmond,2022-12-03
1,2,1,1,0,Richmond,2022-12-11
1,5,1,4,0,Richmond,2023-01-20
1,6,1,5,0,Richmond,2023-02-05
1,2,1,1,0,Richmond,2023-03-15
1,1,1,0,0,Richmond,2023-04-08
1,2,1,1,0,Richmond,2023-04-25
1,6,1,5,0,Robeson,2023-03-09
1,3,1,2,0,Robeson,2023-03-25
1,1,1,0,0,Robeson,2023-04-02
1,4,1,3,0,Robeson,2023-04-10
1,3,1,2,0,Robeson,2023-04-13
1,1,1,0,0,Robeson,2023-05-02
1,9,1,8,0,Rockingham,2022-11-16
1,9,1,8,0,Rockingham,2022-12-04
1,5,1,4,0,Rockingham,2023-03-15
1,2,1,1,0,Rockingham,2023-04-08
1,4,1,3,0,Rockingham,2023-04-18
1,2,1,1,0,Rockingham,2023-04-23
1,3,1,2,0,Rockingham,2023-04-26
1,2,1,1,0,Rockingham,2023-04-30
1,2,1,1,0,Rockingham,2023-05-03
1,4,1,3,0,Rockingham,2023-05-04
1,6,1,5,0,Rowan,2023-03-13
1,4,1,3,0,Rowan,2023-03-18
1,4,1,3,0,Rowan,2023-04-01
1,4,1,3,0,Rowan,2023-04-02
1,5,1,4,0,Rowan,2023-04-10
1,3,1,2,0,Rowan,2023-04-25
1,4,1,3,0,Rowan,2023-04-26
1,3,1,2,0,Rutherford,2022-11-13
1,3,1,2,0,Rutherford,2022-11-19
1,7,1,6,0,Rutherford,2022-11-22
1,7,1,6,0,Rutherford,2022-12-24
1,6,1,5,0,Rutherford,2023-02-04
1,4,1,3,0,Rutherford,2023-02-18
1,1,1,0,0,Rutherford,2023-03-04
1,2,1,1,0,Rutherford,2023-03-07
1,1,1,0,0,Rutherford,2023-03-15
1,3,1,2,0,Rutherford,2023-03-17
1,1,1,0,0,Rutherford,2023-03-26
1,3,1,2,0,Rutherford,2023-03-28
1,3,1,2,0,Rutherford,2023-04-21
1,1,1,0,0,Rutherford,2023-04-25
1,3,1,2,0,Rutherford,2023-05-03
1,3,1,2,0,Sampson,2022-11-09
1,1,1,0,0,Sampson,2023-03-11
1,4,1,3,0,Sampson,2023-03-13
1,2,1,1,0,Sampson,2023-04-05
1,4,1,3,0,Sampson,2023-04-11
1,1,1,0,0,Sampson,2023-04-12
1,1,1,0,0,Sampson,2023-04-22
1,1,1,0,0,Scotland,2022-11-14
1,2,1,1,0,Scotland,2022-11-17
1,4,1,3,0,Scotland,2022-11-29
1,2,1,1,0,Scotland,2022-12-02
1,2,1,1,0,Scotland,2022-12-17
1,1,1,0,0,Scotland,2023-03-10
1,1,1,0,0,Scotland,2023-03-22
1,2,1,1,0,Scotland,2023-04-17
1,2,1,1,0,Scotland,2023-04-19
1,1,1,0,0,Scotland,2023-05-03
1,2,1,1,0,Scotland,2023-05-06
1,6,1,5,0,Stanly,2022-11-15
1,2,1,1,0,Stanly,2022-11-18
1,12,1,11,0,Stanly,2022-12-02
1,19,1,18,0,Stanly,2022-12-26
1,11,1,10,0,Stanly,2023-01-24
1,10,1,9,0,Stanly,2023-02-22
1,2,1,1,0,Stanly,2023-04-07
1,3,1,2,0,Stanly,2023-04-10
1,6,1,5,0,Stanly,2023-04-17
1,7,1,6,0,Stokes,2023-01-25
1,4,1,3,0,Stokes,2023-03-03
1,3,1,2,0,Stokes,2023-03-10
1,5,1,4,0,Stokes,2023-03-20
1,1,1,0,0,Stokes,2023-03-30
1,2,1,1,0,Stokes,2023-03-31
1,5,1,4,0,Stokes,2023-04-03
1,5,1,4,0,Stokes,2023-04-19
1,4,1,3,0,Stokes,2023-04-22
1,4,1,3,0,Stokes,2023-04-28
1,5,1,4,0,Surry,2022-11-09
1,4,1,3,0,Surry,2022-11-19
1,6,1,5,0,Surry,2022-11-26
1,12,1,11,0,Surry,2023-02-17
1,4,1,3,0,Surry,2023-04-11
1,3,1,2,0,Surry,2023-04-17
1,3,1,2,0,Surry,2023-05-03
1,3,1,2,0,Swain,2022-11-10
1,2,1,1,0,Swain,2022-12-02
1,3,1,2,0,Swain,2022-12-10
1,2,1,1,0,Swain,2022-12-11
1,1,1,0,0,Swain,2022-12-18
1,2,1,1,0,Swain,2023-01-16
1,3,1,2,0,Swain,2023-02-05
1,1,1,0,0,Swain,2023-02-12
1,1,1,0,0,Swain,2023-02-15
1,2,1,1,0,Swain,2023-03-21
1,1,1,0,0,Swain,2023-04-01
1,1,1,0,0,Swain,2023-04-05
1,2,1,1,0,Swain,2023-04-10
1,1,1,0,0,Swain,2023-04-26
1,6,1,5,0,Transylvania,2022-12-09
1,3,1,2,0,Transylvania,2022-12-24
1,2,1,1,0,Transylvania,2022-12-25
1,5,1,4,0,Transylvania,2023-01-31
1,4,1,3,0,Transylvania,2023-04-13
1,4,1,3,0,Transylvania,2023-04-19
1,4,1,3,0,Transylvania,2023-04-24
1,1,1,0,0,Tyrrell,2023-01-22
1,3,1,2,0,Tyrrell,2023-01-25
1,1,1,0,0,Tyrrell,2023-02-04
1,2,1,1,0,Tyrrell,2023-02-07
1,2,1,1,0,Union,2023-03-11
1,6,1,5,0,Union,2023-04-11
1,3,1,2,0,Union,2023-04-23
1,5,1,4,0,Vance,2022-11-27
1,13,1,12,0,Vance,2022-11-29
1,12,1,11,0,Vance,2023-01-07
1,7,1,6,0,Vance,2023-01-13
1,6,1,5,0,Vance,2023-01-21
1,7,1,6,0,Vance,2023-02-27
1,5,1,4,0,Vance,2023-03-08
1,4,1,3,0,Vance,2023-03-14
1,2,1,1,0,Vance,2023-03-25
1,3,1,2,0,Vance,2023-04-06
1,4,1,3,0,Vance,2023-04-27
1,3,1,2,0,Warren,2022-11-08
1,1,1,0,0,Warren,2022-11-17
1,2,1,1,0,Warren,2022-11-20
1,5,1,4,0,Warren,2022-12-06
1,3,1,2,0,Warren,2022-12-08
1,2,1,1,0,Warren,2022-12-11
1,5,1,4,0,Warren,2022-12-13
1,9,1,8,0,Warren,2022-12-20
1,4,1,3,0,Warren,2023-01-08
1,2,1,1,0,Warren,2023-01-14
1,2,1,1,0,Warren,2023-01-26
1,1,1,0,0,Warren,2023-02-25
1,3,1,2,0,Warren,2023-02-26
1,5,1,4,0,Warren,2023-02-27
1,1,1,0,0,Warren,2023-03-31
1,1,1,0,0,Warren,2023-05-03
1,4,1,3,0,Washington,2022-11-30
1,3,1,2,0,Washington,2022-12-26
1,3,1,2,0,Washington,2022-12-28
1,1,1,0,0,Washington,2022-12-31
1,2,1,1,0,Washington,2023-01-02
1,1,1,0,0,Washington,2023-01-13
1,1,1,0,0,Washington,2023-01-20
1,4,1,3,0,Washington,2023-01-30
1,1,1,0,0,Washington,2023-02-04
1,3,1,2,0,Washington,2023-02-17
1,2,1,1,0,Washington,2023-04-19
1,9,1,8,0,Watauga,2022-12-09
1,3,1,2,0,Watauga,2023-01-06
1,8,1,7,0,Watauga,2023-01-27
1,8,1,7,0,Watauga,2023-02-09
1,6,1,5,0,Watauga,2023-02-17
1,10,1,9,0,Watauga,2023-02-22
1,4,1,3,0,Watauga,2023-02-23
1,2,1,1,0,Watauga,2023-02-25
1,2,1,1,0,Watauga,2023-03-04
1,4,1,3,0,Watauga,2023-03-09
1,4,1,3,0,Watauga,2023-03-10
1,2,1,1,0,Watauga,2023-04-03
1,6,1,5,0,Watauga,2023-04-04
1,2,1,1,0,Watauga,2023-04-14
1,4,1,3,0,Wayne,2022-11-12
1,3,1,2,0,Wayne,2022-11-13
1,7,1,6,0,Wayne,2023-02-05
1,4,1,3,0,Wayne,2023-04-08
1,4,1,3,0,Wayne,2023-04-23
1,3,1,2,0,Wayne,2023-05-05
1,6,1,5,0,Wilkes,2022-12-25
1,1,1,0,0,Wilkes,2023-03-05
1,3,1,2,0,Wilkes,2023-03-09
1,2,1,1,0,Wilkes,2023-03-25
1,3,1,2,0,Wilkes,2023-03-26
1,1,1,0,0,Wilkes,2023-04-08
1,3,1,2,0,Wilkes,2023-04-13
1,4,1,3,0,Wilson,2022-11-15
1,2,1,1,0,Wilson,2022-12-04
1,8,1,7,0,Wilson,2023-01-01
1,2,1,1,0,Wilson,2023-04-02
1,1,1,0,0,Wilson,2023-04-04
1,2,1,1,0,Wilson,2023-04-05
1,2,1,1,0,Wilson,2023-04-15
1,2,1,1,0,Wilson,2023-04-19
1,3,1,2,0,Wilson,2023-04-21
1,1,1,0,0,Wilson,2023-04-25
1,2,1,1,0,Wilson,2023-05-02
1,1,1,0,0,Wilson,2023-05-05
1,4,1,3,0,Yadkin,2022-11-13
1,10,1,9,0,Yadkin,2022-12-08
1,8,1,7,0,Yadkin,2022-12-25
1,9,1,8,0,Yadkin,2023-01-16
1,8,1,7,0,Yadkin,2023-02-11
1,6,1,5,0,Yadkin,2023-02-14
1,6,1,5,0,Yadkin,2023-03-03
1,3,1,2,0,Yadkin,2023-03-09
1,4,1,3,0,Yadkin,2023-03-21
1,4,1,3,0,Yadkin,2023-03-24
1,4,1,3,0,Yadkin,2023-03-26
1,2,1,1,0,Yadkin,2023-04-13
1,2,1,1,0,Yadkin,2023-04-18
1,3,1,2,0,Yadkin,2023-04-30
1,5,1,4,0,Yadkin,2023-05-01
1,4,1,3,0,Yadkin,2023-05-05
1,2,1,1,0,Yancey,2022-12-09
1,1,1,0,0,Yancey,2022-12-13
1,5,1,4,0,Yancey,2022-12-28
1,3,1,2,0,Yancey,2023-01-16
1,2,1,1,0,Yancey,2023-01-19
1,2,1,1,0,Yancey,2023-03-16
1,3,1,2,0,Yancey,2023-04-04
1,3,2,1,0,Alamance,2023-04-15
1,7,2,5,0,Alamance,2023-04-29
1,8,2,6,0,Alamance,2023-05-04
1,6,2,4,0,Alamance,2023-05-05
1,2,2,0,0,Alexander,2022-11-14
1,5,2,3,0,Alexander,2022-11-17
1,4,2,2,0,Alexander,2022-12-09
1,4,2,2,0,Alexander,2023-01-13
1,5,2,3,0,Alexander,2023-02-13
1,2,2,0,0,Alexander,2023-02-24
1,2,2,0,0,Alexander,2023-03-10
1,3,2,1,0,Alexander,2023-03-14
1,2,2,0,0,Alexander,2023-03-18
1,2,2,0,0,Alexander,2023-05-04
1,2,2,0,0,Alleghany,2022-11-12
1,2,2,0,0,Alleghany,2022-11-22
1,2,2,0,0,Alleghany,2022-11-28
1,4,2,2,0,Alleghany,2023-01-03
1,5,2,3,0,Alleghany,2023-01-30
1,4,2,2,0,Alleghany,2023-03-24
1,8,2,6,0,Anson,2022-12-09
1,8,2,6,0,Anson,2022-12-24
1,11,2,9,0,Anson,2023-01-31
1,2,2,0,0,Anson,2023-03-13
1,3,2,1,0,Anson,2023-03-16
1,2,2,0,0,Ashe,2022-11-08
1,6,2,4,0,Ashe,2022-11-29
1,2,2,0,0,Ashe,2022-11-30
1,10,2,8,0,Ashe,2022-12-26
1,5,2,3,0,Ashe,2023-01-18
1,4,2,2,0,Ashe,2023-01-30
1,5,2,3,0,Ashe,2023-02-01
1,3,2,1,0,Avery,2022-11-08
1,6,2,4,0,Beaufort,2022-12-13
1,6,2,4,0,Beaufort,2023-01-24
1,4,2,2,0,Beaufort,2023-02-01
1,3,2,1,0,Beaufort,2023-03-20
1,3,2,1,0,Beaufort,2023-03-24
1,2,2,0,0,Beaufort,2023-04-04
1,10,2,8,0,Bertie,2023-01-03
1,8,2,6,0,Bertie,2023-01-04
1,6,2,4,0,Bertie,2023-01-10
1,5,2,3,0,Bertie,2023-01-11
1,5,2,3,0,Bertie,2023-01-19
1,12,2,10,0,Bladen,2022-12-23
1,9,2,7,0,Bladen,2023-02-06
1,3,2,1,0,Bladen,2023-03-23
1,3,2,1,0,Brunswick,2022-11-24
1,6,2,4,0,Brunswick,2023-02-26
1,17,2,15,0,Brunswick,2023-03-13
1,12,2,10,0,Brunswick,2023-03-16
1,13,2,11,0,Brunswick,2023-03-22
1,9,2,7,0,Buncombe,2023-04-01
1,4,2,2,0,Buncombe,2023-04-02
1,5,2,3,0,Buncombe,2023-04-04
1,11,2,9,0,Burke,2022-12-25
1,13,2,11,0,Burke,2023-01-23
1,16,2,14,0,Burke,2023-01-30
1,20,2,18,0,Burke,2023-02-07
1,2,2,0,0,Burke,2023-04-24
1,4,2,2,0,Burke,2023-05-03
1,5,2,3,0,Cabarrus,2023-03-26
1,5,2,3,0,Cabarrus,2023-05-02
1,2,2,0,0,Camden,2023-01-01
1,2,2,0,0,Camden,2023-01-05
1,2,2,0,0,Camden,2023-04-27
1,5,2,3,0,Carteret,2022-12-04
1,6,2,4,0,Carteret,2022-12-15
1,3,2,1,0,Carteret,2023-02-04
1,6,2,4,0,Carteret,2023-02-17
1,2,2,0,0,Carteret,2023-05-01
1,4,2,2,0,Caswell,2022-12-21
1,5,2,3,0,Caswell,2023-01-19
1,4,2,2,0,Caswell,2023-02-06
1,4,2,2,0,Caswell,2023-02-07
1,2,2,0,0,Caswell,2023-02-17
1,2,2,0,0,Caswell,2023-03-03
1,3,2,1,0,Caswell,2023-04-10
1,8,2,6,0,Catawba,2023-02-25
1,5,2,3,0,Catawba,2023-04-11
1,7,2,5,0,Catawba,2023-04-21
1,3,2,1,0,Catawba,2023-04-26
1,14,2,12,0,Chatham,2022-12-02
1,9,2,7,0,Chatham,2023-01-07
1,7,2,5,0,Chatham,2023-01-27
1,4,2,2,0,Chatham,2023-03-08
1,4,2,2,0,Chatham,2023-04-24
1,5,2,3,0,Chatham,2023-05-01
1,4,2,2,0,Cherokee,2022-11-29
1,4,2,2,0,Cherokee,2022-12-06
1,7,2,5,0,Cherokee,2022-12-20
1,8,2,6,0,Cherokee,2022-12-30
1,7,2,5,0,Cherokee,2023-01-25
1,2,2,0,0,Cherokee,2023-02-04
1,5,2,3,0,Cherokee,2023-02-07
1,8,2,6,0,Chowan,2022-12-20
1,3,2,1,0,Chowan,2023-05-01
1,3,2,1,0,Clay,2022-11-16
1,2,2,0,0,Clay,2022-12-25
1,3,2,1,0,Clay,2023-02-01
1,2,2,0,0,Clay,2023-02-05
1,4,2,2,0,Clay,2023-03-16
1,5,2,3,0,Cleveland,2022-11-19
1,7,2,5,0,Cleveland,2023-03-07
1,6,2,4,0,Columbus,2022-12-01
1,5,2,3,0,Columbus,2022-12-11
1,8,2,6,0,Columbus,2022-12-26
1,12,2,10,0,Columbus,2023-01-07
1,5,2,3,0,Columbus,2023-01-30
1,6,2,4,0,Columbus,2023-02-01
1,4,2,2,0,Columbus,2023-02-22
1,8,2,6,0,Craven,2022-11-23
1,5,2,3,0,Craven,2022-12-04
1,11,2,9,0,Craven,2023-01-15
1,4,2,2,0,Craven,2023-02-11
1,7,2,5,0,Craven,2023-03-12
1,4,2,2,0,Craven,2023-04-02
1,3,2,1,0,Craven,2023-04-08
1,3,2,1,0,Craven,2023-04-25
1,4,2,2,0,Cumberland,2023-04-29
1,4,2,2,0,Currituck,2023-01-12
1,3,2,1,0,Currituck,2023-02-01
1,2,2,0,0,Currituck,2023-03-01
1,3,2,1,0,Currituck,2023-03-03
1,3,2,1,0,Currituck,2023-03-12
1,8,2,6,0,Dare,2023-01-20
1,4,2,2,0,Dare,2023-03-06
1,15,2,13,0,Davidson,2022-12-03
1,11,2,9,0,Davidson,2023-03-17
1,7,2,5,0,Davidson,2023-03-29
1,11,2,9,0,Davidson,2023-04-04
1,2,2,0,0,Davie,2022-11-14
1,4,2,2,0,Davie,2022-11-17
1,5,2,3,0,Davie,2022-12-10
1,5,2,3,0,Davie,2023-01-22
1,8,2,6,0,Davie,2023-01-27
1,5,2,3,0,Davie,2023-02-02
1,3,2,1,0,Davie,2023-02-05
1,3,2,1,0,Davie,2023-03-11
1,5,2,3,0,Davie,2023-03-16
1,6,2,4,0,Davie,2023-03-28
1,3,2,1,0,Davie,2023-04-24
1,4,2,2,0,Duplin,2022-11-17
1,3,2,1,0,Duplin,2022-11-30
1,4,2,2,0,Duplin,2023-01-07
1,6,2,4,0,Duplin,2023-01-16
1,4,2,2,0,Duplin,2023-03-01
1,3,2,1,0,Duplin,2023-03-06
1,15,2,13,0,Durham,2023-03-26
1,13,2,11,0,Durham,2023-04-24
1,10,2,8,0,Durham,2023-04-28
1,12,2,10,0,Edgecombe,2022-12-21
1,5,2,3,0,Edgecombe,2023-02-05
1,9,2,7,0,Edgecombe,2023-02-10
1,19,2,17,0,Forsyth,2022-11-12
1,8,2,6,0,Franklin,2022-11-09
1,7,2,5,0,Franklin,2022-11-25
1,4,2,2,0,Franklin,2022-11-26
1,5,2,3,0,Franklin,2022-12-04
1,19,2,17,0,Franklin,2022-12-16
1,6,2,4,0,Franklin,2023-02-12
1,3,2,1,0,Franklin,2023-03-13
1,2,2,0,0,Franklin,2023-03-17
1,4,2,2,0,Franklin,2023-03-28
1,4,2,2,0,Gaston,2023-04-03
1,4,2,2,0,Gaston,2023-04-26
1,5,2,3,0,Gaston,2023-05-01
1,2,2,0,0,Gates,2023-01-31
1,4,2,2,0,Gates,2023-02-01
1,2,2,0,0,Gates,2023-03-09
1,4,2,2,0,Gates,2023-03-13
1,2,2,0,0,Gates,2023-03-22
1,2,2,0,0,Graham,2022-11-29
1,2,2,0,0,Graham,2023-01-22
1,2,2,0,0,Graham,2023-01-23
1,2,2,0,0,Graham,2023-04-06
1,10,2,8,0,Granville,2022-11-20
1,8,2,6,0,Granville,2023-01-14
1,8,2,6,0,Granville,2023-02-25
1,5,2,3,0,Granville,2023-03-27
1,3,2,1,0,Granville,2023-04-03
1,4,2,2,0,Greene,2023-02-08
1,8,2,6,0,Guilford,2023-04-30
1,14,2,12,0,Halifax,2022-11-09
1,3,2,1,0,Halifax,2022-12-04
1,7,2,5,0,Halifax,2022-12-10
1,4,2,2,0,Halifax,2022-12-11
1,6,2,4,0,Halifax,2023-03-06
1,6,2,4,0,Halifax,2023-03-09
1,3,2,1,0,Halifax,2023-03-27
1,3,2,1,0,Halifax,2023-04-03
1,4,2,2,0,Halifax,2023-04-13
1,2,2,0,0,Halifax,2023-05-04
1,2,2,0,0,Harnett,2022-11-13
1,17,2,15,0,Harnett,2023-02-15
1,9,2,7,0,Harnett,2023-02-19
1,3,2,1,0,Harnett,2023-03-04
1,9,2,7,0,Harnett,2023-03-06
1,10,2,8,0,Harnett,2023-04-03
1,7,2,5,0,Haywood,2022-12-04
1,4,2,2,0,Haywood,2023-02-15
1,5,2,3,0,Haywood,2023-03-17
1,2,2,0,0,Haywood,2023-03-25
1,3,2,1,0,Haywood,2023-04-27
1,5,2,3,0,Haywood,2023-05-01
1,11,2,9,0,Henderson,2023-02-26
1,7,2,5,0,Henderson,2023-03-31
1,5,2,3,0,Henderson,2023-04-03
1,4,2,2,0,Hertford,2022-11-14
1,5,2,3,0,Hertford,2022-11-21
1,4,2,2,0,Hertford,2022-11-23
1,3,2,1,0,Hertford,2022-12-24
1,4,2,2,0,Hertford,2023-01-25
1,2,2,0,0,Hertford,2023-04-18
1,5,2,3,0,Hoke,2022-11-21
1,4,2,2,0,Hoke,2022-11-26
1,7,2,5,0,Hoke,2022-12-10
1,8,2,6,0,Hoke,2022-12-22
1,6,2,4,0,Hoke,2023-01-07
1,7,2,5,0,Hoke,2023-01-28
1,5,2,3,0,Hoke,2023-01-29
1,9,2,7,0,Hoke,2023-02-21
1,3,2,1,0,Hyde,2023-02-14
1,10,2,8,0,Iredell,2023-03-27
1,3,2,1,0,Iredell,2023-04-08
1,8,2,6,0,Iredell,2023-04-17
1,8,2,6,0,Iredell,2023-05-02
1,4,2,2,0,Jackson,2022-11-23
1,7,2,5,0,Jackson,2022-12-06
1,7,2,5,0,Jackson,2022-12-11
1,6,2,4,0,Jackson,2022-12-24
1,5,2,3,0,Jackson,2023-02-03
1,5,2,3,0,Jackson,2023-02-11
1,2,2,0,0,Jackson,2023-02-24
1,3,2,1,0,Jackson,2023-03-07
1,4,2,2,0,Jackson,2023-03-17
1,4,2,2,0,Jackson,2023-03-29
1,2,2,0,0,Jackson,2023-04-09
1,2,2,0,0,Jackson,2023-04-27
1,13,2,11,0,Johnston,2023-03-04
1,5,2,3,0,Johnston,2023-04-05
1,3,2,1,0,Johnston,2023-04-29
1,3,2,1,0,Johnston,2023-04-30
1,4,2,2,0,Jones,2022-12-12
1,4,2,2,0,Jones,2022-12-28
1,3,2,1,0,Jones,2023-01-23
1,3,2,1,0,Lee,2022-11-16
1,9,2,7,0,Lee,2023-01-08
1,6,2,4,0,Lee,2023-02-14
1,8,2,6,0,Lee,2023-02-28
1,5,2,3,0,Lenoir,2022-11-11
1,3,2,1,0,Lenoir,2022-11-27
1,8,2,6,0,Lenoir,2023-01-20
1,2,2,0,0,Lenoir,2023-04-09
1,11,2,9,0,Lincoln,2022-11-14
1,8,2,6,0,Lincoln,2022-11-18
1,6,2,4,0,Lincoln,2022-12-03
1,7,2,5,0,Lincoln,2023-02-11
1,7,2,5,0,Lincoln,2023-02-20
1,6,2,4,0,Lincoln,2023-02-21
1,4,2,2,0,Macon,2022-11-17
1,3,2,1,0,Macon,2022-11-18
1,6,2,4,0,Macon,2022-12-16
1,4,2,2,0,Macon,2023-01-18
1,8,2,6,0,Macon,2023-01-23
1,4,2,2,0,Macon,2023-01-26
1,3,2,1,0,Madison,2022-12-15
1,3,2,1,0,Madison,2023-01-19
1,3,2,1,0,Madison,2023-02-11
1,2,2,0,0,Madison,2023-03-20
1,3,2,1,0,Madison,2023-03-31
1,5,2,3,0,Martin,2023-01-02
1,6,2,4,0,Martin,2023-01-20
1,3,2,1,0,Martin,2023-01-29
1,4,2,2,0,McDowell,2022-11-14
1,5,2,3,0,McDowell,2023-01-08
1,4,2,2,0,McDowell,2023-02-24
1,3,2,1,0,McDowell,2023-03-05
1,3,2,1,0,McDowell,2023-04-13
1,2,2,0,0,McDowell,2023-05-03
1,2,2,0,0,Mitchell,2023-01-05
1,5,2,3,0,Mitchell,2023-01-27
1,3,2,1,0,Mitchell,2023-01-31
1,2,2,0,0,Mitchell,2023-02-23
1,4,2,2,0,Montgomery,2022-11-17
1,6,2,4,0,Montgomery,2022-12-12
1,5,2,3,0,Montgomery,2022-12-18
1,4,2,2,0,Montgomery,2022-12-24
1,3,2,1,0,Montgomery,2023-01-11
1,3,2,1,0,Montgomery,2023-01-15
1,3,2,1,0,Montgomery,2023-01-31
1,2,2,0,0,Montgomery,2023-02-28
1,4,2,2,0,Montgomery,2023-03-16
1,10,2,8,0,Moore,2023-02-11
1,13,2,11,0,Moore,2023-02-15
1,5,2,3,0,Moore,2023-03-22
1,5,2,3,0,Moore,2023-04-01
1,7,2,5,0,Nash,2022-11-22
1,7,2,5,0,Nash,2023-02-24
1,2,2,0,0,Nash,2023-03-14
1,4,2,2,0,Nash,2023-03-16
1,7,2,5,0,New Hanover,2023-02-19
1,15,2,13,0,New Hanover,2023-02-28
1,18,2,16,0,New Hanover,2023-03-01
1,3,2,1,0,New Hanover,2023-05-02
1,5,2,3,0,Northampton,2022-11-12
1,7,2,5,0,Northampton,2022-12-22
1,2,2,0,0,Northampton,2022-12-26
1,4,2,2,0,Northampton,2023-01-08
1,3,2,1,0,Northampton,2023-02-02
1,2,2,0,0,Northampton,2023-02-05
1,3,2,1,0,Northampton,2023-02-06
1,12,2,10,0,Onslow,2022-12-03
1,5,2,3,0,Orange,2022-11-24
1,23,2,21,0,Orange,2022-12-05
1,10,2,8,0,Orange,2023-01-29
1,11,2,9,0,Orange,2023-02-19
1,17,2,15,0,Orange,2023-02-20
1,6,2,4,0,Orange,2023-03-17
1,3,2,1,0,Orange,2023-04-08
1,2,2,0,0,Pamlico,2022-12-12
1,2,2,0,0,Pamlico,2022-12-26
1,4,2,2,0,Pamlico,2023-01-04
1,2,2,0,0,Pamlico,2023-01-16
1,2,2,0,0,Pamlico,2023-01-30
1,2,2,0,0,Pasquotank,2022-11-20
1,6,2,4,0,Pasquotank,2022-12-08
1,5,2,3,0,Pasquotank,2022-12-31
1,7,2,5,0,Pasquotank,2023-01-08
1,2,2,0,0,Pasquotank,2023-02-03
1,6,2,4,0,Pasquotank,2023-02-12
1,2,2,0,0,Pasquotank,2023-03-16
1,2,2,0,0,Pasquotank,2023-04-03
1,2,2,0,0,Pasquotank,2023-04-25
1,5,2,3,0,Pender,2022-12-03
1,14,2,12,0,Pender,2022-12-05
1,4,2,2,0,Pender,2022-12-11
1,9,2,7,0,Pender,2023-01-16
1,10,2,8,0,Pender,2023-01-31
1,7,2,5,0,Pender,2023-04-03
1,4,2,2,0,Perquimans,2022-12-23
1,5,2,3,0,Perquimans,2022-12-28
1,2,2,0,0,Perquimans,2022-12-30
1,4,2,2,0,Perquimans,2023-02-15
1,2,2,0,0,Perquimans,2023-04-04
1,3,2,1,0,Person,2022-12-24
1,14,2,12,0,Person,2023-01-09
1,7,2,5,0,Person,2023-01-11
1,6,2,4,0,Person,2023-02-17
1,2,2,0,0,Person,2023-03-06
1,7,2,5,0,Polk,2022-12-26
1,3,2,1,0,Polk,2023-01-02
1,3,2,1,0,Polk,2023-03-13
1,4,2,2,0,Polk,2023-03-15
1,9,2,7,0,Randolph,2022-11-26
1,8,2,6,0,Randolph,2023-03-07
1,5,2,3,0,Randolph,2023-03-08
1,6,2,4,0,Randolph,2023-03-10
1,7,2,5,0,Randolph,2023-03-12
1,5,2,3,0,Randolph,2023-03-18
1,2,2,0,0,Randolph,2023-03-19
1,2,2,0,0,Randolph,2023-04-04
1,4,2,2,0,Randolph,2023-04-12
1,2,2,0,0,Randolph,2023-04-16
1,3,2,1,0,Randolph,2023-04-28
1,3,2,1,0,Randolph,2023-04-30
1,2,2,0,0,Randolph,2023-05-03
1,3,2,1,0,Richmond,2022-12-05
1,8,2,6,0,Richmond,2022-12-06
1,4,2,2,0,Richmond,2023-01-18
1,2,2,0,0,Richmond,2023-02-11
1,2,2,0,0,Richmond,2023-04-20
1,9,2,7,0,Robeson,2023-03-23
1,7,2,5,0,Robeson,2023-03-26
1,5,2,3,0,Robeson,2023-04-21
1,3,2,1,0,Robeson,2023-04-26
1,7,2,5,0,Rockingham,2022-11-10
1,4,2,2,0,Rockingham,2022-11-13
1,11,2,9,0,Rockingham,2022-11-26
1,12,2,10,0,Rockingham,2022-12-17
1,3,2,1,0,Rockingham,2023-02-26
1,13,2,11,0,Rockingham,2023-02-27
1,2,2,0,0,Rockingham,2023-04-01
1,4,2,2,0,Rockingham,2023-05-06
1,9,2,7,0,Rowan,2023-03-27
1,8,2,6,0,Rowan,2023-03-31
1,3,2,1,0,Rutherford,2022-11-12
1,7,2,5,0,Rutherford,2022-11-26
1,11,2,9,0,Rutherford,2022-12-09
1,13,2,11,0,Rutherford,2022-12-16
1,2,2,0,0,Rutherford,2023-02-17
1,4,2,2,0,Rutherford,2023-05-05
1,2,2,0,0,Sampson,2022-11-18
1,3,2,1,0,Sampson,2022-11-20
1,4,2,2,0,Sampson,2022-11-26
1,4,2,2,0,Sampson,2022-12-03
1,2,2,0,0,Sampson,2023-05-06
1,2,2,0,0,Scotland,2022-11-08
1,3,2,1,0,Scotland,2022-11-16
1,2,2,0,0,Scotland,2022-11-19
1,4,2,2,0,Scotland,2022-11-30
1,3,2,1,0,Scotland,2022-12-06
1,5,2,3,0,Scotland,2023-02-16
1,6,2,4,0,Scotland,2023-03-15
1,3,2,1,0,Scotland,2023-03-28
1,3,2,1,0,Scotland,2023-04-01
1,2,2,0,0,Stokes,2022-11-13
1,5,2,3,0,Stokes,2022-11-19
1,6,2,4,0,Stokes,2022-12-03
1,6,2,4,0,Stokes,2022-12-10
1,7,2,5,0,Stokes,2023-01-28
1,4,2,2,0,Stokes,2023-02-12
1,7,2,5,0,Surry,2022-11-17
1,4,2,2,0,Surry,2022-11-20
1,5,2,3,0,Surry,2023-03-07
1,3,2,1,0,Swain,2022-12-05
1,3,2,1,0,Swain,2022-12-31
1,3,2,1,0,Swain,2023-01-02
1,2,2,0,0,Swain,2023-01-20
1,2,2,0,0,Swain,2023-01-24
1,2,2,0,0,Swain,2023-01-27
1,2,2,0,0,Swain,2023-02-27
1,7,2,5,0,Transylvania,2022-12-04
1,7,2,5,0,Transylvania,2022-12-11
1,10,2,8,0,Transylvania,2022-12-13
1,7,2,5,0,Transylvania,2022-12-23
1,5,2,3,0,Transylvania,2023-01-08
1,3,2,1,0,Transylvania,2023-03-01
1,3,2,1,0,Transylvania,2023-03-31
1,2,2,0,0,Tyrrell,2023-02-23
1,5,2,3,0,Union,2023-03-12
1,5,2,3,0,Vance,2022-11-08
1,4,2,2,0,Vance,2022-11-12
1,6,2,4,0,Vance,2022-11-22
1,7,2,5,0,Vance,2022-12-10
1,7,2,5,0,Vance,2023-02-08
1,7,2,5,0,Vance,2023-03-21
1,6,2,4,0,Warren,2022-11-28
1,11,2,9,0,Warren,2022-12-26
1,3,2,1,0,Warren,2023-01-24
1,6,2,4,0,Warren,2023-02-03
1,4,2,2,0,Warren,2023-02-18
1,3,2,1,0,Warren,2023-02-28
1,3,2,1,0,Warren,2023-03-02
1,2,2,0,0,Warren,2023-04-07
1,4,2,2,0,Watauga,2022-11-17
1,9,2,7,0,Watauga,2022-12-11
1,8,2,6,0,Watauga,2022-12-28
1,9,2,7,0,Watauga,2023-02-08
1,5,2,3,0,Watauga,2023-02-13
1,7,2,5,0,Watauga,2023-02-21
1,2,2,0,0,Watauga,2023-02-26
1,7,2,5,0,Watauga,2023-02-28
1,3,2,1,0,Watauga,2023-03-13
1,5,2,3,0,Watauga,2023-03-19
1,2,2,0,0,Watauga,2023-03-23
1,3,2,1,0,Watauga,2023-04-09
1,7,2,5,0,Wayne,2023-02-26
1,3,2,1,0,Wayne,2023-03-26
1,5,2,3,0,Wayne,2023-04-07
1,4,2,2,0,Wayne,2023-04-15
1,2,2,0,0,Wayne,2023-04-25
1,5,2,3,0,Wayne,2023-04-28
1,3,2,1,0,Wilkes,2022-11-08
1,2,2,0,0,Wilkes,2022-11-16
1,10,2,8,0,Wilkes,2022-11-18
1,3,2,1,0,Wilkes,2023-01-26
1,5,2,3,0,Wilkes,2023-03-02
1,3,2,1,0,Wilkes,2023-03-27
1,3,2,1,0,Wilkes,2023-03-31
1,5,2,3,0,Wilkes,2023-04-17
1,2,2,0,0,Wilkes,2023-04-25
1,5,2,3,0,Wilkes,2023-05-04
1,2,2,0,0,Wilkes,2023-05-06
1,4,2,2,0,Wilson,2022-11-12
1,5,2,3,0,Wilson,2022-11-26
1,10,2,8,0,Wilson,2022-12-10
1,8,2,6,0,Wilson,2023-01-22
1,7,2,5,0,Wilson,2023-02-04
1,4,2,2,0,Wilson,2023-02-24
1,3,2,1,0,Wilson,2023-03-10
1,3,2,1,0,Wilson,2023-03-12
1,3,2,1,0,Wilson,2023-03-23
1,3,2,1,0,Wilson,2023-03-30
1,4,2,2,0,Wilson,2023-05-01
1,5,2,3,0,Yadkin,2022-12-01
1,7,2,5,0,Yadkin,2023-01-08
1,10,2,8,0,Yadkin,2023-01-14
1,3,2,1,0,Yadkin,2023-03-06
1,4,2,2,0,Yadkin,2023-04-27
1,4,2,2,0,Yadkin,2023-04-28
1,3,2,1,0,Yancey,2022-12-03
1,2,2,0,0,Yancey,2022-12-07
1,3,2,1,0,Yancey,2022-12-14
1,4,2,2,0,Yancey,2022-12-30
1,4,2,2,0,Yancey,2023-01-17
1,3,2,1,0,Yancey,2023-01-18
1,3,2,1,0,Yancey,2023-01-28
1,2,2,0,0,Yancey,2023-02-13
1,2,2,0,0,Yancey,2023-02-16
1,2,2,0,0,Yancey,2023-02-21
1,2,2,0,0,Yancey,2023-02-28
1,2,2,0,0,Yancey,2023-03-06
1,3,2,1,0,Yancey,2023-03-08
1,3,2,1,0,Yancey,2023-03-13
1,3,2,1,0,Yancey,2023-03-15
1,2,2,0,0,Yancey,2023-04-14
1,20,3,17,0,Alamance,2022-11-27
1,14,3,11,0,Alamance,2023-03-13
1,10,3,7,0,Alamance,2023-03-20
1,8,3,5,0,Alamance,2023-04-11
1,10,3,7,0,Alamance,2023-04-13
1,6,3,3,0,Alexander,2022-11-08
1,4,3,1,0,Alexander,2022-12-07
1,4,3,1,0,Alexander,2023-01-01
1,5,3,2,0,Alexander,2023-01-25
1,4,3,1,0,Alleghany,2022-11-23
1,4,3,1,0,Alleghany,2022-12-29
1,6,3,3,0,Alleghany,2022-12-30
1,5,3,2,0,Alleghany,2023-01-19
1,4,3,1,0,Alleghany,2023-01-25
1,10,3,7,0,Anson,2022-12-21
1,8,3,5,0,Anson,2023-01-26
1,5,3,2,0,Anson,2023-02-09
1,3,3,0,0,Anson,2023-03-06
1,3,3,0,0,Ashe,2022-11-21
1,4,3,1,0,Ashe,2022-12-11
1,3,3,0,0,Ashe,2022-12-12
1,7,3,4,0,Ashe,2022-12-28
1,14,3,11,0,Beaufort,2022-12-26
1,5,3,2,0,Beaufort,2023-03-07
1,8,3,5,0,Bertie,2022-12-12
1,6,3,3,0,Bladen,2023-02-24
1,5,3,2,0,Buncombe,2023-03-04
1,15,3,12,0,Burke,2022-11-23
1,14,3,11,0,Burke,2022-12-01
1,9,3,6,0,Burke,2022-12-11
1,5,3,2,0,Burke,2023-03-08
1,3,3,0,0,Burke,2023-04-01
1,6,3,3,0,Cabarrus,2023-04-25
1,3,3,0,0,Cabarrus,2023-04-26
1,7,3,4,0,Caldwell,2023-03-05
1,3,3,0,0,Camden,2023-01-04
1,10,3,7,0,Carteret,2022-12-05
1,7,3,4,0,Carteret,2022-12-06
1,10,3,7,0,Carteret,2023-01-18
1,3,3,0,0,Carteret,2023-02-12
1,4,3,1,0,Carteret,2023-02-21
1,3,3,0,0,Carteret,2023-03-20
1,4,3,1,0,Caswell,2023-01-03
1,7,3,4,0,Catawba,2023-03-11
1,5,3,2,0,Catawba,2023-04-01
1,6,3,3,0,Catawba,2023-04-13
1,10,3,7,0,Chatham,2022-12-07
1,19,3,16,0,Chatham,2023-01-05
1,8,3,5,0,Chatham,2023-02-17
1,5,3,2,0,Chatham,2023-02-26
1,4,3,1,0,Cherokee,2023-01-19
1,7,3,4,0,Cherokee,2023-01-21
1,6,3,3,0,Cherokee,2023-02-20
1,5,3,2,0,Clay,2023-01-26
1,7,3,4,0,Cleveland,2023-02-14
1,6,3,3,0,Cleveland,2023-03-25
1,3,3,0,0,Cleveland,2023-04-25
1,7,3,4,0,Columbus,2023-01-15
1,11,3,8,0,Columbus,2023-01-31
1,5,3,2,0,Columbus,2023-03-01
1,10,3,7,0,Craven,2023-03-14
1,7,3,4,0,Craven,2023-03-15
1,4,3,1,0,Craven,2023-03-29
1,3,3,0,0,Craven,2023-04-26
1,6,3,3,0,Cumberland,2023-03-18
1,8,3,5,0,Cumberland,2023-04-26
1,18,3,15,0,Davidson,2022-11-23
1,16,3,13,0,Davidson,2023-01-29
1,9,3,6,0,Davidson,2023-03-16
1,9,3,6,0,Davidson,2023-04-11
1,10,3,7,0,Davie,2023-01-23
1,9,3,6,0,Davie,2023-03-01
1,7,3,4,0,Davie,2023-03-02
1,11,3,8,0,Duplin,2022-12-14
1,4,3,1,0,Duplin,2023-01-08
1,13,3,10,0,Duplin,2023-02-14
1,3,3,0,0,Duplin,2023-03-07
1,17,3,14,0,Forsyth,2023-04-01
1,3,3,0,0,Franklin,2022-11-13
1,10,3,7,0,Franklin,2023-02-07
1,4,3,1,0,Gaston,2023-03-18
1,5,3,2,0,Gaston,2023-04-12
1,3,3,0,0,Gates,2023-01-26
1,6,3,3,0,Gates,2023-01-30
1,4,3,1,0,Graham,2023-03-16
1,5,3,2,0,Granville,2022-12-25
1,8,3,5,0,Granville,2023-02-03
1,3,3,0,0,Granville,2023-02-04
1,10,3,7,0,Greene,2022-12-30
1,10,3,7,0,Guilford,2023-05-06
1,7,3,4,0,Halifax,2022-11-22
1,11,3,8,0,Halifax,2023-01-18
1,5,3,2,0,Halifax,2023-02-16
1,4,3,1,0,Halifax,2023-03-10
1,11,3,8,0,Harnett,2022-12-09
1,18,3,15,0,Harnett,2023-02-10
1,7,3,4,0,Haywood,2023-01-01
1,6,3,3,0,Haywood,2023-01-13
1,4,3,1,0,Haywood,2023-02-17
1,5,3,2,0,Haywood,2023-03-19
1,4,3,1,0,Haywood,2023-05-03
1,16,3,13,0,Henderson,2022-11-15
1,10,3,7,0,Henderson,2023-03-10
1,9,3,6,0,Henderson,2023-03-23
1,6,3,3,0,Henderson,2023-05-02
1,5,3,2,0,Hertford,2022-12-13
1,3,3,0,0,Hertford,2023-01-20
1,9,3,6,0,Hoke,2023-02-08
1,6,3,3,0,Iredell,2023-04-19
1,6,3,3,0,Iredell,2023-04-23
1,8,3,5,0,Iredell,2023-04-24
1,9,3,6,0,Jackson,2022-11-09
1,7,3,4,0,Jackson,2022-12-18
1,7,3,4,0,Jackson,2022-12-22
1,11,3,8,0,Jackson,2022-12-29
1,4,3,1,0,Jackson,2023-01-26
1,5,3,2,0,Jackson,2023-02-09
1,4,3,1,0,Jackson,2023-04-04
1,6,3,3,0,Johnston,2023-04-06
1,3,3,0,0,Johnston,2023-04-20
1,9,3,6,0,Jones,2022-12-29
1,10,3,7,0,Lee,2022-12-23
1,10,3,7,0,Lee,2023-01-15
1,8,3,5,0,Lee,2023-01-25
1,7,3,4,0,Lenoir,2022-11-16
1,9,3,6,0,Lenoir,2023-01-18
1,19,3,16,0,Lincoln,2022-12-15
1,4,3,1,0,Lincoln,2023-04-17
1,6,3,3,0,Macon,2022-12-07
1,5,3,2,0,Macon,2023-03-08
1,5,3,2,0,Madison,2022-11-09
1,3,3,0,0,Madison,2022-12-13
1,4,3,1,0,Madison,2022-12-22
1,4,3,1,0,Madison,2023-02-14
1,8,3,5,0,McDowell,2023-01-01
1,7,3,4,0,McDowell,2023-02-03
1,10,3,7,0,McDowell,2023-02-08
1,4,3,1,0,McDowell,2023-04-06
1,3,3,0,0,Mitchell,2022-11-26
1,6,3,3,0,Mitchell,2023-01-04
1,3,3,0,0,Mitchell,2023-02-21
1,3,3,0,0,Montgomery,2022-11-11
1,9,3,6,0,Moore,2023-02-14
1,8,3,5,0,Moore,2023-03-26
1,3,3,0,0,Moore,2023-04-24
1,3,3,0,0,Nash,2023-03-28
1,7,3,4,0,New Hanover,2022-11-24
1,13,3,10,0,New Hanover,2023-02-11
1,7,3,4,0,New Hanover,2023-04-19
1,5,3,2,0,New Hanover,2023-04-22
1,4,3,1,0,Northampton,2022-11-22
1,7,3,4,0,Northampton,2023-01-13
1,4,3,1,0,Northampton,2023-02-28
1,6,3,3,0,Onslow,2022-11-27
1,10,3,7,0,Onslow,2023-02-28
1,23,3,20,0,Orange,2022-11-23
1,23,3,20,0,Orange,2022-12-17
1,20,3,17,0,Orange,2023-02-17
1,11,3,8,0,Orange,2023-03-15
1,7,3,4,0,Pamlico,2022-12-29
1,9,3,6,0,Pamlico,2023-02-07
1,4,3,1,0,Pamlico,2023-02-15
1,5,3,2,0,Pasquotank,2022-11-09
1,4,3,1,0,Pasquotank,2022-12-15
1,6,3,3,0,Pasquotank,2023-01-06
1,5,3,2,0,Pasquotank,2023-01-24
1,10,3,7,0,Pasquotank,2023-01-30
1,11,3,8,0,Pender,2022-12-09
1,13,3,10,0,Pender,2022-12-31
1,9,3,6,0,Pender,2023-01-27
1,3,3,0,0,Perquimans,2022-12-18
1,4,3,1,0,Perquimans,2022-12-22
1,3,3,0,0,Perquimans,2022-12-24
1,3,3,0,0,Perquimans,2023-01-24
1,7,3,4,0,Perquimans,2023-02-01
1,4,3,1,0,Person,2023-02-16
1,5,3,2,0,Pitt,2022-12-10
1,7,3,4,0,Pitt,2023-04-03
1,12,3,9,0,Pitt,2023-05-03
1,5,3,2,0,Polk,2022-12-06
1,4,3,1,0,Polk,2022-12-09
1,7,3,4,0,Polk,2022-12-23
1,6,3,3,0,Polk,2023-01-16
1,3,3,0,0,Polk,2023-04-13
1,8,3,5,0,Randolph,2023-05-06
1,10,3,7,0,Richmond,2022-12-12
1,9,3,6,0,Richmond,2022-12-24
1,9,3,6,0,Richmond,2023-01-07
1,6,3,3,0,Richmond,2023-01-13
1,5,3,2,0,Richmond,2023-02-19
1,6,3,3,0,Richmond,2023-03-23
1,8,3,5,0,Robeson,2023-03-08
1,6,3,3,0,Robeson,2023-03-28
1,10,3,7,0,Rockingham,2023-02-04
1,7,3,4,0,Rockingham,2023-02-11
1,11,3,8,0,Rockingham,2023-02-23
1,5,3,2,0,Rowan,2022-11-24
1,8,3,5,0,Rowan,2023-03-29
1,8,3,5,0,Rutherford,2022-12-25
1,11,3,8,0,Rutherford,2023-01-31
1,3,3,0,0,Rutherford,2023-03-25
1,4,3,1,0,Rutherford,2023-03-31
1,4,3,1,0,Rutherford,2023-04-26
1,5,3,2,0,Rutherford,2023-04-30
1,3,3,0,0,Sampson,2022-11-21
1,5,3,2,0,Sampson,2022-11-30
1,5,3,2,0,Sampson,2022-12-17
1,4,3,1,0,Sampson,2023-01-22
1,4,3,1,0,Sampson,2023-02-22
1,4,3,1,0,Sampson,2023-03-28
1,3,3,0,0,Sampson,2023-04-03
1,3,3,0,0,Sampson,2023-04-04
1,4,3,1,0,Scotland,2022-12-25
1,5,3,2,0,Scotland,2023-02-18
1,4,3,1,0,Scotland,2023-03-03
1,3,3,0,0,Scotland,2023-03-11
1,3,3,0,0,Scotland,2023-03-13
1,4,3,1,0,Scotland,2023-03-19
1,3,3,0,0,Scotland,2023-05-02
1,4,3,1,0,Stokes,2022-11-20
1,4,3,1,0,Stokes,2022-12-18
1,6,3,3,0,Stokes,2023-01-01
1,8,3,5,0,Stokes,2023-02-16
1,7,3,4,0,Surry,2022-11-11
1,3,3,0,0,Surry,2023-04-19
1,5,3,2,0,Swain,2022-12-13
1,4,3,1,0,Swain,2022-12-28
1,3,3,0,0,Swain,2022-12-29
1,7,3,4,0,Swain,2023-01-01
1,5,3,2,0,Swain,2023-02-07
1,4,3,1,0,Swain,2023-02-28
1,3,3,0,0,Swain,2023-03-12
1,4,3,1,0,Swain,2023-03-24
1,3,3,0,0,Swain,2023-03-27
1,3,3,0,0,Swain,2023-04-17
1,16,3,13,0,Transylvania,2022-12-14
1,8,3,5,0,Transylvania,2022-12-21
1,10,3,7,0,Transylvania,2023-01-07
1,3,3,0,0,Tyrrell,2023-01-24
1,9,3,6,0,Union,2023-04-16
1,15,3,12,0,Union,2023-04-24
1,7,3,4,0,Union,2023-05-06
1,5,3,2,0,Vance,2022-11-09
1,7,3,4,0,Vance,2023-01-14
1,11,3,8,0,Vance,2023-01-15
1,8,3,5,0,Vance,2023-03-30
1,3,3,0,0,Vance,2023-04-16
1,8,3,5,0,Warren,2022-12-27
1,9,3,6,0,Warren,2023-01-11
1,6,3,3,0,Warren,2023-01-23
1,6,3,3,0,Warren,2023-01-30
1,6,3,3,0,Warren,2023-02-20
1,5,3,2,0,Warren,2023-03-01
1,4,3,1,0,Washington,2022-12-25
1,4,3,1,0,Watauga,2022-11-21
1,12,3,9,0,Watauga,2022-11-28
1,7,3,4,0,Watauga,2023-01-19
1,9,3,6,0,Watauga,2023-02-14
1,5,3,2,0,Watauga,2023-03-21
1,10,3,7,0,Wayne,2022-11-18
1,6,3,3,0,Wayne,2023-03-04
1,3,3,0,0,Wayne,2023-03-25
1,6,3,3,0,Wayne,2023-04-05
1,4,3,1,0,Wilkes,2022-11-11
1,9,3,6,0,Wilkes,2023-01-19
1,10,3,7,0,Wilkes,2023-02-11
1,8,3,5,0,Wilkes,2023-02-18
1,4,3,1,0,Wilkes,2023-03-20
1,10,3,7,0,Wilson,2022-12-11
1,6,3,3,0,Wilson,2023-02-19
1,4,3,1,0,Wilson,2023-03-07
1,5,3,2,0,Wilson,2023-03-29
1,3,3,0,0,Wilson,2023-04-26
1,6,3,3,0,Yadkin,2022-11-22
1,7,3,4,0,Yadkin,2022-12-18
1,5,3,2,0,Yadkin,2023-02-28
1,3,3,0,0,Yancey,2022-12-05
1,4,3,1,0,Yancey,2023-03-23
1,13,4,9,0,Alamance,2023-03-03
1,5,4,1,0,Alexander,2023-01-02
1,6,4,2,0,Alexander,2023-01-08
1,7,4,3,0,Alexander,2023-01-18
1,4,4,0,0,Alleghany,2022-11-25
1,5,4,1,0,Alleghany,2022-12-28
1,12,4,8,0,Avery,2022-12-14
1,5,4,1,0,Beaufort,2023-01-13
1,6,4,2,0,Beaufort,2023-02-17
1,5,4,1,0,Beaufort,2023-04-13
1,17,4,13,0,Brunswick,2023-02-13
1,6,4,2,0,Brunswick,2023-04-24
1,8,4,4,0,Buncombe,2023-04-22
1,11,4,7,0,Buncombe,2023-05-01
1,17,4,13,0,Cabarrus,2022-11-20
1,6,4,2,0,Cabarrus,2023-04-21
1,21,4,17,0,Caldwell,2022-11-28
1,22,4,18,0,Caldwell,2022-12-17
1,6,4,2,0,Carteret,2022-12-01
1,7,4,3,0,Carteret,2023-02-24
1,6,4,2,0,Catawba,2023-03-24
1,15,4,11,0,Chatham,2023-01-20
1,9,4,5,0,Clay,2022-12-31
1,5,4,1,0,Clay,2023-01-23
1,8,4,4,0,Cleveland,2022-11-23
1,20,4,16,0,Columbus,2023-01-05
1,6,4,2,0,Craven,2022-12-03
1,10,4,6,0,Craven,2023-02-18
1,8,4,4,0,Craven,2023-03-01
1,7,4,3,0,Craven,2023-03-16
1,6,4,2,0,Currituck,2023-02-15
1,14,4,10,0,Davidson,2023-01-21
1,6,4,2,0,Davie,2023-02-16
1,5,4,1,0,Duplin,2022-11-14
1,5,4,1,0,Duplin,2022-12-02
1,9,4,5,0,Duplin,2022-12-15
1,11,4,7,0,Duplin,2023-01-13
1,22,4,18,0,Durham,2023-03-09
1,9,4,5,0,Edgecombe,2023-01-16
1,14,4,10,0,Franklin,2022-12-14
1,9,4,5,0,Franklin,2023-01-01
1,9,4,5,0,Franklin,2023-02-04
1,7,4,3,0,Gaston,2023-05-05
1,4,4,0,0,Graham,2022-12-21
1,7,4,3,0,Greene,2022-12-21
1,17,4,13,0,Guilford,2022-11-24
1,11,4,7,0,Halifax,2023-02-01
1,10,4,6,0,Halifax,2023-02-05
1,11,4,7,0,Harnett,2022-11-09
1,11,4,7,0,Harnett,2022-12-04
1,13,4,9,0,Harnett,2023-03-28
1,7,4,3,0,Haywood,2022-11-13
1,9,4,5,0,Haywood,2023-02-08
1,7,4,3,0,Haywood,2023-03-01
1,5,4,1,0,Haywood,2023-03-13
1,4,4,0,0,Haywood,2023-05-04
1,7,4,3,0,Henderson,2023-03-16
1,10,4,6,0,Henderson,2023-04-18
1,8,4,4,0,Henderson,2023-05-03
1,13,4,9,0,Hoke,2022-12-06
1,10,4,6,0,Hoke,2023-01-15
1,16,4,12,0,Hoke,2023-02-03
1,5,4,1,0,Iredell,2023-04-05
1,8,4,4,0,Jackson,2022-11-29
1,6,4,2,0,Jackson,2023-01-08
1,5,4,1,0,Jackson,2023-02-13
1,8,4,4,0,Jackson,2023-04-20
1,25,4,21,0,Johnston,2023-02-17
1,12,4,8,0,Johnston,2023-03-21
1,11,4,7,0,Lee,2022-12-15
1,22,4,18,0,Lincoln,2022-12-16
1,10,4,6,0,Lincoln,2023-02-14
1,10,4,6,0,Lincoln,2023-02-23
1,4,4,0,0,Madison,2022-12-19
1,11,4,7,0,McDowell,2022-12-02
1,16,4,12,0,McDowell,2022-12-22
1,6,4,2,0,Mitchell,2022-12-05
1,9,4,5,0,Montgomery,2022-12-21
1,11,4,7,0,Moore,2022-11-12
1,7,4,3,0,Moore,2022-11-20
1,7,4,3,0,Moore,2023-03-12
1,14,4,10,0,Nash,2022-12-10
1,15,4,11,0,New Hanover,2022-11-14
1,10,4,6,0,New Hanover,2023-02-18
1,17,4,13,0,New Hanover,2023-02-23
1,10,4,6,0,Northampton,2022-12-01
1,8,4,4,0,Northampton,2023-02-07
1,9,4,5,0,Onslow,2022-12-04
1,15,4,11,0,Onslow,2023-03-24
1,15,4,11,0,Orange,2023-01-16
1,5,4,1,0,Pamlico,2023-01-03
1,7,4,3,0,Pasquotank,2023-02-08
1,7,4,3,0,Pasquotank,2023-02-17
1,6,4,2,0,Pasquotank,2023-02-23
1,6,4,2,0,Person,2023-01-02
1,4,4,0,0,Person,2023-04-28
1,10,4,6,0,Pitt,2023-03-21
1,4,4,0,0,Polk,2022-12-08
1,4,4,0,0,Polk,2022-12-18
1,8,4,4,0,Polk,2023-01-04
1,6,4,2,0,Polk,2023-01-13
1,4,4,0,0,Polk,2023-01-22
1,5,4,1,0,Polk,2023-01-25
1,8,4,4,0,Polk,2023-02-03
1,4,4,0,0,Polk,2023-02-09
1,4,4,0,0,Randolph,2023-03-21
1,7,4,3,0,Randolph,2023-04-03
1,12,4,8,0,Richmond,2023-01-10
1,5,4,1,0,Richmond,2023-01-19
1,8,4,4,0,Robeson,2023-03-07
1,10,4,6,0,Robeson,2023-03-16
1,5,4,1,0,Rockingham,2023-04-12
1,6,4,2,0,Sampson,2023-03-08
1,4,4,0,0,Scotland,2022-11-21
1,6,4,2,0,Scotland,2023-01-17
1,4,4,0,0,Scotland,2023-02-12
1,6,4,2,0,Scotland,2023-02-14
1,4,4,0,0,Scotland,2023-04-13
1,8,4,4,0,Stokes,2022-12-11
1,6,4,2,0,Stokes,2023-01-26
1,12,4,8,0,Stokes,2023-02-23
1,6,4,2,0,Swain,2022-12-20
1,7,4,3,0,Swain,2022-12-30
1,5,4,1,0,Swain,2023-03-05
1,5,4,1,0,Tyrrell,2023-02-10
1,13,4,9,0,Union,2023-03-08
1,13,4,9,0,Union,2023-03-17
1,16,4,12,0,Union,2023-03-27
1,10,4,6,0,Vance,2022-12-08
1,5,4,1,0,Vance,2023-01-01
1,9,4,5,0,Watauga,2023-01-04
1,5,4,1,0,Watauga,2023-03-15
1,9,4,5,0,Wayne,2022-11-17
1,9,4,5,0,Wayne,2022-11-20
1,6,4,2,0,Wayne,2023-03-17
1,6,4,2,0,Wayne,2023-03-22
1,7,4,3,0,Wilkes,2023-02-25
1,15,4,11,0,Yadkin,2022-11-30
1,8,4,4,0,Yancey,2022-12-27
1,7,5,2,0,Alexander,2022-12-26
1,9,5,4,0,Alexander,2023-01-12
1,7,5,2,0,Ashe,2023-01-03
1,11,5,6,0,Beaufort,2023-03-03
1,10,5,5,0,Buncombe,2023-03-20
1,8,5,3,0,Buncombe,2023-04-28
1,14,5,9,0,Burke,2022-11-22
1,13,5,8,0,Cabarrus,2023-03-02
1,11,5,6,0,Cabarrus,2023-04-05
1,11,5,6,0,Cabarrus,2023-05-01
1,8,5,3,0,Carteret,2022-12-17
1,8,5,3,0,Carteret,2023-01-24
1,8,5,3,0,Carteret,2023-03-30
1,13,5,8,0,Cleveland,2023-01-21
1,9,5,4,0,Columbus,2022-11-09
1,12,5,7,0,Columbus,2022-11-28
1,9,5,4,0,Craven,2022-11-11
1,15,5,10,0,Craven,2022-12-09
1,11,5,6,0,Craven,2023-02-10
1,10,5,5,0,Craven,2023-03-22
1,6,5,1,0,Currituck,2023-03-13
1,8,5,3,0,Davie,2022-12-17
1,11,5,6,0,Edgecombe,2023-01-29
1,9,5,4,0,Forsyth,2023-05-06
1,8,5,3,0,Gaston,2023-04-13
1,8,5,3,0,Harnett,2023-04-06
1,9,5,4,0,Haywood,2022-12-06
1,6,5,1,0,Haywood,2022-12-09
1,6,5,1,0,Haywood,2023-01-26
1,6,5,1,0,Haywood,2023-04-11
1,7,5,2,0,Haywood,2023-04-17
1,8,5,3,0,Haywood,2023-04-28
1,13,5,8,0,Henderson,2022-11-08
1,10,5,5,0,Henderson,2022-11-13
1,18,5,13,0,Henderson,2022-11-27
1,8,5,3,0,Henderson,2023-03-14
1,12,5,7,0,Henderson,2023-04-25
1,6,5,1,0,Iredell,2023-04-07
1,9,5,4,0,Jackson,2022-12-20
1,9,5,4,0,Jackson,2023-01-13
1,7,5,2,0,Jackson,2023-02-15
1,5,5,0,0,Johnston,2023-04-13
1,6,5,1,0,Jones,2023-01-30
1,8,5,3,0,Lenoir,2022-11-09
1,14,5,9,0,Lincoln,2023-01-27
1,6,5,1,0,Macon,2022-11-16
1,10,5,5,0,Macon,2022-12-21
1,5,5,0,0,Macon,2023-03-10
1,18,5,13,0,Mecklenburg,2023-04-22
1,5,5,0,0,Mitchell,2022-12-20
1,6,5,1,0,Mitchell,2022-12-26
1,5,5,0,0,Mitchell,2022-12-27
1,13,5,8,0,Moore,2022-12-01
1,11,5,6,0,Moore,2022-12-10
1,8,5,3,0,Moore,2022-12-15
1,11,5,6,0,Moore,2023-01-01
1,7,5,2,0,Nash,2022-11-25
1,11,5,6,0,New Hanover,2023-03-22
1,8,5,3,0,New Hanover,2023-03-23
1,9,5,4,0,New Hanover,2023-04-27
1,6,5,1,0,New Hanover,2023-04-28
1,8,5,3,0,Northampton,2022-11-28
1,10,5,5,0,Northampton,2023-01-06
1,13,5,8,0,Orange,2023-03-13
1,8,5,3,0,Pasquotank,2022-12-14
1,6,5,1,0,Pasquotank,2023-02-10
1,11,5,6,0,Pender,2022-12-12
1,7,5,2,0,Randolph,2023-03-09
1,10,5,5,0,Randolph,2023-03-14
1,10,5,5,0,Richmond,2023-01-17
1,13,5,8,0,Richmond,2023-02-07
1,10,5,5,0,Rockingham,2023-02-10
1,12,5,7,0,Rowan,2023-02-11
1,5,5,0,0,Rutherford,2023-04-27
1,6,5,1,0,Sampson,2022-11-14
1,9,5,4,0,Sampson,2023-02-28
1,7,5,2,0,Sampson,2023-03-01
1,6,5,1,0,Scotland,2022-12-08
1,6,5,1,0,Scotland,2023-01-16
1,6,5,1,0,Stokes,2022-12-25
1,10,5,5,0,Surry,2022-11-16
1,7,5,2,0,Swain,2023-01-14
1,11,5,6,0,Transylvania,2023-01-13
1,10,5,5,0,Watauga,2022-12-17
1,8,5,3,0,Watauga,2022-12-24
1,15,5,10,0,Watauga,2023-01-26
1,10,5,5,0,Wayne,2022-11-10
1,9,5,4,0,Wayne,2023-03-07
1,7,5,2,0,Wayne,2023-03-16
1,7,5,2,0,Wayne,2023-04-14
1,9,5,4,0,Wilkes,2023-02-21
1,11,5,6,0,Wilson,2022-12-06
1,8,5,3,0,Wilson,2023-03-01
1,6,5,1,0,Yancey,2023-01-12
1,6,5,1,0,Yancey,2023-04-10
1,7,6,1,0,Alexander,2023-01-10
1,6,6,0,0,Alleghany,2022-11-30
1,13,6,7,0,Ashe,2022-12-05
1,18,6,12,0,Brunswick,2023-02-14
1,14,6,8,0,Buncombe,2022-11-19
1,14,6,8,0,Cabarrus,2023-03-23
1,13,6,7,0,Carteret,2022-11-28
1,10,6,4,0,Carteret,2023-02-07
1,10,6,4,0,Catawba,2023-04-12
1,9,6,3,0,Catawba,2023-04-19
1,6,6,0,0,Cherokee,2023-01-31
1,10,6,4,0,Columbus,2022-12-13
1,13,6,7,0,Craven,2023-01-30
1,7,6,1,0,Cumberland,2023-04-16
1,9,6,3,0,Davie,2022-12-08
1,8,6,2,0,Graham,2023-01-02
1,13,6,7,0,Granville,2023-01-30
1,10,6,4,0,Halifax,2022-12-08
1,12,6,6,0,Haywood,2022-12-27
1,16,6,10,0,Iredell,2022-12-25
1,10,6,4,0,Jackson,2022-12-14
1,12,6,6,0,Jackson,2022-12-27
1,9,6,3,0,Jackson,2023-01-24
1,6,6,0,0,Jones,2023-01-12
1,8,6,2,0,Lee,2022-12-02
1,15,6,9,0,Lincoln,2022-12-26
1,10,6,4,0,Macon,2022-12-20
1,8,6,2,0,Macon,2023-01-10
1,8,6,2,0,New Hanover,2023-03-04
1,7,6,1,0,Pamlico,2023-02-01
1,8,6,2,0,Pasquotank,2023-01-01
1,9,6,3,0,Pasquotank,2023-01-02
1,7,6,1,0,Pasquotank,2023-01-25
1,18,6,12,0,Person,2022-12-23
1,10,6,4,0,Pitt,2023-03-11
1,8,6,2,0,Polk,2022-11-18
1,7,6,1,0,Polk,2022-12-19
1,12,6,6,0,Randolph,2023-01-15
1,14,6,8,0,Robeson,2023-01-24
1,8,6,2,0,Sampson,2022-11-29
1,8,6,2,0,Sampson,2022-12-10
1,8,6,2,0,Sampson,2023-02-05
1,8,6,2,0,Sampson,2023-03-03
1,6,6,0,0,Scotland,2023-02-04
1,6,6,0,0,Swain,2022-11-09
1,9,6,3,0,Transylvania,2023-01-05
1,10,6,4,0,Watauga,2022-12-13
1,12,6,6,0,Wayne,2023-04-10
1,8,6,2,0,Wilkes,2023-01-20
1,13,7,6,0,Alamance,2023-03-24
1,10,7,3,0,Buncombe,2023-03-19
1,14,7,7,0,Carteret,2022-12-07
1,7,7,0,0,Catawba,2023-03-26
1,15,7,8,0,Cumberland,2023-04-28
1,17,7,10,0,Granville,2022-12-09
1,8,7,1,0,Halifax,2023-02-14
1,11,7,4,0,Haywood,2022-12-14
1,9,7,2,0,Henderson,2023-04-27
1,11,7,4,0,Iredell,2023-03-29
1,15,7,8,0,Lee,2023-02-07
1,12,7,5,0,McDowell,2023-01-02
1,27,7,20,0,Moore,2022-12-30
1,15,7,8,0,Nash,2022-12-11
1,7,7,0,0,Pasquotank,2023-02-20
1,15,7,8,0,Pitt,2023-03-14
1,10,7,3,0,Pitt,2023-03-23
1,8,7,1,0,Polk,2022-11-22
1,8,7,1,0,Randolph,2023-03-17
1,14,7,7,0,Rutherford,2022-11-29
1,13,7,6,0,Sampson,2022-12-12
1,9,7,2,0,Sampson,2022-12-18
1,14,7,7,0,Scotland,2023-02-20
1,7,7,0,0,Swain,2022-12-08
1,7,7,0,0,Swain,2023-02-14
1,10,7,3,0,Watauga,2022-12-15
1,15,7,8,0,Watauga,2022-12-26
1,12,7,5,0,Watauga,2023-01-24
1,11,7,4,0,Wayne,2022-11-23
1,11,7,4,0,Wilson,2022-12-24
1,16,8,8,0,Carteret,2022-12-13
1,13,8,5,0,Columbus,2023-01-26
1,9,8,1,0,Graham,2022-12-28
1,17,8,9,0,Greene,2023-01-12
1,37,8,29,0,Guilford,2022-11-13
1,10,8,2,0,Haywood,2023-01-24
1,13,8,5,0,Henderson,2023-02-12
1,13,8,5,0,Iredell,2023-02-18
1,20,8,12,0,Lee,2022-12-08
1,18,8,10,0,Lee,2022-12-28
1,14,8,6,0,Montgomery,2022-12-28
1,12,8,4,0,Moore,2022-11-14
1,20,8,12,0,New Hanover,2022-11-08
1,10,8,2,0,Polk,2022-11-17
1,9,8,1,0,Robeson,2022-11-10
1,13,8,5,0,Scotland,2023-01-19
1,19,8,11,0,Surry,2023-01-12
1,9,8,1,0,Wayne,2023-04-17
1,22,8,14,0,Yadkin,2023-01-06
1,11,9,2,0,Alleghany,2022-12-13
1,18,9,9,0,Buncombe,2023-02-27
1,14,9,5,0,New Hanover,2022-11-20
1,9,9,0,0,Polk,2023-01-30
1,12,9,3,0,Rockingham,2023-04-04
1,15,9,6,0,Vance,2023-01-31
1,9,9,0,0,Wayne,2022-11-14
1,15,10,5,0,Carteret,2023-01-12
1,12,10,2,0,Cleveland,2023-02-04
1,12,10,2,0,Haywood,2022-11-09
1,13,10,3,0,Haywood,2022-12-12
1,12,10,2,0,Polk,2022-11-14
1,18,10,8,0,Sampson,2022-12-20
1,17,10,7,0,Sampson,2022-12-22
1,19,10,9,0,Watauga,2022-12-14
1,16,11,5,0,Catawba,2023-03-10
1,15,11,4,0,Craven,2023-04-10
1,14,11,3,0,Davie,2023-02-19
1,12,11,1,0,Warren,2022-11-22
1,13,12,1,0,Haywood,2022-12-08
1,17,12,5,0,Sampson,2023-01-18
1,29,12,17,0,Surry,2022-12-06
1,40,13,27,0,Chatham,2022-12-28
1,24,13,11,0,Craven,2022-12-06
1,14,13,1,0,Haywood,2023-01-20
1,18,13,5,0,Wayne,2022-11-22
1,24,14,10,0,Watauga,2022-12-12
1,21,14,7,0,Wayne,2023-03-20
1,36,15,21,0,Buncombe,2022-11-09
1,21,15,6,0,Sampson,2022-12-15
1,40,24,16,0,Buncombe,2022-12-11
2,5,0,5,0,Alamance,2023-03-12
2,11,0,11,0,Alamance,2023-03-17
2,8,0,8,0,Alamance,2023-03-22
2,6,0,6,0,Alamance,2023-03-31
2,2,0,2,0,Alexander,2022-11-11
2,3,0,3,0,Alexander,2022-11-23
2,3,0,3,0,Alexander,2023-02-04
2,4,0,4,0,Anson,2022-12-05
2,3,0,3,0,Anson,2022-12-11
2,6,0,6,0,Anson,2022-12-16
2,6,0,6,0,Anson,2022-12-22
2,11,0,11,0,Anson,2023-01-05
2,4,0,4,0,Anson,2023-01-11
2,3,0,3,0,Ashe,2023-03-20
2,4,0,4,0,Avery,2022-11-29
2,5,0,5,0,Avery,2022-12-20
2,3,0,3,0,Avery,2022-12-24
2,2,0,2,0,Avery,2023-01-10
2,3,0,3,0,Beaufort,2022-11-09
2,7,0,7,0,Beaufort,2023-01-02
2,6,0,6,0,Beaufort,2023-01-06
2,6,0,6,0,Beaufort,2023-01-26
2,6,0,6,0,Beaufort,2023-02-16
2,4,0,4,0,Beaufort,2023-03-15
2,2,0,2,0,Beaufort,2023-03-26
2,4,0,4,0,Bertie,2022-11-16
2,5,0,5,0,Bertie,2022-11-21
2,7,0,7,0,Bertie,2022-12-05
2,6,0,6,0,Bertie,2023-01-17
2,4,0,4,0,Bertie,2023-01-18
2,3,0,3,0,Bertie,2023-02-11
2,5,0,5,0,Bladen,2022-12-01
2,5,0,5,0,Bladen,2023-01-28
2,8,0,8,0,Bladen,2023-02-02
2,5,0,5,0,Bladen,2023-02-12
2,7,0,7,0,Bladen,2023-02-23
2,3,0,3,0,Bladen,2023-03-28
2,2,0,2,0,Bladen,2023-04-19
2,5,0,5,0,Brunswick,2023-04-05
2,7,0,7,0,Burke,2023-02-27
2,5,0,5,0,Burke,2023-03-12
2,8,0,8,0,Burke,2023-03-21
2,6,0,6,0,Burke,2023-04-11
2,6,0,6,0,Cabarrus,2023-04-04
2,6,0,6,0,Cabarrus,2023-04-10
2,11,0,11,0,Caldwell,2022-11-26
2,3,0,3,0,Caldwell,2023-03-08
2,3,0,3,0,Caldwell,2023-03-19
2,6,0,6,0,Caldwell,2023-04-01
2,4,0,4,0,Caldwell,2023-04-11
2,2,0,2,0,Camden,2023-01-27
2,4,0,4,0,Carteret,2023-02-18
2,3,0,3,0,Caswell,2022-11-23
2,5,0,5,0,Caswell,2022-11-28
2,5,0,5,0,Caswell,2022-11-30
2,6,0,6,0,Caswell,2022-12-08
2,4,0,4,0,Caswell,2022-12-15
2,5,0,5,0,Caswell,2022-12-30
2,9,0,9,0,Caswell,2023-02-03
2,4,0,4,0,Caswell,2023-02-16
2,5,0,5,0,Chatham,2023-02-05
2,3,0,3,0,Cherokee,2022-11-25
2,6,0,6,0,Cherokee,2023-01-12
2,3,0,3,0,Cherokee,2023-01-18
2,2,0,2,0,Chowan,2022-11-26
2,6,0,6,0,Chowan,2022-11-30
2,3,0,3,0,Chowan,2023-01-29
2,5,0,5,0,Chowan,2023-02-07
2,4,0,4,0,Chowan,2023-02-22
2,2,0,2,0,Chowan,2023-02-27
2,2,0,2,0,Chowan,2023-04-10
2,2,0,2,0,Chowan,2023-04-20
2,8,0,8,0,Cleveland,2022-11-17
2,7,0,7,0,Cleveland,2023-02-25
2,4,0,4,0,Cleveland,2023-03-20
2,3,0,3,0,Cleveland,2023-04-11
2,6,0,6,0,Cleveland,2023-04-20
2,3,0,3,0,Columbus,2022-12-04
2,5,0,5,0,Columbus,2022-12-25
2,7,0,7,0,Columbus,2023-01-13
2,4,0,4,0,Columbus,2023-01-27
2,5,0,5,0,Columbus,2023-02-03
2,2,0,2,0,Columbus,2023-04-09
2,9,0,9,0,Craven,2022-11-09
2,3,0,3,0,Currituck,2023-01-17
2,5,0,5,0,Currituck,2023-01-19
2,3,0,3,0,Currituck,2023-02-27
2,5,0,5,0,Dare,2022-11-08
2,3,0,3,0,Dare,2022-11-30
2,4,0,4,0,Dare,2022-12-10
2,8,0,8,0,Dare,2022-12-15
2,15,0,15,0,Dare,2022-12-30
2,12,0,12,0,Dare,2023-01-04
2,7,0,7,0,Dare,2023-01-06
2,8,0,8,0,Dare,2023-01-09
2,6,0,6,0,Dare,2023-01-18
2,9,0,9,0,Dare,2023-01-19
2,8,0,8,0,Dare,2023-02-16
2,3,0,3,0,Dare,2023-02-21
2,9,0,9,0,Dare,2023-02-24
2,4,0,4,0,Dare,2023-02-26
2,7,0,7,0,Dare,2023-02-27
2,3,0,3,0,Dare,2023-03-01
2,2,0,2,0,Dare,2023-05-02
2,3,0,3,0,Davidson,2023-03-10
2,8,0,8,0,Davidson,2023-03-19
2,4,0,4,0,Davie,2022-11-11
2,2,0,2,0,Davie,2022-12-03
2,2,0,2,0,Davie,2022-12-25
2,7,0,7,0,Davie,2023-01-08
2,7,0,7,0,Davie,2023-03-21
2,3,0,3,0,Duplin,2023-04-03
2,7,0,7,0,Durham,2023-04-30
2,5,0,5,0,Edgecombe,2022-11-22
2,4,0,4,0,Edgecombe,2022-12-01
2,7,0,7,0,Edgecombe,2022-12-11
2,8,0,8,0,Edgecombe,2023-01-07
2,15,0,15,0,Edgecombe,2023-01-17
2,8,0,8,0,Edgecombe,2023-02-04
2,7,0,7,0,Edgecombe,2023-02-07
2,7,0,7,0,Edgecombe,2023-02-14
2,8,0,8,0,Edgecombe,2023-03-08
2,6,0,6,0,Edgecombe,2023-03-15
2,3,0,3,0,Edgecombe,2023-04-05
2,7,0,7,0,Forsyth,2023-04-08
2,5,0,5,0,Franklin,2023-01-21
2,9,0,9,0,Franklin,2023-02-21
2,2,0,2,0,Franklin,2023-03-02
2,2,0,2,0,Franklin,2023-05-06
2,2,0,2,0,Gates,2022-12-31
2,4,0,4,0,Granville,2023-02-11
2,11,0,11,0,Granville,2023-02-14
2,4,0,4,0,Granville,2023-03-06
2,4,0,4,0,Greene,2022-11-09
2,8,0,8,0,Greene,2022-12-12
2,7,0,7,0,Greene,2023-01-06
2,5,0,5,0,Greene,2023-01-11
2,4,0,4,0,Greene,2023-01-13
2,8,0,8,0,Greene,2023-01-19
2,5,0,5,0,Greene,2023-02-24
2,6,0,6,0,Halifax,2022-11-25
2,3,0,3,0,Halifax,2022-11-26
2,2,0,2,0,Halifax,2023-03-15
2,13,0,13,0,Harnett,2023-01-22
2,6,0,6,0,Harnett,2023-04-18
2,4,0,4,0,Harnett,2023-04-26
2,5,0,5,0,Haywood,2022-11-27
2,3,0,3,0,Hertford,2023-02-27
2,8,0,8,0,Hoke,2022-11-09
2,2,0,2,0,Hoke,2023-03-06
2,5,0,5,0,Hoke,2023-03-11
2,2,0,2,0,Jones,2023-03-07
2,6,0,6,0,Lee,2023-01-22
2,3,0,3,0,Lee,2023-03-09
2,12,0,12,0,Lenoir,2022-12-10
2,7,0,7,0,Lenoir,2023-01-13
2,5,0,5,0,Lenoir,2023-02-04
2,5,0,5,0,Lenoir,2023-02-23
2,6,0,6,0,Lenoir,2023-03-03
2,8,0,8,0,Lenoir,2023-03-09
2,5,0,5,0,Lenoir,2023-04-01
2,10,0,10,0,Lincoln,2023-02-09
2,2,0,2,0,Lincoln,2023-03-24
2,6,0,6,0,Macon,2022-12-03
2,10,0,10,0,Macon,2022-12-12
2,6,0,6,0,Macon,2023-01-01
2,5,0,5,0,Madison,2022-12-28
2,2,0,2,0,Madison,2023-04-17
2,2,0,2,0,Martin,2022-11-21
2,5,0,5,0,Martin,2022-12-26
2,6,0,6,0,Martin,2022-12-27
2,9,0,9,0,Martin,2023-01-04
2,4,0,4,0,Martin,2023-01-28
2,4,0,4,0,Martin,2023-02-27
2,11,0,11,0,McDowell,2022-11-21
2,7,0,7,0,McDowell,2022-12-16
2,7,0,7,0,McDowell,2023-02-09
2,3,0,3,0,McDowell,2023-03-23
2,2,0,2,0,Montgomery,2022-11-23
2,4,0,4,0,Montgomery,2022-12-14
2,3,0,3,0,Montgomery,2023-01-19
2,8,0,8,0,Montgomery,2023-02-17
2,4,0,4,0,Moore,2023-03-29
2,2,0,2,0,Moore,2023-04-10
2,3,0,3,0,Moore,2023-04-27
2,3,0,3,0,Nash,2022-11-15
2,7,0,7,0,New Hanover,2022-11-12
2,7,0,7,0,New Hanover,2023-03-02
2,3,0,3,0,New Hanover,2023-04-05
2,5,0,5,0,Northampton,2023-01-23
2,4,0,4,0,Northampton,2023-01-27
2,6,0,6,0,Onslow,2023-02-19
2,7,0,7,0,Onslow,2023-03-09
2,3,0,3,0,Onslow,2023-03-12
2,12,0,12,0,Onslow,2023-03-14
2,11,0,11,0,Onslow,2023-04-03
2,4,0,4,0,Onslow,2023-04-11
2,10,0,10,0,Onslow,2023-04-13
2,4,0,4,0,Onslow,2023-05-01
2,11,0,11,0,Orange,2022-11-12
2,11,0,11,0,Orange,2022-11-14
2,11,0,11,0,Orange,2022-11-21
2,13,0,13,0,Orange,2023-02-15
2,10,0,10,0,Orange,2023-03-10
2,7,0,7,0,Orange,2023-03-14
2,10,0,10,0,Orange,2023-03-27
2,3,0,3,0,Orange,2023-04-05
2,5,0,5,0,Orange,2023-04-20
2,9,0,9,0,Orange,2023-04-29
2,3,0,3,0,Pamlico,2023-01-07
2,2,0,2,0,Pamlico,2023-01-09
2,2,0,2,0,Pamlico,2023-02-12
2,3,0,3,0,Pasquotank,2022-11-29
2,3,0,3,0,Pasquotank,2022-12-09
2,15,0,15,0,Pender,2022-12-19
2,11,0,11,0,Pender,2022-12-24
2,12,0,12,0,Pender,2022-12-30
2,4,0,4,0,Pender,2023-02-19
2,4,0,4,0,Pender,2023-04-01
2,5,0,5,0,Perquimans,2023-01-05
2,4,0,4,0,Perquimans,2023-01-27
2,5,0,5,0,Perquimans,2023-02-10
2,5,0,5,0,Person,2023-01-06
2,5,0,5,0,Person,2023-02-12
2,10,0,10,0,Pitt,2023-04-13
2,6,0,6,0,Pitt,2023-04-17
2,10,0,10,0,Pitt,2023-04-18
2,5,0,5,0,Pitt,2023-04-20
2,4,0,4,0,Pitt,2023-04-21
2,6,0,6,0,Pitt,2023-04-25
2,2,0,2,0,Randolph,2023-04-07
2,2,0,2,0,Richmond,2022-12-04
2,6,0,6,0,Richmond,2022-12-25
2,3,0,3,0,Richmond,2023-03-04
2,2,0,2,0,Richmond,2023-03-07
2,3,0,3,0,Richmond,2023-05-01
2,3,0,3,0,Robeson,2023-04-06
2,3,0,3,0,Robeson,2023-04-27
2,12,0,12,0,Rockingham,2022-12-06
2,5,0,5,0,Rockingham,2023-03-05
2,7,0,7,0,Rockingham,2023-04-20
2,5,0,5,0,Rowan,2022-11-10
2,6,0,6,0,Rowan,2023-02-26
2,2,0,2,0,Rutherford,2022-11-24
2,6,0,6,0,Rutherford,2022-11-27
2,9,0,9,0,Rutherford,2022-12-04
2,6,0,6,0,Rutherford,2023-02-03
2,5,0,5,0,Rutherford,2023-02-11
2,3,0,3,0,Rutherford,2023-02-16
2,3,0,3,0,Rutherford,2023-02-28
2,2,0,2,0,Scotland,2023-01-29
2,2,0,2,0,Scotland,2023-03-04
2,6,0,6,0,Stanly,2022-11-19
2,3,0,3,0,Stanly,2022-11-20
2,4,0,4,0,Stanly,2022-12-03
2,12,0,12,0,Stanly,2022-12-08
2,14,0,14,0,Stanly,2023-01-01
2,7,0,7,0,Stanly,2023-01-28
2,5,0,5,0,Stanly,2023-02-05
2,9,0,9,0,Stanly,2023-02-11
2,4,0,4,0,Stanly,2023-02-12
2,3,0,3,0,Stanly,2023-02-23
2,6,0,6,0,Stanly,2023-02-27
2,5,0,5,0,Stanly,2023-03-14
2,3,0,3,0,Stanly,2023-03-22
2,3,0,3,0,Stanly,2023-04-14
2,3,0,3,0,Stanly,2023-04-25
2,4,0,4,0,Stokes,2023-02-04
2,5,0,5,0,Stokes,2023-03-01
2,3,0,3,0,Stokes,2023-03-15
2,2,0,2,0,Stokes,2023-03-22
2,6,0,6,0,Stokes,2023-04-17
2,4,0,4,0,Stokes,2023-04-29
2,3,0,3,0,Surry,2023-03-05
2,4,0,4,0,Surry,2023-04-12
2,4,0,4,0,Surry,2023-04-15
2,2,0,2,0,Surry,2023-04-16
2,4,0,4,0,Surry,2023-05-01
2,4,0,4,0,Transylvania,2022-12-06
2,6,0,6,0,Transylvania,2023-01-26
2,9,0,9,0,Transylvania,2023-01-30
2,2,0,2,0,Transylvania,2023-03-17
2,2,0,2,0,Transylvania,2023-04-06
2,4,0,4,0,Transylvania,2023-04-17
2,4,0,4,0,Transylvania,2023-04-26
2,14,0,14,0,Union,2023-02-25
2,7,0,7,0,Union,2023-03-24
2,4,0,4,0,Vance,2022-11-14
2,6,0,6,0,Vance,2022-12-02
2,3,0,3,0,Vance,2023-02-12
2,4,0,4,0,Vance,2023-02-25
2,3,0,3,0,Warren,2023-03-08
2,5,0,5,0,Warren,2023-03-23
2,4,0,4,0,Washington,2022-12-12
2,8,0,8,0,Washington,2022-12-21
2,4,0,4,0,Washington,2023-02-03
2,16,0,16,0,Watauga,2023-01-02
2,5,0,5,0,Yadkin,2023-01-28
2,6,0,6,0,Yadkin,2023-02-05
2,3,0,3,0,Yadkin,2023-02-18
2,3,0,3,0,Yadkin,2023-03-25
2,9,1,8,0,Alamance,2023-01-29
2,9,1,8,0,Alamance,2023-02-26
2,13,1,12,0,Alamance,2023-03-01
2,5,1,4,0,Alamance,2023-03-19
2,10,1,9,0,Alamance,2023-03-27
2,7,1,6,0,Alamance,2023-04-06
2,4,1,3,0,Alamance,2023-04-07
2,3,1,2,0,Alamance,2023-04-19
2,3,1,2,0,Alamance,2023-04-23
2,2,1,1,0,Alleghany,2022-12-02
2,2,1,1,0,Alleghany,2023-02-16
2,2,1,1,0,Anson,2022-11-21
2,8,1,7,0,Anson,2022-12-12
2,9,1,8,0,Anson,2022-12-13
2,6,1,5,0,Anson,2023-01-06
2,5,1,4,0,Anson,2023-01-16
2,10,1,9,0,Ashe,2023-01-04
2,4,1,3,0,Ashe,2023-01-22
2,2,1,1,0,Ashe,2023-02-14
2,2,1,1,0,Avery,2022-12-03
2,4,1,3,0,Avery,2022-12-06
2,2,1,1,0,Avery,2022-12-11
2,3,1,2,0,Avery,2022-12-23
2,5,1,4,0,Avery,2022-12-29
2,5,1,4,0,Beaufort,2022-11-10
2,3,1,2,0,Beaufort,2022-11-14
2,6,1,5,0,Beaufort,2022-12-16
2,6,1,5,0,Beaufort,2023-03-01
2,3,1,2,0,Beaufort,2023-03-28
2,2,1,1,0,Beaufort,2023-05-03
2,9,1,8,0,Bertie,2022-12-27
2,15,1,14,0,Bertie,2022-12-30
2,4,1,3,0,Bertie,2023-01-30
2,7,1,6,0,Bladen,2022-11-27
2,7,1,6,0,Bladen,2022-12-09
2,4,1,3,0,Bladen,2022-12-25
2,14,1,13,0,Bladen,2023-01-20
2,16,1,15,0,Bladen,2023-02-09
2,5,1,4,0,Bladen,2023-02-17
2,4,1,3,0,Bladen,2023-02-20
2,5,1,4,0,Brunswick,2023-02-04
2,11,1,10,0,Brunswick,2023-02-17
2,5,1,4,0,Brunswick,2023-03-04
2,13,1,12,0,Brunswick,2023-03-27
2,8,1,7,0,Brunswick,2023-05-01
2,12,1,11,0,Burke,2022-11-09
2,4,1,3,0,Burke,2023-01-22
2,12,1,11,0,Burke,2023-02-18
2,3,1,2,0,Burke,2023-04-10
2,4,1,3,0,Burke,2023-04-26
2,12,1,11,0,Cabarrus,2023-03-20
2,5,1,4,0,Cabarrus,2023-03-25
2,5,1,4,0,Cabarrus,2023-04-06
2,3,1,2,0,Cabarrus,2023-04-22
2,9,1,8,0,Cabarrus,2023-04-27
2,11,1,10,0,Caldwell,2023-01-21
2,5,1,4,0,Caldwell,2023-03-14
2,6,1,5,0,Caldwell,2023-03-17
2,8,1,7,0,Caldwell,2023-04-16
2,4,1,3,0,Caldwell,2023-04-25
2,6,1,5,0,Caldwell,2023-05-04
2,3,1,2,0,Camden,2023-01-23
2,4,1,3,0,Caswell,2023-01-23
2,2,1,1,0,Catawba,2023-04-02
2,3,1,2,0,Catawba,2023-04-25
2,5,1,4,0,Chatham,2022-11-13
2,5,1,4,0,Chatham,2023-01-15
2,4,1,3,0,Chatham,2023-02-25
2,4,1,3,0,Chatham,2023-03-01
2,5,1,4,0,Chatham,2023-03-19
2,5,1,4,0,Chatham,2023-03-29
2,4,1,3,0,Cherokee,2022-12-16
2,10,1,9,0,Cherokee,2023-01-16
2,2,1,1,0,Cherokee,2023-02-03
2,2,1,1,0,Cherokee,2023-04-14
2,8,1,7,0,Chowan,2022-12-19
2,7,1,6,0,Chowan,2023-01-18
2,5,1,4,0,Chowan,2023-01-24
2,3,1,2,0,Chowan,2023-02-04
2,4,1,3,0,Clay,2023-01-11
2,19,1,18,0,Cleveland,2023-01-26
2,6,1,5,0,Cleveland,2023-02-11
2,7,1,6,0,Cleveland,2023-02-28
2,4,1,3,0,Cleveland,2023-04-19
2,5,1,4,0,Columbus,2022-11-26
2,7,1,6,0,Columbus,2022-12-02
2,9,1,8,0,Columbus,2023-02-10
2,6,1,5,0,Columbus,2023-02-23
2,8,1,7,0,Cumberland,2022-11-13
2,5,1,4,0,Cumberland,2023-04-09
2,6,1,5,0,Cumberland,2023-04-10
2,3,1,2,0,Currituck,2022-12-02
2,9,1,8,0,Currituck,2022-12-30
2,5,1,4,0,Currituck,2023-01-04
2,5,1,4,0,Currituck,2023-01-13
2,4,1,3,0,Currituck,2023-02-03
2,2,1,1,0,Currituck,2023-04-02
2,8,1,7,0,Dare,2023-02-15
2,11,1,10,0,Davidson,2022-11-11
2,3,1,2,0,Davidson,2023-04-23
2,8,1,7,0,Davidson,2023-05-02
2,6,1,5,0,Davie,2022-12-04
2,5,1,4,0,Davie,2023-03-10
2,5,1,4,0,Davie,2023-03-13
2,7,1,6,0,Duplin,2023-02-04
2,3,1,2,0,Duplin,2023-03-16
2,2,1,1,0,Duplin,2023-04-05
2,13,1,12,0,Durham,2023-04-14
2,8,1,7,0,Durham,2023-04-15
2,7,1,6,0,Durham,2023-05-06
2,5,1,4,0,Edgecombe,2022-12-02
2,3,1,2,0,Edgecombe,2022-12-04
2,10,1,9,0,Edgecombe,2022-12-06
2,4,1,3,0,Edgecombe,2023-01-21
2,7,1,6,0,Edgecombe,2023-01-26
2,11,1,10,0,Edgecombe,2023-02-02
2,13,1,12,0,Franklin,2022-11-08
2,6,1,5,0,Franklin,2022-11-27
2,11,1,10,0,Franklin,2022-12-01
2,11,1,10,0,Franklin,2022-12-13
2,10,1,9,0,Franklin,2023-02-03
2,6,1,5,0,Franklin,2023-02-10
2,7,1,6,0,Franklin,2023-02-25
2,3,1,2,0,Franklin,2023-02-27
2,6,1,5,0,Franklin,2023-03-06
2,3,1,2,0,Franklin,2023-03-10
2,2,1,1,0,Franklin,2023-03-11
2,6,1,5,0,Franklin,2023-03-16
2,6,1,5,0,Franklin,2023-03-20
2,6,1,5,0,Franklin,2023-03-27
2,5,1,4,0,Franklin,2023-04-19
2,3,1,2,0,Franklin,2023-04-24
2,19,1,18,0,Gaston,2022-11-15
2,6,1,5,0,Gaston,2023-03-14
2,7,1,6,0,Gaston,2023-04-01
2,7,1,6,0,Gaston,2023-04-04
2,3,1,2,0,Gaston,2023-04-07
2,7,1,6,0,Gaston,2023-04-19
2,4,1,3,0,Gaston,2023-04-29
2,4,1,3,0,Gaston,2023-05-02
2,5,1,4,0,Gates,2023-01-10
2,2,1,1,0,Gates,2023-01-16
2,2,1,1,0,Graham,2023-03-05
2,2,1,1,0,Graham,2023-04-07
2,12,1,11,0,Granville,2022-11-16
2,13,1,12,0,Granville,2022-11-23
2,3,1,2,0,Granville,2022-11-27
2,8,1,7,0,Granville,2023-02-17
2,8,1,7,0,Granville,2023-03-22
2,4,1,3,0,Granville,2023-04-25
2,5,1,4,0,Greene,2022-12-16
2,5,1,4,0,Greene,2023-01-14
2,2,1,1,0,Greene,2023-01-18
2,6,1,5,0,Greene,2023-01-23
2,4,1,3,0,Greene,2023-01-24
2,3,1,2,0,Greene,2023-02-13
2,12,1,11,0,Guilford,2023-04-22
2,7,1,6,0,Halifax,2022-11-11
2,10,1,9,0,Halifax,2022-12-01
2,7,1,6,0,Halifax,2023-01-01
2,8,1,7,0,Halifax,2023-03-07
2,5,1,4,0,Halifax,2023-04-07
2,6,1,5,0,Halifax,2023-04-11
2,3,1,2,0,Halifax,2023-04-22
2,10,1,9,0,Harnett,2022-11-27
2,11,1,10,0,Harnett,2023-01-28
2,4,1,3,0,Harnett,2023-03-02
2,8,1,7,0,Harnett,2023-03-21
2,6,1,5,0,Haywood,2022-12-31
2,5,1,4,0,Haywood,2023-02-09
2,4,1,3,0,Haywood,2023-03-03
2,7,1,6,0,Hertford,2023-01-17
2,4,1,3,0,Hertford,2023-03-02
2,5,1,4,0,Hertford,2023-03-11
2,9,1,8,0,Hoke,2022-11-10
2,4,1,3,0,Hoke,2022-11-13
2,7,1,6,0,Hoke,2022-11-17
2,4,1,3,0,Hoke,2022-12-03
2,4,1,3,0,Hoke,2023-02-19
2,8,1,7,0,Hoke,2023-02-22
2,6,1,5,0,Hoke,2023-03-02
2,3,1,2,0,Hoke,2023-03-08
2,6,1,5,0,Hoke,2023-03-16
2,4,1,3,0,Hoke,2023-03-23
2,5,1,4,0,Hoke,2023-03-24
2,5,1,4,0,Hoke,2023-04-12
2,3,1,2,0,Hoke,2023-05-01
2,3,1,2,0,Jackson,2023-04-21
2,6,1,5,0,Johnston,2023-03-12
2,9,1,8,0,Johnston,2023-03-26
2,4,1,3,0,Johnston,2023-04-01
2,7,1,6,0,Johnston,2023-04-21
2,12,1,11,0,Lee,2022-12-06
2,9,1,8,0,Lee,2023-02-13
2,3,1,2,0,Lee,2023-02-22
2,2,1,1,0,Lee,2023-02-24
2,5,1,4,0,Lenoir,2022-11-10
2,6,1,5,0,Lenoir,2022-12-24
2,6,1,5,0,Lenoir,2023-02-05
2,5,1,4,0,Lenoir,2023-03-06
2,3,1,2,0,Lenoir,2023-04-21
2,7,1,6,0,Lincoln,2022-11-23
2,2,1,1,0,Lincoln,2023-04-21
2,8,1,7,0,Macon,2022-12-09
2,4,1,3,0,Macon,2023-01-11
2,3,1,2,0,Macon,2023-02-02
2,4,1,3,0,Macon,2023-02-10
2,2,1,1,0,Madison,2022-12-11
2,3,1,2,0,Madison,2022-12-20
2,3,1,2,0,Madison,2023-01-02
2,2,1,1,0,Martin,2022-12-05
2,8,1,7,0,Martin,2023-01-10
2,6,1,5,0,Martin,2023-01-16
2,5,1,4,0,Martin,2023-02-06
2,5,1,4,0,Martin,2023-02-17
2,14,1,13,0,McDowell,2022-11-28
2,7,1,6,0,McDowell,2022-12-10
2,5,1,4,0,McDowell,2023-01-07
2,6,1,5,0,McDowell,2023-01-20
2,6,1,5,0,McDowell,2023-02-02
2,9,1,8,0,McDowell,2023-02-16
2,5,1,4,0,McDowell,2023-03-22
2,6,1,5,0,McDowell,2023-04-21
2,2,1,1,0,Mitchell,2023-01-26
2,7,1,6,0,Montgomery,2022-11-09
2,5,1,4,0,Montgomery,2023-01-24
2,7,1,6,0,Montgomery,2023-02-09
2,8,1,7,0,Montgomery,2023-02-13
2,7,1,6,0,Moore,2022-11-19
2,5,1,4,0,Moore,2023-02-23
2,5,1,4,0,Moore,2023-02-25
2,9,1,8,0,Moore,2023-03-20
2,3,1,2,0,Nash,2022-11-09
2,5,1,4,0,Nash,2023-03-20
2,2,1,1,0,Nash,2023-04-04
2,3,1,2,0,Nash,2023-05-04
2,4,1,3,0,Northampton,2022-12-06
2,11,1,10,0,Northampton,2023-01-02
2,6,1,5,0,Northampton,2023-01-18
2,6,1,5,0,Northampton,2023-02-14
2,2,1,1,0,Northampton,2023-04-06
2,6,1,5,0,Onslow,2022-11-10
2,13,1,12,0,Onslow,2022-11-21
2,8,1,7,0,Onslow,2022-11-23
2,24,1,23,0,Onslow,2022-12-01
2,14,1,13,0,Onslow,2022-12-25
2,11,1,10,0,Onslow,2023-01-22
2,14,1,13,0,Onslow,2023-02-27
2,6,1,5,0,Onslow,2023-03-15
2,13,1,12,0,Onslow,2023-03-31
2,13,1,12,0,Onslow,2023-04-18
2,16,1,15,0,Orange,2022-11-08
2,4,1,3,0,Orange,2022-11-13
2,13,1,12,0,Orange,2022-12-03
2,9,1,8,0,Orange,2023-02-18
2,4,1,3,0,Orange,2023-03-28
2,7,1,6,0,Orange,2023-03-30
2,7,1,6,0,Pamlico,2022-12-28
2,7,1,6,0,Pender,2022-11-30
2,4,1,3,0,Pender,2022-12-01
2,10,1,9,0,Pender,2023-01-22
2,2,1,1,0,Pender,2023-02-22
2,5,1,4,0,Pender,2023-03-07
2,5,1,4,0,Pender,2023-03-23
2,3,1,2,0,Pender,2023-03-28
2,5,1,4,0,Perquimans,2022-12-21
2,2,1,1,0,Perquimans,2022-12-26
2,5,1,4,0,Person,2022-11-09
2,5,1,4,0,Person,2022-11-16
2,7,1,6,0,Person,2022-12-09
2,6,1,5,0,Person,2022-12-20
2,18,1,17,0,Person,2022-12-27
2,5,1,4,0,Person,2023-01-18
2,5,1,4,0,Person,2023-01-27
2,2,1,1,0,Person,2023-04-17
2,9,1,8,0,Pitt,2023-02-26
2,5,1,4,0,Pitt,2023-03-30
2,5,1,4,0,Pitt,2023-04-24
2,6,1,5,0,Pitt,2023-04-27
2,2,1,1,0,Polk,2022-12-10
2,6,1,5,0,Randolph,2023-04-02
2,6,1,5,0,Richmond,2023-01-22
2,11,1,10,0,Richmond,2023-01-27
2,9,1,8,0,Richmond,2023-01-31
2,7,1,6,0,Richmond,2023-02-10
2,6,1,5,0,Richmond,2023-02-15
2,7,1,6,0,Richmond,2023-02-28
2,4,1,3,0,Richmond,2023-03-06
2,3,1,2,0,Richmond,2023-03-20
2,4,1,3,0,Richmond,2023-03-27
2,3,1,2,0,Richmond,2023-05-03
2,3,1,2,0,Robeson,2023-04-18
2,3,1,2,0,Robeson,2023-04-28
2,4,1,3,0,Robeson,2023-04-30
2,5,1,4,0,Robeson,2023-05-01
2,16,1,15,0,Rockingham,2022-12-24
2,11,1,10,0,Rockingham,2023-02-13
2,5,1,4,0,Rockingham,2023-03-21
2,2,1,1,0,Rockingham,2023-05-05
2,9,1,8,0,Rowan,2022-11-12
2,15,1,14,0,Rowan,2023-02-05
2,9,1,8,0,Rowan,2023-03-20
2,3,1,2,0,Rowan,2023-04-15
2,4,1,3,0,Rowan,2023-04-20
2,9,1,8,0,Rutherford,2022-11-23
2,12,1,11,0,Rutherford,2023-01-17
2,7,1,6,0,Rutherford,2023-01-22
2,8,1,7,0,Rutherford,2023-02-09
2,5,1,4,0,Rutherford,2023-03-08
2,8,1,7,0,Rutherford,2023-03-23
2,3,1,2,0,Rutherford,2023-04-04
2,6,1,5,0,Sampson,2022-11-08
2,5,1,4,0,Sampson,2023-03-17
2,11,1,10,0,Stanly,2022-12-06
2,9,1,8,0,Stanly,2022-12-11
2,20,1,19,0,Stanly,2022-12-23
2,10,1,9,0,Stanly,2023-01-08
2,7,1,6,0,Stanly,2023-01-22
2,8,1,7,0,Stanly,2023-01-30
2,5,1,4,0,Stanly,2023-02-16
2,5,1,4,0,Stokes,2022-11-15
2,7,1,6,0,Stokes,2023-02-28
2,2,1,1,0,Stokes,2023-04-08
2,2,1,1,0,Stokes,2023-04-23
2,12,1,11,0,Surry,2022-11-22
2,4,1,3,0,Surry,2023-03-14
2,4,1,3,0,Surry,2023-03-21
2,7,1,6,0,Surry,2023-04-10
2,4,1,3,0,Surry,2023-04-30
2,3,1,2,0,Swain,2023-02-01
2,3,1,2,0,Tyrrell,2023-01-31
2,5,1,4,0,Union,2023-03-26
2,9,1,8,0,Union,2023-03-31
2,10,1,9,0,Union,2023-04-10
2,6,1,5,0,Vance,2022-12-05
2,9,1,8,0,Vance,2023-01-08
2,4,1,3,0,Vance,2023-02-13
2,8,1,7,0,Vance,2023-02-17
2,6,1,5,0,Vance,2023-02-20
2,5,1,4,0,Vance,2023-02-28
2,6,1,5,0,Vance,2023-03-23
2,4,1,3,0,Vance,2023-04-01
2,3,1,2,0,Vance,2023-04-02
2,3,1,2,0,Vance,2023-04-14
2,3,1,2,0,Vance,2023-04-18
2,3,1,2,0,Vance,2023-04-26
2,3,1,2,0,Warren,2022-11-23
2,6,1,5,0,Warren,2022-12-12
2,6,1,5,0,Warren,2022-12-14
2,4,1,3,0,Warren,2023-01-07
2,5,1,4,0,Warren,2023-01-18
2,3,1,2,0,Warren,2023-02-02
2,2,1,1,0,Warren,2023-02-22
2,5,1,4,0,Watauga,2022-11-22
2,5,1,4,0,Watauga,2023-01-08
2,7,1,6,0,Watauga,2023-01-12
2,3,1,2,0,Watauga,2023-02-04
2,5,1,4,0,Wayne,2022-11-24
2,5,1,4,0,Wilkes,2022-11-23
2,5,1,4,0,Wilkes,2023-03-18
2,6,1,5,0,Wilkes,2023-03-30
2,3,1,2,0,Wilson,2022-11-13
2,8,1,7,0,Wilson,2022-11-27
2,3,1,2,0,Wilson,2022-12-03
2,3,1,2,0,Wilson,2023-04-12
2,13,1,12,0,Yadkin,2023-02-02
2,4,1,3,0,Yadkin,2023-02-12
2,9,1,8,0,Yadkin,2023-02-17
2,9,1,8,0,Yadkin,2023-02-22
2,4,1,3,0,Yadkin,2023-03-20
2,4,1,3,0,Yadkin,2023-04-29
2,2,1,1,0,Yancey,2022-12-29
2,3,1,2,0,Yancey,2023-02-09
2,3,1,2,0,Yancey,2023-03-21
2,23,2,21,0,Alamance,2022-11-14
2,10,2,8,0,Alamance,2023-03-08
2,11,2,9,0,Alamance,2023-03-09
2,14,2,12,0,Alamance,2023-03-23
2,11,2,9,0,Alexander,2022-12-16
2,5,2,3,0,Alexander,2022-12-18
2,5,2,3,0,Alexander,2023-01-24
2,4,2,2,0,Alexander,2023-01-29
2,5,2,3,0,Alexander,2023-01-31
2,4,2,2,0,Alexander,2023-02-20
2,2,2,0,0,Alexander,2023-04-07
2,5,2,3,0,Alleghany,2022-12-04
2,2,2,0,0,Alleghany,2023-01-09
2,3,2,1,0,Alleghany,2023-01-27
2,5,2,3,0,Alleghany,2023-02-10
2,3,2,1,0,Alleghany,2023-02-11
2,5,2,3,0,Anson,2022-12-31
2,4,2,2,0,Anson,2023-03-12
2,3,2,1,0,Anson,2023-05-02
2,2,2,0,0,Ashe,2022-11-12
2,5,2,3,0,Ashe,2022-12-18
2,5,2,3,0,Ashe,2023-01-02
2,5,2,3,0,Ashe,2023-01-19
2,5,2,3,0,Ashe,2023-01-20
2,3,2,1,0,Ashe,2023-02-26
2,6,2,4,0,Beaufort,2022-11-28
2,8,2,6,0,Beaufort,2022-12-22
2,8,2,6,0,Beaufort,2023-01-18
2,8,2,6,0,Beaufort,2023-02-09
2,4,2,2,0,Beaufort,2023-03-08
2,5,2,3,0,Bertie,2022-12-11
2,6,2,4,0,Bertie,2022-12-22
2,9,2,7,0,Bladen,2022-12-11
2,6,2,4,0,Bladen,2023-02-14
2,14,2,12,0,Brunswick,2023-01-29
2,11,2,9,0,Brunswick,2023-03-14
2,11,2,9,0,Brunswick,2023-04-04
2,8,2,6,0,Brunswick,2023-04-11
2,6,2,4,0,Brunswick,2023-04-19
2,10,2,8,0,Brunswick,2023-04-25
2,8,2,6,0,Buncombe,2023-04-08
2,11,2,9,0,Buncombe,2023-05-05
2,14,2,12,0,Burke,2022-11-30
2,11,2,9,0,Burke,2023-01-21
2,11,2,9,0,Burke,2023-01-31
2,9,2,7,0,Burke,2023-02-12
2,14,2,12,0,Burke,2023-02-17
2,14,2,12,0,Cabarrus,2023-04-17
2,10,2,8,0,Cabarrus,2023-04-19
2,8,2,6,0,Caldwell,2023-02-19
2,8,2,6,0,Caldwell,2023-03-20
2,5,2,3,0,Caldwell,2023-04-14
2,3,2,1,0,Camden,2022-11-30
2,6,2,4,0,Carteret,2023-02-01
2,5,2,3,0,Carteret,2023-02-05
2,3,2,1,0,Catawba,2023-04-14
2,14,2,12,0,Chatham,2022-11-18
2,13,2,11,0,Chatham,2022-11-27
2,8,2,6,0,Chatham,2023-02-14
2,9,2,7,0,Chatham,2023-03-27
2,5,2,3,0,Cherokee,2022-12-15
2,5,2,3,0,Chowan,2023-01-04
2,2,2,0,0,Chowan,2023-05-03
2,4,2,2,0,Clay,2022-12-27
2,7,2,5,0,Clay,2022-12-28
2,4,2,2,0,Clay,2022-12-30
2,11,2,9,0,Cleveland,2022-11-22
2,8,2,6,0,Cleveland,2022-11-27
2,16,2,14,0,Cleveland,2022-12-11
2,8,2,6,0,Cleveland,2023-03-01
2,6,2,4,0,Cleveland,2023-03-04
2,5,2,3,0,Columbus,2023-02-06
2,10,2,8,0,Columbus,2023-02-20
2,2,2,0,0,Columbus,2023-04-10
2,8,2,6,0,Craven,2022-11-08
2,6,2,4,0,Craven,2022-11-12
2,3,2,1,0,Craven,2023-02-26
2,6,2,4,0,Craven,2023-03-17
2,6,2,4,0,Craven,2023-04-04
2,9,2,7,0,Cumberland,2023-04-12
2,8,2,6,0,Cumberland,2023-04-22
2,6,2,4,0,Cumberland,2023-04-30
2,5,2,3,0,Currituck,2023-01-18
2,8,2,6,0,Currituck,2023-01-25
2,6,2,4,0,Currituck,2023-03-17
2,3,2,1,0,Currituck,2023-03-24
2,15,2,13,0,Davidson,2022-11-09
2,11,2,9,0,Davidson,2023-02-05
2,7,2,5,0,Davie,2023-01-21
2,3,2,1,0,Davie,2023-04-06
2,16,2,14,0,Durham,2023-04-17
2,16,2,14,0,Edgecombe,2022-12-31
2,8,2,6,0,Edgecombe,2023-01-20
2,13,2,11,0,Forsyth,2023-04-09
2,9,2,7,0,Franklin,2022-11-15
2,11,2,9,0,Franklin,2022-11-23
2,15,2,13,0,Franklin,2022-12-21
2,9,2,7,0,Franklin,2023-01-07
2,19,2,17,0,Franklin,2023-01-13
2,9,2,7,0,Franklin,2023-01-27
2,5,2,3,0,Franklin,2023-02-28
2,5,2,3,0,Franklin,2023-03-14
2,3,2,1,0,Franklin,2023-03-26
2,3,2,1,0,Franklin,2023-04-18
2,13,2,11,0,Gaston,2023-03-02
2,7,2,5,0,Gaston,2023-03-05
2,7,2,5,0,Gaston,2023-03-28
2,8,2,6,0,Gaston,2023-04-11
2,4,2,2,0,Gaston,2023-04-23
2,2,2,0,0,Graham,2022-12-12
2,4,2,2,0,Graham,2023-01-04
2,2,2,0,0,Graham,2023-02-23
2,10,2,8,0,Granville,2022-12-04
2,6,2,4,0,Granville,2023-01-21
2,5,2,3,0,Granville,2023-03-01
2,6,2,4,0,Granville,2023-03-21
2,7,2,5,0,Granville,2023-04-04
2,5,2,3,0,Greene,2023-02-14
2,8,2,6,0,Guilford,2023-03-11
2,3,2,1,0,Halifax,2023-03-13
2,13,2,11,0,Harnett,2022-11-08
2,19,2,17,0,Harnett,2022-11-29
2,11,2,9,0,Harnett,2023-02-08
2,7,2,5,0,Harnett,2023-02-11
2,18,2,16,0,Harnett,2023-02-16
2,7,2,5,0,Harnett,2023-03-14
2,6,2,4,0,Harnett,2023-03-31
2,6,2,4,0,Harnett,2023-04-07
2,9,2,7,0,Haywood,2023-01-06
2,6,2,4,0,Haywood,2023-02-13
2,7,2,5,0,Haywood,2023-02-27
2,4,2,2,0,Haywood,2023-03-21
2,7,2,5,0,Henderson,2023-03-04
2,6,2,4,0,Henderson,2023-03-07
2,6,2,4,0,Henderson,2023-03-18
2,10,2,8,0,Henderson,2023-03-20
2,6,2,4,0,Henderson,2023-04-09
2,4,2,2,0,Henderson,2023-04-15
2,2,2,0,0,Henderson,2023-05-05
2,3,2,1,0,Henderson,2023-05-06
2,7,2,5,0,Hertford,2023-02-07
2,6,2,4,0,Hertford,2023-02-09
2,6,2,4,0,Hoke,2022-11-16
2,7,2,5,0,Hoke,2022-12-16
2,16,2,14,0,Hoke,2022-12-23
2,9,2,7,0,Hoke,2022-12-24
2,12,2,10,0,Hoke,2023-02-01
2,11,2,9,0,Hoke,2023-02-14
2,11,2,9,0,Hoke,2023-02-16
2,9,2,7,0,Jackson,2022-12-26
2,4,2,2,0,Jackson,2023-01-06
2,5,2,3,0,Jackson,2023-02-05
2,7,2,5,0,Johnston,2023-03-17
2,5,2,3,0,Johnston,2023-04-14
2,8,2,6,0,Lee,2022-11-10
2,10,2,8,0,Lee,2022-11-21
2,10,2,8,0,Lee,2022-11-29
2,5,2,3,0,Lee,2023-02-12
2,3,2,1,0,Lee,2023-03-16
2,9,2,7,0,Lenoir,2022-11-21
2,8,2,6,0,Lenoir,2022-12-16
2,15,2,13,0,Lenoir,2023-01-12
2,8,2,6,0,Lenoir,2023-01-26
2,7,2,5,0,Lenoir,2023-02-11
2,6,2,4,0,Lincoln,2022-11-24
2,5,2,3,0,Lincoln,2023-03-12
2,2,2,0,0,Macon,2023-02-14
2,3,2,1,0,Madison,2022-11-28
2,8,2,6,0,Madison,2022-12-27
2,2,2,0,0,Madison,2023-01-13
2,2,2,0,0,Madison,2023-04-27
2,8,2,6,0,McDowell,2022-12-03
2,13,2,11,0,McDowell,2022-12-09
2,8,2,6,0,McDowell,2023-02-13
2,3,2,1,0,McDowell,2023-04-01
2,4,2,2,0,McDowell,2023-05-05
2,6,2,4,0,Mitchell,2023-02-08
2,2,2,0,0,Montgomery,2022-11-13
2,11,2,9,0,Montgomery,2022-12-20
2,4,2,2,0,Montgomery,2023-01-06
2,2,2,0,0,Montgomery,2023-01-14
2,4,2,2,0,Montgomery,2023-02-03
2,5,2,3,0,Montgomery,2023-02-21
2,7,2,5,0,Moore,2023-03-11
2,10,2,8,0,Moore,2023-03-14
2,5,2,3,0,Nash,2022-11-26
2,9,2,7,0,Nash,2022-12-01
2,9,2,7,0,Nash,2023-02-11
2,3,2,1,0,Nash,2023-04-05
2,5,2,3,0,Nash,2023-04-06
2,6,2,4,0,New Hanover,2022-11-19
2,18,2,16,0,New Hanover,2023-01-01
2,13,2,11,0,New Hanover,2023-01-21
2,4,2,2,0,Northampton,2022-11-30
2,2,2,0,0,Northampton,2022-12-07
2,10,2,8,0,Northampton,2022-12-30
2,3,2,1,0,Northampton,2023-02-13
2,7,2,5,0,Onslow,2022-11-12
2,22,2,20,0,Onslow,2022-12-23
2,14,2,12,0,Onslow,2023-01-01
2,16,2,14,0,Orange,2022-11-09
2,21,2,19,0,Orange,2022-12-02
2,23,2,21,0,Orange,2022-12-10
2,6,2,4,0,Orange,2023-03-12
2,9,2,7,0,Orange,2023-03-21
2,11,2,9,0,Orange,2023-03-31
2,9,2,7,0,Orange,2023-04-07
2,8,2,6,0,Orange,2023-04-17
2,7,2,5,0,Pasquotank,2022-12-05
2,2,2,0,0,Pasquotank,2023-03-17
2,7,2,5,0,Pender,2022-11-21
2,11,2,9,0,Pender,2022-12-20
2,12,2,10,0,Pender,2022-12-23
2,12,2,10,0,Pender,2023-01-10
2,11,2,9,0,Pender,2023-01-11
2,6,2,4,0,Perquimans,2022-12-27
2,7,2,5,0,Person,2022-11-14
2,9,2,7,0,Person,2023-01-23
2,4,2,2,0,Person,2023-02-05
2,2,2,0,0,Person,2023-05-04
2,9,2,7,0,Pitt,2022-11-12
2,10,2,8,0,Pitt,2022-11-20
2,6,2,4,0,Pitt,2023-02-04
2,5,2,3,0,Pitt,2023-03-04
2,4,2,2,0,Polk,2022-11-30
2,3,2,1,0,Polk,2023-02-12
2,5,2,3,0,Randolph,2022-11-20
2,9,2,7,0,Randolph,2023-02-05
2,4,2,2,0,Randolph,2023-05-01
2,5,2,3,0,Richmond,2022-11-08
2,6,2,4,0,Richmond,2022-11-16
2,5,2,3,0,Richmond,2023-01-14
2,6,2,4,0,Richmond,2023-02-22
2,7,2,5,0,Rockingham,2022-11-08
2,5,2,3,0,Rockingham,2022-11-19
2,7,2,5,0,Rockingham,2022-11-27
2,12,2,10,0,Rockingham,2022-12-08
2,11,2,9,0,Rockingham,2023-01-07
2,11,2,9,0,Rockingham,2023-01-26
2,3,2,1,0,Rockingham,2023-04-06
2,13,2,11,0,Rowan,2022-11-17
2,9,2,7,0,Rowan,2022-11-26
2,9,2,7,0,Rowan,2022-12-11
2,6,2,4,0,Rowan,2023-03-05
2,13,2,11,0,Rowan,2023-03-07
2,6,2,4,0,Rowan,2023-04-12
2,7,2,5,0,Rowan,2023-04-23
2,10,2,8,0,Rutherford,2022-12-10
2,12,2,10,0,Rutherford,2023-01-07
2,10,2,8,0,Rutherford,2023-02-01
2,2,2,0,0,Rutherford,2023-04-09
2,4,2,2,0,Rutherford,2023-04-19
2,3,2,1,0,Sampson,2023-04-10
2,6,2,4,0,Scotland,2023-01-13
2,22,2,20,0,Scotland,2023-01-25
2,2,2,0,0,Scotland,2023-03-26
2,5,2,3,0,Scotland,2023-03-31
2,2,2,0,0,Scotland,2023-04-25
2,6,2,4,0,Stanly,2023-04-03
2,7,2,5,0,Stokes,2022-11-08
2,8,2,6,0,Stokes,2022-11-22
2,9,2,7,0,Stokes,2022-11-23
2,11,2,9,0,Stokes,2022-11-29
2,8,2,6,0,Stokes,2023-01-08
2,13,2,11,0,Stokes,2023-01-16
2,13,2,11,0,Stokes,2023-01-30
2,6,2,4,0,Stokes,2023-02-24
2,4,2,2,0,Stokes,2023-03-27
2,6,2,4,0,Stokes,2023-04-06
2,4,2,2,0,Stokes,2023-05-01
2,11,2,9,0,Surry,2022-12-25
2,12,2,10,0,Surry,2023-01-21
2,12,2,10,0,Surry,2023-02-11
2,6,2,4,0,Surry,2023-03-10
2,5,2,3,0,Surry,2023-04-04
2,3,2,1,0,Swain,2022-11-21
2,3,2,1,0,Swain,2022-11-30
2,2,2,0,0,Swain,2023-04-04
2,2,2,0,0,Swain,2023-04-11
2,8,2,6,0,Transylvania,2022-12-28
2,6,2,4,0,Transylvania,2022-12-31
2,8,2,6,0,Transylvania,2023-01-25
2,4,2,2,0,Transylvania,2023-02-09
2,4,2,2,0,Tyrrell,2023-02-14
2,13,2,11,0,Union,2023-02-12
2,8,2,6,0,Union,2023-04-22
2,7,2,5,0,Union,2023-05-04
2,8,2,6,0,Vance,2022-12-11
2,6,2,4,0,Vance,2023-01-22
2,5,2,3,0,Vance,2023-02-05
2,11,2,9,0,Vance,2023-02-11
2,6,2,4,0,Warren,2022-12-01
2,7,2,5,0,Warren,2023-01-03
2,8,2,6,0,Warren,2023-01-04
2,9,2,7,0,Warren,2023-01-25
2,2,2,0,0,Warren,2023-01-28
2,4,2,2,0,Warren,2023-04-21
2,12,2,10,0,Watauga,2022-11-15
2,10,2,8,0,Watauga,2023-02-03
2,3,2,1,0,Wayne,2023-04-12
2,6,2,4,0,Wayne,2023-04-13
2,3,2,1,0,Wayne,2023-04-22
2,10,2,8,0,Wilkes,2023-01-27
2,4,2,2,0,Wilkes,2023-03-12
2,2,2,0,0,Wilkes,2023-03-19
2,2,2,0,0,Wilkes,2023-04-06
2,4,2,2,0,Wilkes,2023-04-07
2,4,2,2,0,Wilkes,2023-05-03
2,6,2,4,0,Wilson,2022-11-17
2,10,2,8,0,Wilson,2023-01-28
2,6,2,4,0,Wilson,2023-03-19
2,5,2,3,0,Wilson,2023-03-21
2,3,2,1,0,Wilson,2023-04-18
2,5,2,3,0,Yadkin,2022-11-28
2,7,2,5,0,Yadkin,2023-01-23
2,10,2,8,0,Yadkin,2023-02-03
2,6,2,4,0,Yadkin,2023-02-19
2,9,2,7,0,Yadkin,2023-02-23
2,8,2,6,0,Yadkin,2023-02-27
2,5,2,3,0,Yancey,2022-11-28
2,4,2,2,0,Yancey,2022-12-08
2,4,2,2,0,Yancey,2022-12-19
2,4,2,2,0,Yancey,2023-01-02
2,2,2,0,0,Yancey,2023-04-16
2,12,3,9,0,Alamance,2023-02-23
2,5,3,2,0,Alamance,2023-03-18
2,10,3,7,0,Alamance,2023-04-04
2,5,3,2,0,Alamance,2023-04-14
2,10,3,7,0,Alamance,2023-04-26
2,9,3,6,0,Alexander,2022-12-05
2,6,3,3,0,Alexander,2022-12-23
2,9,3,6,0,Alexander,2023-01-04
2,5,3,2,0,Alexander,2023-01-27
2,5,3,2,0,Alleghany,2022-12-14
2,4,3,1,0,Alleghany,2023-01-31
2,5,3,2,0,Alleghany,2023-02-06
2,6,3,3,0,Anson,2023-01-27
2,6,3,3,0,Anson,2023-02-04
2,5,3,2,0,Anson,2023-02-10
2,6,3,3,0,Ashe,2023-03-10
2,3,3,0,0,Ashe,2023-03-22
2,11,3,8,0,Beaufort,2022-12-21
2,11,3,8,0,Beaufort,2023-01-12
2,8,3,5,0,Beaufort,2023-02-10
2,6,3,3,0,Beaufort,2023-03-06
2,6,3,3,0,Beaufort,2023-03-21
2,7,3,4,0,Bladen,2022-12-17
2,20,3,17,0,Bladen,2023-01-06
2,20,3,17,0,Bladen,2023-01-11
2,21,3,18,0,Bladen,2023-01-24
2,11,3,8,0,Brunswick,2022-11-11
2,8,3,5,0,Brunswick,2022-11-18
2,26,3,23,0,Brunswick,2022-11-28
2,14,3,11,0,Brunswick,2022-12-09
2,10,3,7,0,Brunswick,2023-03-08
2,4,3,1,0,Buncombe,2023-04-07
2,10,3,7,0,Buncombe,2023-04-10
2,11,3,8,0,Burke,2022-11-14
2,4,3,1,0,Burke,2023-01-13
2,16,3,13,0,Cabarrus,2023-02-19
2,9,3,6,0,Cabarrus,2023-03-08
2,13,3,10,0,Cabarrus,2023-05-03
2,13,3,10,0,Caldwell,2022-11-25
2,19,3,16,0,Caldwell,2022-12-01
2,11,3,8,0,Caldwell,2023-02-25
2,7,3,4,0,Caldwell,2023-04-03
2,5,3,2,0,Carteret,2022-11-15
2,8,3,5,0,Carteret,2022-12-09
2,8,3,5,0,Caswell,2023-01-04
2,8,3,5,0,Catawba,2023-05-01
2,16,3,13,0,Chatham,2022-12-17
2,17,3,14,0,Chatham,2022-12-23
2,9,3,6,0,Chatham,2023-01-08
2,16,3,13,0,Chatham,2023-01-11
2,18,3,15,0,Chatham,2023-02-03
2,13,3,10,0,Chatham,2023-02-07
2,9,3,6,0,Chatham,2023-02-13
2,9,3,6,0,Cherokee,2022-11-14
2,4,3,1,0,Chowan,2023-04-28
2,8,3,5,0,Cleveland,2022-11-15
2,11,3,8,0,Cleveland,2022-12-04
2,9,3,6,0,Cleveland,2022-12-18
2,12,3,9,0,Cleveland,2023-02-23
2,4,3,1,0,Cleveland,2023-03-11
2,9,3,6,0,Columbus,2022-12-06
2,24,3,21,0,Craven,2022-12-14
2,6,3,3,0,Craven,2023-03-02
2,7,3,4,0,Craven,2023-03-24
2,4,3,1,0,Craven,2023-04-28
2,15,3,12,0,Cumberland,2022-11-12
2,11,3,8,0,Cumberland,2023-03-24
2,11,3,8,0,Cumberland,2023-04-07
2,5,3,2,0,Currituck,2023-03-20
2,8,3,5,0,Davie,2022-11-21
2,5,3,2,0,Davie,2022-12-11
2,11,3,8,0,Davie,2022-12-24
2,11,3,8,0,Davie,2023-01-20
2,9,3,6,0,Davie,2023-02-27
2,9,3,6,0,Davie,2023-03-07
2,11,3,8,0,Duplin,2022-12-07
2,5,3,2,0,Duplin,2023-02-17
2,6,3,3,0,Duplin,2023-02-22
2,25,3,22,0,Durham,2022-11-20
2,12,3,9,0,Durham,2023-04-07
2,18,3,15,0,Edgecombe,2022-12-29
2,8,3,5,0,Edgecombe,2023-01-24
2,11,3,8,0,Forsyth,2023-03-11
2,11,3,8,0,Forsyth,2023-04-07
2,16,3,13,0,Franklin,2022-12-09
2,18,3,15,0,Franklin,2022-12-31
2,19,3,16,0,Franklin,2023-01-10
2,8,3,5,0,Gaston,2023-03-19
2,5,3,2,0,Gaston,2023-04-18
2,3,3,0,0,Graham,2022-11-10
2,10,3,7,0,Granville,2022-11-21
2,15,3,12,0,Granville,2022-12-05
2,5,3,2,0,Granville,2022-12-10
2,11,3,8,0,Granville,2023-01-28
2,8,3,5,0,Greene,2023-02-02
2,6,3,3,0,Greene,2023-02-07
2,6,3,3,0,Greene,2023-02-09
2,10,3,7,0,Halifax,2023-02-10
2,8,3,5,0,Halifax,2023-02-27
2,8,3,5,0,Halifax,2023-03-20
2,11,3,8,0,Harnett,2022-11-23
2,9,3,6,0,Harnett,2023-01-15
2,15,3,12,0,Harnett,2023-02-24
2,7,3,4,0,Harnett,2023-02-26
2,10,3,7,0,Harnett,2023-03-22
2,10,3,7,0,Harnett,2023-04-04
2,6,3,3,0,Haywood,2022-12-03
2,7,3,4,0,Haywood,2023-02-16
2,12,3,9,0,Haywood,2023-02-22
2,4,3,1,0,Haywood,2023-03-09
2,4,3,1,0,Haywood,2023-04-03
2,13,3,10,0,Henderson,2022-12-10
2,6,3,3,0,Henderson,2023-03-25
2,10,3,7,0,Henderson,2023-04-05
2,11,3,8,0,Hertford,2022-12-01
2,5,3,2,0,Hertford,2023-01-30
2,10,3,7,0,Hoke,2022-12-17
2,8,3,5,0,Hoke,2023-01-01
2,15,3,12,0,Hoke,2023-01-13
2,5,3,2,0,Iredell,2023-03-10
2,7,3,4,0,Iredell,2023-04-25
2,8,3,5,0,Jackson,2022-11-21
2,7,3,4,0,Jackson,2022-11-30
2,6,3,3,0,Jackson,2023-01-17
2,7,3,4,0,Jackson,2023-01-31
2,7,3,4,0,Jackson,2023-02-14
2,9,3,6,0,Jackson,2023-02-16
2,6,3,3,0,Jackson,2023-02-23
2,7,3,4,0,Jackson,2023-02-27
2,4,3,1,0,Jackson,2023-03-01
2,14,3,11,0,Johnston,2022-11-24
2,18,3,15,0,Johnston,2023-01-29
2,15,3,12,0,Johnston,2023-03-08
2,10,3,7,0,Lee,2022-11-28
2,8,3,5,0,Lee,2023-01-07
2,11,3,8,0,Lee,2023-01-12
2,13,3,10,0,Lee,2023-01-16
2,4,3,1,0,Lee,2023-01-29
2,7,3,4,0,Lee,2023-02-15
2,14,3,11,0,Lenoir,2022-12-09
2,16,3,13,0,Lenoir,2023-02-17
2,5,3,2,0,Lenoir,2023-03-20
2,15,3,12,0,Lincoln,2022-12-01
2,5,3,2,0,Lincoln,2023-03-04
2,10,3,7,0,Macon,2022-12-06
2,8,3,5,0,Macon,2022-12-27
2,4,3,1,0,Macon,2023-01-17
2,5,3,2,0,Madison,2022-12-21
2,7,3,4,0,McDowell,2023-01-12
2,8,3,5,0,McDowell,2023-01-29
2,7,3,4,0,McDowell,2023-02-11
2,11,3,8,0,McDowell,2023-02-15
2,8,3,5,0,Montgomery,2023-01-16
2,4,3,1,0,Montgomery,2023-01-22
2,3,3,0,0,Montgomery,2023-03-17
2,6,3,3,0,Moore,2022-11-11
2,7,3,4,0,Moore,2022-11-23
2,9,3,6,0,Moore,2022-12-05
2,6,3,3,0,Moore,2023-03-15
2,7,3,4,0,Nash,2023-01-29
2,8,3,5,0,Nash,2023-03-13
2,4,3,1,0,Nash,2023-04-07
2,13,3,10,0,New Hanover,2022-11-11
2,6,3,3,0,New Hanover,2023-04-12
2,6,3,3,0,Northampton,2022-11-21
2,9,3,6,0,Northampton,2022-12-21
2,8,3,5,0,Northampton,2023-01-30
2,14,3,11,0,Onslow,2022-11-18
2,25,3,22,0,Orange,2023-02-14
2,13,3,10,0,Orange,2023-04-01
2,12,3,9,0,Orange,2023-04-10
2,7,3,4,0,Pasquotank,2022-12-06
2,9,3,6,0,Pasquotank,2022-12-29
2,8,3,5,0,Pasquotank,2023-01-05
2,5,3,2,0,Pasquotank,2023-01-17
2,20,3,17,0,Pender,2022-12-27
2,4,3,1,0,Pender,2023-03-01
2,3,3,0,0,Perquimans,2023-04-03
2,4,3,1,0,Person,2023-01-01
2,3,3,0,0,Person,2023-03-14
2,7,3,4,0,Pitt,2023-04-11
2,5,3,2,0,Polk,2022-12-12
2,5,3,2,0,Polk,2022-12-14
2,6,3,3,0,Polk,2023-01-03
2,8,3,5,0,Randolph,2022-11-16
2,12,3,9,0,Randolph,2022-11-27
2,8,3,5,0,Randolph,2023-03-16
2,4,3,1,0,Randolph,2023-04-13
2,6,3,3,0,Richmond,2022-11-18
2,8,3,5,0,Richmond,2022-11-29
2,10,3,7,0,Richmond,2022-12-14
2,18,3,15,0,Richmond,2023-01-04
2,6,3,3,0,Richmond,2023-02-27
2,3,3,0,0,Richmond,2023-03-21
2,9,3,6,0,Robeson,2022-11-26
2,8,3,5,0,Robeson,2023-02-26
2,16,3,13,0,Robeson,2023-03-01
2,8,3,5,0,Robeson,2023-03-13
2,5,3,2,0,Robeson,2023-03-24
2,4,3,1,0,Robeson,2023-05-04
2,9,3,6,0,Rockingham,2022-11-09
2,18,3,15,0,Rockingham,2022-12-01
2,15,3,12,0,Rockingham,2022-12-11
2,23,3,20,0,Rockingham,2022-12-20
2,9,3,6,0,Rockingham,2023-03-06
2,5,3,2,0,Rockingham,2023-04-05
2,16,3,13,0,Rowan,2022-11-23
2,14,3,11,0,Rowan,2022-12-04
2,11,3,8,0,Rowan,2023-02-23
2,9,3,6,0,Rowan,2023-03-17
2,14,3,11,0,Rowan,2023-03-28
2,7,3,4,0,Rowan,2023-03-30
2,8,3,5,0,Rowan,2023-05-02
2,5,3,2,0,Sampson,2022-11-17
2,6,3,3,0,Scotland,2022-11-10
2,5,3,2,0,Scotland,2022-12-04
2,4,3,1,0,Scotland,2022-12-11
2,12,3,9,0,Stanly,2022-12-17
2,3,3,0,0,Stanly,2023-04-28
2,12,3,9,0,Stokes,2022-11-12
2,11,3,8,0,Stokes,2022-11-30
2,7,3,4,0,Surry,2022-11-15
2,10,3,7,0,Surry,2022-11-23
2,7,3,4,0,Surry,2023-03-28
2,3,3,0,0,Swain,2023-02-03
2,4,3,1,0,Swain,2023-02-11
2,6,3,3,0,Transylvania,2022-11-28
2,10,3,7,0,Transylvania,2022-12-20
2,5,3,2,0,Tyrrell,2022-12-28
2,14,3,11,0,Union,2023-05-05
2,6,3,3,0,Vance,2022-11-10
2,6,3,3,0,Vance,2022-11-30
2,9,3,6,0,Vance,2023-02-14
2,10,3,7,0,Vance,2023-02-15
2,4,3,1,0,Vance,2023-04-11
2,6,3,3,0,Warren,2023-01-13
2,5,3,2,0,Warren,2023-03-03
2,7,3,4,0,Washington,2023-02-15
2,10,3,7,0,Watauga,2022-12-08
2,6,3,3,0,Watauga,2023-01-11
2,8,3,5,0,Wayne,2022-12-10
2,5,3,2,0,Wayne,2023-02-04
2,10,3,7,0,Wayne,2023-03-24
2,6,3,3,0,Wayne,2023-03-31
2,3,3,0,0,Wayne,2023-04-20
2,5,3,2,0,Wayne,2023-04-27
2,5,3,2,0,Wilkes,2022-11-12
2,5,3,2,0,Wilkes,2022-11-21
2,6,3,3,0,Wilkes,2022-11-26
2,9,3,6,0,Wilkes,2023-02-28
2,6,3,3,0,Wilkes,2023-03-03
2,5,3,2,0,Wilkes,2023-03-11
2,6,3,3,0,Wilkes,2023-03-16
2,4,3,1,0,Wilkes,2023-04-28
2,9,3,6,0,Wilkes,2023-05-05
2,7,3,4,0,Wilson,2022-11-11
2,3,3,0,0,Wilson,2023-03-11
2,6,3,3,0,Yadkin,2022-11-19
2,9,4,5,0,Alamance,2023-04-10
2,6,4,2,0,Alamance,2023-05-03
2,8,4,4,0,Alexander,2022-12-20
2,4,4,0,0,Alexander,2023-01-19
2,5,4,1,0,Alexander,2023-02-07
2,7,4,3,0,Bladen,2022-11-29
2,17,4,13,0,Brunswick,2023-03-15
2,11,4,7,0,Brunswick,2023-03-28
2,18,4,14,0,Buncombe,2023-02-11
2,11,4,7,0,Buncombe,2023-04-11
2,16,4,12,0,Burke,2022-11-08
2,14,4,10,0,Burke,2023-02-06
2,17,4,13,0,Cabarrus,2023-02-11
2,10,4,6,0,Cabarrus,2023-03-19
2,17,4,13,0,Caldwell,2023-01-15
2,14,4,10,0,Caldwell,2023-02-11
2,5,4,1,0,Carteret,2022-12-02
2,15,4,11,0,Carteret,2022-12-12
2,10,4,6,0,Carteret,2023-01-01
2,16,4,12,0,Carteret,2023-01-23
2,7,4,3,0,Carteret,2023-02-08
2,7,4,3,0,Carteret,2023-03-29
2,7,4,3,0,Catawba,2023-04-15
2,5,4,1,0,Catawba,2023-05-05
2,12,4,8,0,Chatham,2023-02-06
2,11,4,7,0,Chatham,2023-02-08
2,17,4,13,0,Cleveland,2023-01-27
2,12,4,8,0,Cleveland,2023-01-29
2,10,4,6,0,Columbus,2022-12-31
2,13,4,9,0,Craven,2022-11-16
2,14,4,10,0,Craven,2023-02-14
2,7,4,3,0,Craven,2023-03-21
2,17,4,13,0,Cumberland,2023-04-11
2,6,4,2,0,Cumberland,2023-05-03
2,11,4,7,0,Cumberland,2023-05-05
2,19,4,15,0,Davidson,2022-12-10
2,7,4,3,0,Davie,2022-12-01
2,7,4,3,0,Davie,2023-02-23
2,10,4,6,0,Davie,2023-02-28
2,6,4,2,0,Duplin,2023-02-16
2,6,4,2,0,Duplin,2023-03-17
2,34,4,30,0,Forsyth,2022-11-18
2,18,4,14,0,Forsyth,2022-11-20
2,10,4,6,0,Franklin,2022-12-11
2,9,4,5,0,Franklin,2023-02-23
2,13,4,9,0,Gaston,2023-02-27
2,8,4,4,0,Gaston,2023-05-04
2,4,4,0,0,Graham,2022-12-27
2,12,4,8,0,Granville,2022-11-14
2,19,4,15,0,Granville,2022-12-23
2,10,4,6,0,Guilford,2023-03-25
2,7,4,3,0,Halifax,2023-03-21
2,5,4,1,0,Halifax,2023-05-03
2,16,4,12,0,Harnett,2023-01-16
2,9,4,5,0,Harnett,2023-02-27
2,9,4,5,0,Harnett,2023-03-09
2,9,4,5,0,Haywood,2022-11-29
2,22,4,18,0,Henderson,2022-12-17
2,13,4,9,0,Henderson,2023-02-23
2,9,4,5,0,Henderson,2023-03-05
2,11,4,7,0,Henderson,2023-04-13
2,8,4,4,0,Hertford,2023-01-06
2,20,4,16,0,Hoke,2022-12-21
2,10,4,6,0,Iredell,2023-03-17
2,11,4,7,0,Iredell,2023-03-26
2,10,4,6,0,Jackson,2023-02-06
2,7,4,3,0,Jackson,2023-03-02
2,6,4,2,0,Jackson,2023-03-05
2,7,4,3,0,Jackson,2023-03-06
2,5,4,1,0,Jackson,2023-04-10
2,23,4,19,0,Johnston,2022-11-15
2,10,4,6,0,Johnston,2023-04-03
2,6,4,2,0,Lee,2022-11-27
2,13,4,9,0,Lee,2022-12-04
2,18,4,14,0,Lee,2022-12-30
2,4,4,0,0,Lee,2023-02-18
2,11,4,7,0,Lincoln,2023-02-17
2,12,4,8,0,Lincoln,2023-03-08
2,10,4,6,0,Macon,2022-12-14
2,6,4,2,0,McDowell,2022-11-09
2,6,4,2,0,McDowell,2022-11-12
2,5,4,1,0,McDowell,2023-04-16
2,5,4,1,0,Mitchell,2022-11-16
2,5,4,1,0,Mitchell,2022-12-22
2,7,4,3,0,Montgomery,2022-12-19
2,9,4,5,0,Moore,2022-11-18
2,12,4,8,0,Moore,2023-02-08
2,11,4,7,0,Moore,2023-03-13
2,15,4,11,0,Nash,2022-12-09
2,15,4,11,0,New Hanover,2022-11-16
2,14,4,10,0,New Hanover,2022-12-10
2,5,4,1,0,Northampton,2022-12-05
2,8,4,4,0,Northampton,2022-12-27
2,8,4,4,0,Northampton,2023-02-09
2,18,4,14,0,Orange,2023-01-01
2,23,4,19,0,Orange,2023-02-08
2,6,4,2,0,Orange,2023-03-16
2,6,4,2,0,Pasquotank,2023-01-21
2,14,4,10,0,Pender,2022-12-22
2,11,4,7,0,Pender,2023-01-20
2,12,4,8,0,Pender,2023-02-02
2,8,4,4,0,Pender,2023-02-16
2,8,4,4,0,Perquimans,2022-12-20
2,10,4,6,0,Person,2023-02-03
2,16,4,12,0,Pitt,2023-01-01
2,6,4,2,0,Polk,2022-12-16
2,7,4,3,0,Polk,2022-12-28
2,5,4,1,0,Polk,2023-02-13
2,6,4,2,0,Polk,2023-03-14
2,12,4,8,0,Richmond,2023-01-02
2,9,4,5,0,Robeson,2023-03-18
2,12,4,8,0,Robeson,2023-03-20
2,11,4,7,0,Rockingham,2022-11-21
2,16,4,12,0,Rowan,2022-12-17
2,8,4,4,0,Rutherford,2022-11-09
2,4,4,0,0,Rutherford,2023-03-14
2,5,4,1,0,Sampson,2022-11-11
2,6,4,2,0,Sampson,2023-02-12
2,7,4,3,0,Scotland,2022-12-10
2,7,4,3,0,Scotland,2023-02-13
2,5,4,1,0,Scotland,2023-03-06
2,7,4,3,0,Stokes,2022-11-16
2,12,4,8,0,Stokes,2023-01-31
2,9,4,5,0,Surry,2023-02-20
2,4,4,0,0,Swain,2022-12-07
2,23,4,19,0,Union,2022-11-15
2,5,4,1,0,Vance,2022-12-25
2,18,4,14,0,Vance,2022-12-31
2,16,4,12,0,Vance,2023-01-20
2,19,4,15,0,Wake,2023-04-16
2,4,4,0,0,Warren,2022-12-25
2,9,4,5,0,Washington,2022-12-27
2,12,4,8,0,Watauga,2022-12-10
2,8,4,4,0,Watauga,2023-02-02
2,12,4,8,0,Wayne,2022-12-04
2,5,4,1,0,Wayne,2023-03-12
2,8,4,4,0,Wilkes,2023-01-28
2,10,4,6,0,Wilkes,2023-01-31
2,8,4,4,0,Wilkes,2023-02-22
2,7,4,3,0,Wilson,2022-11-08
2,7,4,3,0,Wilson,2023-03-28
2,16,4,12,0,Yadkin,2022-12-06
2,7,4,3,0,Yadkin,2022-12-17
2,10,5,5,0,Alamance,2023-03-16
2,9,5,4,0,Alexander,2022-12-30
2,8,5,3,0,Ashe,2022-12-07
2,14,5,9,0,Bladen,2022-12-08
2,12,5,7,0,Bladen,2022-12-13
2,9,5,4,0,Brunswick,2023-03-01
2,17,5,12,0,Brunswick,2023-04-03
2,15,5,10,0,Buncombe,2023-02-18
2,13,5,8,0,Buncombe,2023-03-10
2,15,5,10,0,Buncombe,2023-03-13
2,13,5,8,0,Cabarrus,2023-02-25
2,6,5,1,0,Carteret,2023-01-22
2,13,5,8,0,Catawba,2023-02-23
2,7,5,2,0,Catawba,2023-03-31
2,20,5,15,0,Chatham,2022-11-30
2,9,5,4,0,Chatham,2023-02-22
2,12,5,7,0,Chatham,2023-02-27
2,6,5,1,0,Cherokee,2023-02-14
2,6,5,1,0,Cherokee,2023-02-17
2,9,5,4,0,Cleveland,2023-02-05
2,10,5,5,0,Craven,2022-12-01
2,18,5,13,0,Craven,2022-12-25
2,18,5,13,0,Craven,2023-01-01
2,11,5,6,0,Craven,2023-01-27
2,7,5,2,0,Craven,2023-03-08
2,11,5,6,0,Craven,2023-04-06
2,10,5,5,0,Cumberland,2023-05-06
2,23,5,18,0,Davidson,2023-01-20
2,17,5,12,0,Duplin,2022-12-26
2,7,5,2,0,Duplin,2023-02-27
2,14,5,9,0,Durham,2023-04-02
2,23,5,18,0,Forsyth,2023-05-03
2,24,5,19,0,Guilford,2023-03-12
2,8,5,3,0,Halifax,2023-04-17
2,8,5,3,0,Harnett,2023-03-08
2,7,5,2,0,Haywood,2022-11-11
2,6,5,1,0,Haywood,2022-11-15
2,11,5,6,0,Haywood,2022-12-20
2,10,5,5,0,Haywood,2022-12-21
2,16,5,11,0,Henderson,2022-12-04
2,12,5,7,0,Henderson,2023-01-12
2,15,5,10,0,Henderson,2023-02-10
2,8,5,3,0,Henderson,2023-04-16
2,10,5,5,0,Hertford,2022-12-28
2,7,5,2,0,Hoke,2023-02-18
2,12,5,7,0,Jackson,2022-12-21
2,6,5,1,0,Jackson,2023-01-18
2,9,5,4,0,Jackson,2023-01-25
2,9,5,4,0,Jackson,2023-02-21
2,6,5,1,0,Jackson,2023-04-13
2,18,5,13,0,Johnston,2022-12-25
2,12,5,7,0,Johnston,2023-03-27
2,18,5,13,0,Lee,2022-12-19
2,10,5,5,0,Lee,2023-02-17
2,7,5,2,0,Lee,2023-02-23
2,19,5,14,0,Lincoln,2022-11-30
2,21,5,16,0,Lincoln,2023-01-09
2,5,5,0,0,McDowell,2022-12-18
2,6,5,1,0,Montgomery,2022-12-31
2,7,5,2,0,Montgomery,2023-03-21
2,16,5,11,0,Moore,2022-11-30
2,12,5,7,0,Moore,2022-12-11
2,10,5,5,0,Moore,2023-03-01
2,9,5,4,0,Nash,2023-01-20
2,9,5,4,0,New Hanover,2022-12-03
2,14,5,9,0,New Hanover,2023-01-22
2,10,5,5,0,New Hanover,2023-03-28
2,6,5,1,0,Northampton,2022-11-23
2,27,5,22,0,Onslow,2023-02-22
2,17,5,12,0,Orange,2022-11-27
2,27,5,22,0,Orange,2022-12-01
2,18,5,13,0,Orange,2023-02-05
2,19,5,14,0,Orange,2023-03-07
2,7,5,2,0,Pasquotank,2022-12-26
2,9,5,4,0,Pasquotank,2023-01-07
2,9,5,4,0,Pasquotank,2023-01-18
2,7,5,2,0,Pender,2023-01-08
2,13,5,8,0,Pitt,2023-03-28
2,6,5,1,0,Polk,2023-01-01
2,8,5,3,0,Randolph,2023-03-29
2,6,5,1,0,Randolph,2023-04-06
2,11,5,6,0,Richmond,2023-02-16
2,12,5,7,0,Rutherford,2022-12-02
2,7,5,2,0,Sampson,2023-01-01
2,8,5,3,0,Sampson,2023-02-09
2,6,5,1,0,Scotland,2022-11-22
2,8,5,3,0,Scotland,2022-12-14
2,6,5,1,0,Scotland,2023-03-09
2,13,5,8,0,Stokes,2022-12-02
2,10,5,5,0,Stokes,2022-12-24
2,6,5,1,0,Stokes,2023-04-24
2,10,5,5,0,Surry,2023-03-02
2,13,5,8,0,Vance,2022-12-30
2,18,5,13,0,Warren,2022-12-28
2,11,5,6,0,Wayne,2023-01-21
2,10,5,5,0,Wilkes,2022-11-09
2,8,5,3,0,Wilkes,2022-12-03
2,11,5,6,0,Wilkes,2022-12-24
2,11,5,6,0,Wilson,2022-12-01
2,15,5,10,0,Wilson,2023-01-13
2,8,5,3,0,Wilson,2023-02-21
2,6,5,1,0,Yadkin,2022-11-18
2,21,5,16,0,Yadkin,2023-01-05
2,7,6,1,0,Alexander,2022-12-15
2,8,6,2,0,Alexander,2023-02-01
2,11,6,5,0,Beaufort,2023-01-31
2,17,6,11,0,Bladen,2022-12-30
2,20,6,14,0,Brunswick,2022-11-22
2,28,6,22,0,Brunswick,2022-11-30
2,20,6,14,0,Brunswick,2022-12-01
2,18,6,12,0,Brunswick,2022-12-02
2,47,6,41,0,Brunswick,2022-12-14
2,13,6,7,0,Buncombe,2023-03-07
2,7,6,1,0,Buncombe,2023-03-23
2,15,6,9,0,Buncombe,2023-04-15
2,11,6,5,0,Buncombe,2023-04-25
2,10,6,4,0,Buncombe,2023-04-29
2,20,6,14,0,Burke,2022-12-23
2,15,6,9,0,Burke,2023-02-14
2,17,6,11,0,Carteret,2023-01-05
2,7,6,1,0,Carteret,2023-02-03
2,15,6,9,0,Catawba,2022-11-26
2,8,6,2,0,Catawba,2023-02-26
2,23,6,17,0,Chatham,2022-12-20
2,22,6,16,0,Chatham,2023-02-01
2,11,6,5,0,Cherokee,2023-01-02
2,15,6,9,0,Cleveland,2022-11-09
2,18,6,12,0,Craven,2023-02-08
2,8,6,2,0,Craven,2023-03-03
2,13,6,7,0,Cumberland,2023-04-04
2,13,6,7,0,Cumberland,2023-04-24
2,11,6,5,0,Duplin,2022-12-23
2,13,6,7,0,Duplin,2023-01-24
2,19,6,13,0,Gaston,2023-01-14
2,7,6,1,0,Graham,2022-12-26
2,6,6,0,0,Graham,2022-12-30
2,12,6,6,0,Halifax,2022-11-29
2,23,6,17,0,Harnett,2022-12-24
2,7,6,1,0,Haywood,2022-11-22
2,13,6,7,0,Haywood,2023-02-02
2,12,6,6,0,Henderson,2023-03-27
2,11,6,5,0,Iredell,2022-11-13
2,17,6,11,0,Iredell,2023-02-11
2,10,6,4,0,Jackson,2022-12-13
2,12,6,6,0,Jackson,2023-01-11
2,13,6,7,0,Johnston,2023-03-29
2,8,6,2,0,Johnston,2023-04-17
2,8,6,2,0,Lee,2022-12-11
2,13,6,7,0,Lenoir,2023-02-10
2,16,6,10,0,Lenoir,2023-02-13
2,13,6,7,0,Lincoln,2022-12-24
2,14,6,8,0,Lincoln,2023-01-16
2,7,6,1,0,Madison,2022-12-08
2,12,6,6,0,McDowell,2023-01-31
2,26,6,20,0,Mecklenburg,2023-04-30
2,12,6,6,0,Moore,2022-11-16
2,35,6,29,0,Moore,2023-01-03
2,16,6,10,0,Nash,2022-11-28
2,15,6,9,0,New Hanover,2022-11-10
2,12,6,6,0,New Hanover,2022-12-11
2,11,6,5,0,New Hanover,2023-03-06
2,10,6,4,0,New Hanover,2023-03-10
2,12,6,6,0,New Hanover,2023-04-17
2,10,6,4,0,Pasquotank,2023-01-23
2,6,6,0,0,Polk,2022-12-05
2,7,6,1,0,Polk,2022-12-29
2,9,6,3,0,Randolph,2023-03-15
2,9,6,3,0,Randolph,2023-03-27
2,8,6,2,0,Richmond,2022-12-15
2,14,6,8,0,Richmond,2022-12-16
2,10,6,4,0,Robeson,2022-11-23
2,8,6,2,0,Robeson,2023-03-11
2,10,6,4,0,Sampson,2023-01-07
2,6,6,0,0,Sampson,2023-02-04
2,9,6,3,0,Sampson,2023-02-17
2,10,6,4,0,Sampson,2023-02-20
2,7,6,1,0,Scotland,2022-12-12
2,11,6,5,0,Surry,2022-12-03
2,7,6,1,0,Tyrrell,2023-02-11
2,9,6,3,0,Vance,2023-04-07
2,12,6,6,0,Wilkes,2023-01-01
2,12,6,6,0,Wilson,2023-01-12
2,8,6,2,0,Wilson,2023-04-17
2,7,6,1,0,Yadkin,2022-11-24
2,9,7,2,0,Alexander,2022-12-24
2,10,7,3,0,Alleghany,2022-12-27
2,7,7,0,0,Alleghany,2023-03-23
2,17,7,10,0,Buncombe,2022-11-13
2,17,7,10,0,Burke,2023-01-20
2,9,7,2,0,Carteret,2023-01-27
2,7,7,0,0,Catawba,2023-04-17
2,9,7,2,0,Davie,2022-11-09
2,12,7,5,0,Davie,2022-12-05
2,13,7,6,0,Davie,2023-01-24
2,18,7,11,0,Duplin,2022-12-21
2,10,7,3,0,Graham,2022-12-29
2,13,7,6,0,Greene,2022-12-22
2,19,7,12,0,Harnett,2023-01-26
2,12,7,5,0,Haywood,2023-01-18
2,8,7,1,0,Haywood,2023-02-01
2,7,7,0,0,Haywood,2023-04-12
2,19,7,12,0,Henderson,2022-12-09
2,9,7,2,0,Hertford,2022-11-28
2,18,7,11,0,Iredell,2022-11-23
2,9,7,2,0,Iredell,2023-04-20
2,10,7,3,0,Jackson,2023-02-08
2,9,7,2,0,Johnston,2023-04-24
2,12,7,5,0,Lincoln,2023-01-31
2,8,7,1,0,Madison,2022-12-05
2,13,7,6,0,McDowell,2022-12-23
2,8,7,1,0,Mitchell,2022-12-19
2,16,7,9,0,Montgomery,2022-12-29
2,29,7,22,0,Moore,2023-01-23
2,21,7,14,0,New Hanover,2022-12-25
2,14,7,7,0,New Hanover,2023-03-24
2,11,7,4,0,Pasquotank,2023-01-04
2,17,7,10,0,Person,2022-12-30
2,22,7,15,0,Pitt,2022-11-08
2,13,7,6,0,Pitt,2023-03-29
2,7,7,0,0,Polk,2022-12-31
2,11,7,4,0,Randolph,2022-11-10
2,13,7,6,0,Randolph,2022-12-24
2,18,7,11,0,Randolph,2023-01-27
2,7,7,0,0,Sampson,2022-12-11
2,10,7,3,0,Sampson,2023-02-03
2,9,7,2,0,Scotland,2023-02-07
2,8,7,1,0,Scotland,2023-02-10
2,8,7,1,0,Swain,2023-01-04
2,21,7,14,0,Wake,2023-04-29
2,13,7,6,0,Watauga,2022-12-05
2,14,7,7,0,Wayne,2023-02-28
2,12,7,5,0,Wayne,2023-03-30
2,15,7,8,0,Wilkes,2022-11-29
2,13,7,6,0,Wilkes,2022-11-30
2,14,7,7,0,Wilkes,2023-01-16
2,11,7,4,0,Wilson,2022-11-14
2,11,7,4,0,Yadkin,2022-11-25
2,15,7,8,0,Yadkin,2023-01-02
2,9,8,1,0,Alleghany,2022-12-12
2,11,8,3,0,Bladen,2022-12-05
2,29,8,21,0,Buncombe,2022-11-11
2,17,8,9,0,Buncombe,2023-03-24
2,15,8,7,0,Cabarrus,2023-03-31
2,14,8,6,0,Chatham,2023-01-12
2,17,8,9,0,Craven,2023-02-17
2,12,8,4,0,Craven,2023-04-07
2,20,8,12,0,Davidson,2023-02-27
2,11,8,3,0,Duplin,2022-11-21
2,14,8,6,0,Duplin,2022-12-13
2,14,8,6,0,Duplin,2022-12-31
2,17,8,9,0,Duplin,2023-01-10
2,28,8,20,0,Durham,2023-03-24
2,16,8,8,0,Halifax,2022-11-28
2,14,8,6,0,Halifax,2022-12-06
2,17,8,9,0,Haywood,2023-01-04
2,13,8,5,0,Henderson,2023-02-11
2,11,8,3,0,Hoke,2022-12-18
2,10,8,2,0,Iredell,2023-05-01
2,19,8,11,0,Johnston,2022-11-22
2,18,8,10,0,Nash,2023-02-10
2,21,8,13,0,New Hanover,2022-11-21
2,18,8,10,0,New Hanover,2022-11-23
2,41,8,33,0,New Hanover,2023-01-18
2,10,8,2,0,Pasquotank,2022-12-13
2,14,8,6,0,Person,2022-12-19
2,18,8,10,0,Randolph,2023-02-02
2,11,8,3,0,Robeson,2023-03-10
2,21,8,13,0,Rockingham,2022-12-22
2,11,8,3,0,Scotland,2023-01-01
2,8,8,0,0,Scotland,2023-01-14
2,10,8,2,0,Stokes,2022-11-26
2,14,8,6,0,Stokes,2023-01-23
2,11,8,3,0,Surry,2023-02-27
2,9,8,1,0,Swain,2023-01-10
2,15,8,7,0,Transylvania,2023-01-03
2,15,8,7,0,Vance,2022-12-09
2,18,8,10,0,Wilson,2023-02-01
2,34,9,25,0,Brunswick,2023-01-01
2,18,9,9,0,Buncombe,2023-01-29
2,18,9,9,0,Carteret,2023-01-06
2,10,9,1,0,Chatham,2023-03-16
2,19,9,10,0,Columbus,2022-12-14
2,18,9,9,0,Cumberland,2023-02-26
2,19,9,10,0,Davidson,2022-11-16
2,39,9,30,0,Guilford,2022-11-19
2,17,9,8,0,Guilford,2023-04-13
2,21,9,12,0,Henderson,2022-12-06
2,20,9,11,0,Henderson,2022-12-21
2,22,9,13,0,Nash,2023-01-06
2,19,9,10,0,New Hanover,2022-11-27
2,12,9,3,0,Pasquotank,2023-01-03
2,22,9,13,0,Rockingham,2023-01-04
2,16,9,7,0,Scotland,2022-12-29
2,14,9,5,0,Scotland,2023-02-01
2,19,9,10,0,Wilson,2022-12-13
2,14,10,4,0,Craven,2023-02-16
2,14,10,4,0,Haywood,2023-01-16
2,33,10,23,0,Henderson,2023-01-07
2,23,10,13,0,Iredell,2022-11-17
2,22,10,12,0,Iredell,2023-01-07
2,17,10,7,0,Moore,2023-02-06
2,12,10,2,0,Pasquotank,2022-12-22
2,12,10,2,0,Sampson,2023-01-26
2,13,10,3,0,Scotland,2022-12-13
2,23,10,13,0,Wayne,2023-02-15
2,13,10,3,0,Wayne,2023-03-27
2,11,10,1,0,Yadkin,2022-11-11
2,15,10,5,0,Yadkin,2022-11-21
2,12,11,1,0,Catawba,2023-03-20
2,22,11,11,0,Craven,2022-11-30
2,12,11,1,0,Gates,2023-01-23
2,11,11,0,0,Gates,2023-01-27
2,14,11,3,0,Haywood,2022-12-26
2,18,11,7,0,Henderson,2022-11-14
2,17,11,6,0,Henderson,2023-01-28
2,27,11,16,0,Moore,2022-12-12
2,15,11,4,0,New Hanover,2023-04-13
2,28,11,17,0,Rockingham,2022-12-23
2,18,11,7,0,Sampson,2023-01-13
2,16,11,5,0,Sampson,2023-01-19
2,16,11,5,0,Wilson,2023-01-31
2,18,12,6,0,Catawba,2023-01-27
2,25,12,13,0,Henderson,2023-01-30
2,17,12,5,0,Randolph,2022-11-21
2,15,12,3,0,Sampson,2022-12-08
2,32,13,19,0,Brunswick,2023-01-11
2,21,13,8,0,Craven,2023-02-01
2,24,13,11,0,Guilford,2023-03-29
2,31,14,17,0,Craven,2022-12-23
2,25,14,11,0,New Hanover,2022-12-06
2,22,14,8,0,Surry,2023-01-13
2,25,15,10,0,Wilson,2022-12-22
2,18,16,2,0,Catawba,2023-01-07
2,23,17,6,0,Carteret,2022-12-22
2,23,20,3,0,Swain,2022-12-12
3,5,0,5,0,Alamance,2023-04-30
3,6,0,6,0,Alamance,2023-05-01
3,4,0,4,0,Alexander,2022-11-16
3,7,0,7,0,Anson,2023-01-30
3,9,0,9,0,Beaufort,2022-12-30
3,7,0,7,0,Bertie,2023-01-02
3,9,0,9,0,Bladen,2023-02-07
3,8,0,8,0,Bladen,2023-02-10
3,18,0,18,0,Burke,2022-11-25
3,15,0,15,0,Burke,2023-02-23
3,9,0,9,0,Cabarrus,2023-04-01
3,9,0,9,0,Cabarrus,2023-04-24
3,10,0,10,0,Caldwell,2023-01-22
3,11,0,11,0,Caldwell,2023-02-12
3,7,0,7,0,Caldwell,2023-04-06
3,9,0,9,0,Caldwell,2023-04-21
3,7,0,7,0,Caswell,2022-12-28
3,6,0,6,0,Catawba,2022-11-24
3,10,0,10,0,Chatham,2022-11-10
3,10,0,10,0,Chatham,2023-01-24
3,7,0,7,0,Chowan,2022-12-21
3,8,0,8,0,Chowan,2022-12-29
3,7,0,7,0,Chowan,2022-12-31
3,10,0,10,0,Chowan,2023-01-03
3,7,0,7,0,Chowan,2023-02-01
3,4,0,4,0,Chowan,2023-02-20
3,4,0,4,0,Clay,2022-12-19
3,7,0,7,0,Cleveland,2023-04-03
3,5,0,5,0,Currituck,2022-12-12
3,9,0,9,0,Currituck,2022-12-20
3,6,0,6,0,Dare,2022-11-18
3,5,0,5,0,Dare,2022-11-21
3,10,0,10,0,Dare,2022-12-14
3,9,0,9,0,Dare,2022-12-16
3,6,0,6,0,Dare,2022-12-17
3,6,0,6,0,Dare,2022-12-18
3,19,0,19,0,Dare,2022-12-20
3,10,0,10,0,Dare,2022-12-21
3,14,0,14,0,Dare,2022-12-22
3,16,0,16,0,Dare,2022-12-29
3,9,0,9,0,Dare,2023-01-01
3,12,0,12,0,Dare,2023-01-02
3,12,0,12,0,Dare,2023-01-03
3,13,0,13,0,Dare,2023-01-05
3,14,0,14,0,Dare,2023-01-23
3,8,0,8,0,Dare,2023-01-24
3,9,0,9,0,Dare,2023-02-14
3,9,0,9,0,Davidson,2023-03-20
3,7,0,7,0,Davidson,2023-03-22
3,5,0,5,0,Davidson,2023-03-26
3,6,0,6,0,Davidson,2023-03-31
3,6,0,6,0,Davidson,2023-04-01
3,3,0,3,0,Davidson,2023-04-18
3,4,0,4,0,Edgecombe,2023-01-15
3,6,0,6,0,Edgecombe,2023-02-20
3,8,0,8,0,Edgecombe,2023-03-22
3,11,0,11,0,Franklin,2022-12-17
3,3,0,3,0,Franklin,2023-05-05
3,17,0,17,0,Greene,2023-01-03
3,4,0,4,0,Halifax,2023-01-29
3,4,0,4,0,Halifax,2023-03-16
3,16,0,16,0,Harnett,2023-02-20
3,7,0,7,0,Hertford,2022-12-09
3,11,0,11,0,Hoke,2023-02-09
3,3,0,3,0,Hoke,2023-05-02
3,10,0,10,0,McDowell,2022-11-22
3,11,0,11,0,McDowell,2022-11-23
3,6,0,6,0,McDowell,2023-03-02
3,8,0,8,0,McDowell,2023-05-01
3,5,0,5,0,McDowell,2023-05-04
3,7,0,7,0,Nash,2023-02-18
3,6,0,6,0,Northampton,2022-12-15
3,15,0,15,0,Onslow,2022-11-16
3,16,0,16,0,Onslow,2023-01-08
3,11,0,11,0,Onslow,2023-02-20
3,16,0,16,0,Onslow,2023-03-01
3,18,0,18,0,Onslow,2023-03-30
3,18,0,18,0,Orange,2023-01-22
3,25,0,25,0,Orange,2023-02-07
3,6,0,6,0,Orange,2023-05-04
3,9,0,9,0,Pender,2023-02-06
3,8,0,8,0,Pender,2023-02-15
3,7,0,7,0,Person,2022-12-06
3,9,0,9,0,Pitt,2022-12-25
3,14,0,14,0,Richmond,2023-05-02
3,5,0,5,0,Rowan,2022-11-20
3,5,0,5,0,Rowan,2023-04-09
3,6,0,6,0,Rowan,2023-04-18
3,5,0,5,0,Rowan,2023-05-03
3,8,0,8,0,Stanly,2022-11-13
3,9,0,9,0,Stanly,2022-11-21
3,12,0,12,0,Stanly,2022-12-16
3,8,0,8,0,Stanly,2023-02-01
3,6,0,6,0,Stanly,2023-02-15
3,13,0,13,0,Stanly,2023-02-17
3,11,0,11,0,Stanly,2023-02-20
3,6,0,6,0,Stanly,2023-05-03
3,4,0,4,0,Stokes,2023-04-26
3,4,0,4,0,Surry,2023-03-30
3,6,0,6,0,Union,2023-04-01
3,5,0,5,0,Vance,2023-02-10
3,13,0,13,0,Wake,2023-04-30
3,4,0,4,0,Washington,2022-11-09
3,7,0,7,0,Wilkes,2023-01-22
3,10,1,9,0,Alamance,2023-05-02
3,11,1,10,0,Alexander,2023-01-23
3,7,1,6,0,Alexander,2023-02-08
3,5,1,4,0,Alexander,2023-02-10
3,5,1,4,0,Anson,2022-11-08
3,12,1,11,0,Anson,2023-01-02
3,6,1,5,0,Beaufort,2022-12-11
3,8,1,7,0,Beaufort,2023-01-20
3,15,1,14,0,Beaufort,2023-01-23
3,3,1,2,0,Bertie,2023-01-13
3,5,1,4,0,Bertie,2023-02-24
3,12,1,11,0,Bladen,2023-01-08
3,12,1,11,0,Bladen,2023-01-12
3,13,1,12,0,Bladen,2023-01-21
3,7,1,6,0,Bladen,2023-02-16
3,9,1,8,0,Brunswick,2023-02-23
3,10,1,9,0,Brunswick,2023-02-27
3,11,1,10,0,Buncombe,2023-03-03
3,5,1,4,0,Buncombe,2023-04-05
3,11,1,10,0,Burke,2023-01-27
3,5,1,4,0,Burke,2023-03-15
3,7,1,6,0,Burke,2023-03-22
3,7,1,6,0,Cabarrus,2023-03-15
3,11,1,10,0,Cabarrus,2023-04-02
3,5,1,4,0,Cabarrus,2023-04-28
3,10,1,9,0,Caldwell,2022-11-27
3,14,1,13,0,Caldwell,2022-12-04
3,12,1,11,0,Caldwell,2023-02-24
3,4,1,3,0,Caldwell,2023-03-04
3,8,1,7,0,Caldwell,2023-03-27
3,5,1,4,0,Caldwell,2023-04-05
3,7,1,6,0,Caswell,2022-12-19
3,9,1,8,0,Caswell,2023-01-02
3,11,1,10,0,Chatham,2022-11-09
3,14,1,13,0,Chatham,2023-01-13
3,6,1,5,0,Chatham,2023-01-14
3,5,1,4,0,Cherokee,2023-02-10
3,7,1,6,0,Chowan,2022-12-30
3,3,1,2,0,Chowan,2023-04-27
3,8,1,7,0,Cleveland,2022-12-02
3,7,1,6,0,Columbus,2023-01-28
3,7,1,6,0,Craven,2023-03-28
3,7,1,6,0,Davidson,2023-03-15
3,5,1,4,0,Davidson,2023-05-04
3,7,1,6,0,Duplin,2023-02-05
3,14,1,13,0,Duplin,2023-03-10
3,21,1,20,0,Durham,2022-11-12
3,15,1,14,0,Durham,2022-11-24
3,18,1,17,0,Durham,2023-03-21
3,23,1,22,0,Durham,2023-03-28
3,15,1,14,0,Durham,2023-04-13
3,12,1,11,0,Durham,2023-04-21
3,6,1,5,0,Edgecombe,2023-01-19
3,6,1,5,0,Edgecombe,2023-02-24
3,5,1,4,0,Edgecombe,2023-03-01
3,5,1,4,0,Franklin,2022-11-18
3,13,1,12,0,Franklin,2022-11-21
3,19,1,18,0,Franklin,2022-11-28
3,17,1,16,0,Franklin,2023-01-20
3,9,1,8,0,Franklin,2023-02-14
3,14,1,13,0,Gaston,2023-02-11
3,4,1,3,0,Gaston,2023-04-21
3,4,1,3,0,Graham,2023-02-06
3,8,1,7,0,Granville,2022-12-01
3,12,1,11,0,Granville,2022-12-02
3,15,1,14,0,Granville,2023-02-01
3,12,1,11,0,Granville,2023-02-02
3,4,1,3,0,Granville,2023-03-18
3,8,1,7,0,Greene,2022-12-28
3,8,1,7,0,Greene,2022-12-29
3,11,1,10,0,Harnett,2022-11-10
3,4,1,3,0,Harnett,2023-02-25
3,5,1,4,0,Harnett,2023-03-03
3,6,1,5,0,Harnett,2023-03-17
3,9,1,8,0,Harnett,2023-03-24
3,12,1,11,0,Henderson,2023-03-08
3,8,1,7,0,Hoke,2022-12-15
3,16,1,15,0,Hoke,2023-01-27
3,9,1,8,0,Lee,2022-12-18
3,10,1,9,0,Lee,2023-01-17
3,9,1,8,0,Lee,2023-02-09
3,13,1,12,0,Lenoir,2022-12-08
3,13,1,12,0,Lenoir,2023-02-15
3,3,1,2,0,Lenoir,2023-04-25
3,12,1,11,0,Lincoln,2022-12-02
3,9,1,8,0,Lincoln,2022-12-04
3,6,1,5,0,Lincoln,2023-01-29
3,11,1,10,0,Lincoln,2023-02-16
3,5,1,4,0,Martin,2022-12-17
3,6,1,5,0,McDowell,2022-11-25
3,9,1,8,0,McDowell,2022-12-08
3,7,1,6,0,McDowell,2023-01-28
3,5,1,4,0,McDowell,2023-03-08
3,7,1,6,0,Mitchell,2023-01-25
3,6,1,5,0,Montgomery,2022-12-30
3,8,1,7,0,Montgomery,2023-01-05
3,8,1,7,0,Moore,2023-01-22
3,10,1,9,0,Moore,2023-01-27
3,7,1,6,0,Moore,2023-02-19
3,10,1,9,0,Moore,2023-02-24
3,10,1,9,0,Moore,2023-03-03
3,9,1,8,0,Nash,2023-01-15
3,5,1,4,0,Nash,2023-02-25
3,6,1,5,0,Nash,2023-03-01
3,7,1,6,0,Onslow,2023-04-04
3,10,1,9,0,Onslow,2023-04-24
3,20,1,19,0,Orange,2023-02-16
3,10,1,9,0,Pender,2022-12-02
3,14,1,13,0,Pender,2022-12-13
3,5,1,4,0,Person,2022-11-23
3,9,1,8,0,Person,2023-01-17
3,9,1,8,0,Person,2023-01-24
3,10,1,9,0,Pitt,2022-12-11
3,8,1,7,0,Pitt,2023-02-19
3,6,1,5,0,Pitt,2023-04-14
3,10,1,9,0,Richmond,2022-11-28
3,13,1,12,0,Richmond,2022-12-02
3,8,1,7,0,Richmond,2023-01-01
3,8,1,7,0,Richmond,2023-01-08
3,12,1,11,0,Richmond,2023-01-16
3,6,1,5,0,Richmond,2023-01-26
3,3,1,2,0,Richmond,2023-04-03
3,5,1,4,0,Robeson,2023-04-01
3,5,1,4,0,Robeson,2023-04-12
3,5,1,4,0,Robeson,2023-04-20
3,4,1,3,0,Robeson,2023-04-25
3,8,1,7,0,Rockingham,2022-11-23
3,13,1,12,0,Rockingham,2023-01-25
3,8,1,7,0,Rockingham,2023-01-28
3,15,1,14,0,Rowan,2022-11-09
3,15,1,14,0,Rowan,2023-01-08
3,14,1,13,0,Rowan,2023-04-17
3,7,1,6,0,Rowan,2023-05-05
3,8,1,7,0,Rutherford,2022-12-01
3,11,1,10,0,Rutherford,2022-12-07
3,13,1,12,0,Stanly,2022-12-18
3,24,1,23,0,Stanly,2022-12-28
3,12,1,11,0,Stanly,2023-01-20
3,15,1,14,0,Stanly,2023-02-06
3,8,1,7,0,Stanly,2023-02-08
3,6,1,5,0,Stanly,2023-02-28
3,5,1,4,0,Stanly,2023-04-04
3,7,1,6,0,Stanly,2023-04-27
3,14,1,13,0,Stokes,2022-12-06
3,13,1,12,0,Stokes,2022-12-09
3,20,1,19,0,Stokes,2023-01-04
3,7,1,6,0,Stokes,2023-02-10
3,7,1,6,0,Surry,2023-01-15
3,10,1,9,0,Surry,2023-03-01
3,10,1,9,0,Surry,2023-03-09
3,7,1,6,0,Surry,2023-04-03
3,15,1,14,0,Transylvania,2022-12-29
3,9,1,8,0,Transylvania,2023-02-02
3,5,1,4,0,Transylvania,2023-02-11
3,6,1,5,0,Union,2023-04-09
3,12,1,11,0,Union,2023-04-20
3,9,1,8,0,Union,2023-05-03
3,14,1,13,0,Vance,2022-12-19
3,8,1,7,0,Vance,2023-02-16
3,4,1,3,0,Warren,2022-11-21
3,4,1,3,0,Wilkes,2023-03-21
3,12,1,11,0,Yadkin,2022-12-24
3,4,1,3,0,Yadkin,2023-03-30
3,15,2,13,0,Alamance,2022-12-25
3,9,2,7,0,Alamance,2023-02-25
3,11,2,9,0,Alamance,2023-03-10
3,6,2,4,0,Alexander,2023-01-26
3,8,2,6,0,Anson,2022-12-29
3,10,2,8,0,Anson,2023-01-24
3,8,2,6,0,Ashe,2023-01-31
3,9,2,7,0,Beaufort,2023-02-13
3,19,2,17,0,Bladen,2023-01-31
3,10,2,8,0,Bladen,2023-02-15
3,11,2,9,0,Brunswick,2022-12-03
3,12,2,10,0,Brunswick,2023-03-07
3,5,2,3,0,Brunswick,2023-05-05
3,11,2,9,0,Buncombe,2023-03-25
3,9,2,7,0,Burke,2022-12-18
3,7,2,5,0,Burke,2023-01-15
3,13,2,11,0,Burke,2023-01-18
3,12,2,10,0,Burke,2023-02-09
3,11,2,9,0,Burke,2023-02-22
3,10,2,8,0,Burke,2023-02-28
3,7,2,5,0,Burke,2023-03-18
3,7,2,5,0,Burke,2023-04-25
3,19,2,17,0,Cabarrus,2022-11-08
3,14,2,12,0,Cabarrus,2022-11-12
3,10,2,8,0,Caldwell,2023-03-28
3,7,2,5,0,Catawba,2022-11-19
3,3,2,1,0,Catawba,2023-04-27
3,19,2,17,0,Chatham,2022-12-16
3,12,2,10,0,Chatham,2023-02-16
3,8,2,6,0,Cherokee,2023-01-05
3,5,2,3,0,Clay,2022-12-26
3,4,2,2,0,Clay,2023-02-06
3,12,2,10,0,Cleveland,2022-11-25
3,18,2,16,0,Cleveland,2022-12-08
3,12,2,10,0,Cleveland,2023-02-17
3,16,2,14,0,Cleveland,2023-02-20
3,11,2,9,0,Cleveland,2023-02-26
3,7,2,5,0,Cleveland,2023-03-17
3,8,2,6,0,Columbus,2023-01-08
3,6,2,4,0,Columbus,2023-02-02
3,8,2,6,0,Columbus,2023-02-09
3,12,2,10,0,Craven,2022-12-11
3,16,2,14,0,Craven,2023-01-08
3,4,2,2,0,Craven,2023-04-19
3,10,2,8,0,Cumberland,2023-05-04
3,7,2,5,0,Davidson,2023-04-05
3,4,2,2,0,Davidson,2023-04-26
3,6,2,4,0,Davie,2022-12-09
3,11,2,9,0,Davie,2023-01-12
3,13,2,11,0,Davie,2023-01-26
3,7,2,5,0,Davie,2023-01-30
3,26,2,24,0,Durham,2023-02-18
3,16,2,14,0,Durham,2023-04-18
3,13,2,11,0,Edgecombe,2022-12-05
3,6,2,4,0,Edgecombe,2022-12-18
3,14,2,12,0,Edgecombe,2023-01-08
3,10,2,8,0,Forsyth,2023-03-25
3,7,2,5,0,Franklin,2022-11-16
3,20,2,18,0,Franklin,2022-12-07
3,10,2,8,0,Franklin,2022-12-18
3,17,2,15,0,Franklin,2023-01-17
3,15,2,13,0,Gaston,2022-11-24
3,15,2,13,0,Gaston,2022-12-25
3,10,2,8,0,Gaston,2023-03-29
3,8,2,6,0,Gaston,2023-04-10
3,5,2,3,0,Gaston,2023-04-25
3,16,2,14,0,Granville,2022-11-30
3,24,2,22,0,Granville,2022-12-20
3,19,2,17,0,Granville,2023-01-06
3,16,2,14,0,Granville,2023-02-08
3,11,2,9,0,Greene,2022-12-13
3,11,2,9,0,Greene,2023-01-17
3,5,2,3,0,Halifax,2022-11-12
3,6,2,4,0,Halifax,2023-02-21
3,11,2,9,0,Halifax,2023-02-22
3,14,2,12,0,Harnett,2022-11-22
3,6,2,4,0,Henderson,2023-03-02
3,7,2,5,0,Hertford,2023-01-05
3,8,2,6,0,Hertford,2023-01-24
3,19,2,17,0,Hoke,2023-01-05
3,9,2,7,0,Iredell,2023-03-07
3,8,2,6,0,Iredell,2023-03-08
3,8,2,6,0,Jackson,2023-02-22
3,4,2,2,0,Jackson,2023-04-14
3,11,2,9,0,Johnston,2023-02-26
3,10,2,8,0,Johnston,2023-04-23
3,3,2,1,0,Lee,2022-11-19
3,15,2,13,0,Lee,2022-12-27
3,7,2,5,0,Lee,2023-01-18
3,6,2,4,0,Lenoir,2022-12-01
3,7,2,5,0,Lenoir,2022-12-18
3,16,2,14,0,Lenoir,2022-12-23
3,17,2,15,0,Lenoir,2023-02-20
3,10,2,8,0,Lincoln,2022-11-21
3,13,2,11,0,Lincoln,2022-12-31
3,9,2,7,0,Lincoln,2023-01-14
3,5,2,3,0,Lincoln,2023-03-05
3,9,2,7,0,Lincoln,2023-03-27
3,8,2,6,0,Macon,2023-01-03
3,7,2,5,0,Madison,2023-01-03
3,8,2,6,0,McDowell,2022-12-17
3,5,2,3,0,Mitchell,2023-01-11
3,7,2,5,0,Moore,2023-02-05
3,8,2,6,0,Moore,2023-03-16
3,9,2,7,0,Moore,2023-03-27
3,9,2,7,0,Nash,2022-11-18
3,6,2,4,0,Nash,2022-11-24
3,7,2,5,0,Nash,2022-12-02
3,8,2,6,0,Nash,2023-02-16
3,6,2,4,0,Northampton,2022-12-13
3,5,2,3,0,Northampton,2023-02-01
3,11,2,9,0,Northampton,2023-02-08
3,18,2,16,0,Onslow,2022-11-09
3,11,2,9,0,Onslow,2023-01-14
3,16,2,14,0,Onslow,2023-01-15
3,17,2,15,0,Onslow,2023-02-17
3,32,2,30,0,Orange,2023-01-20
3,9,2,7,0,Orange,2023-03-02
3,11,2,9,0,Pender,2022-12-16
3,5,2,3,0,Perquimans,2023-01-26
3,5,2,3,0,Person,2023-01-26
3,7,2,5,0,Pitt,2023-05-05
3,6,2,4,0,Randolph,2023-03-11
3,3,2,1,0,Randolph,2023-04-01
3,9,2,7,0,Richmond,2023-02-14
3,4,2,2,0,Robeson,2023-05-03
3,16,2,14,0,Rockingham,2022-12-16
3,15,2,13,0,Rockingham,2023-01-24
3,9,2,7,0,Rockingham,2023-03-09
3,4,2,2,0,Rowan,2023-03-09
3,9,2,7,0,Rowan,2023-03-21
3,9,2,7,0,Rowan,2023-03-23
3,5,2,3,0,Rowan,2023-04-05
3,5,2,3,0,Rutherford,2022-11-11
3,8,2,6,0,Rutherford,2022-11-21
3,6,2,4,0,Rutherford,2023-04-17
3,5,2,3,0,Rutherford,2023-05-01
3,6,2,4,0,Scotland,2022-12-01
3,3,2,1,0,Scotland,2023-03-29
3,8,2,6,0,Stanly,2023-02-10
3,16,2,14,0,Stokes,2022-12-17
3,8,2,6,0,Stokes,2023-01-07
3,10,2,8,0,Stokes,2023-01-27
3,11,2,9,0,Surry,2022-11-18
3,5,2,3,0,Surry,2023-03-24
3,7,2,5,0,Surry,2023-04-06
3,5,2,3,0,Surry,2023-04-07
3,5,2,3,0,Surry,2023-04-18
3,5,2,3,0,Transylvania,2023-03-29
3,27,2,25,0,Union,2022-11-14
3,24,2,22,0,Union,2023-01-08
3,24,2,22,0,Union,2023-02-11
3,14,2,12,0,Union,2023-02-23
3,21,2,19,0,Union,2023-03-15
3,8,2,6,0,Union,2023-03-20
3,11,2,9,0,Union,2023-04-19
3,5,2,3,0,Vance,2023-03-22
3,4,2,2,0,Warren,2023-02-01
3,7,2,5,0,Warren,2023-02-10
3,4,2,2,0,Washington,2022-12-22
3,10,2,8,0,Watauga,2023-01-30
3,6,2,4,0,Watauga,2023-02-27
3,4,2,2,0,Wilkes,2023-04-11
3,6,2,4,0,Wilson,2022-11-09
3,5,2,3,0,Wilson,2023-03-15
3,8,2,6,0,Yadkin,2022-11-09
3,11,2,9,0,Yadkin,2022-12-31
3,9,2,7,0,Yadkin,2023-01-07
3,6,3,3,0,Alamance,2022-11-24
3,9,3,6,0,Alexander,2022-12-13
3,9,3,6,0,Alexander,2022-12-21
3,5,3,2,0,Alexander,2022-12-31
3,8,3,5,0,Anson,2022-12-30
3,11,3,8,0,Anson,2023-01-23
3,5,3,2,0,Ashe,2022-12-22
3,7,3,4,0,Beaufort,2023-01-05
3,10,3,7,0,Beaufort,2023-02-21
3,13,3,10,0,Bladen,2022-12-21
3,21,3,18,0,Bladen,2022-12-28
3,18,3,15,0,Brunswick,2022-11-27
3,8,3,5,0,Buncombe,2023-04-12
3,10,3,7,0,Burke,2023-01-26
3,21,3,18,0,Burke,2023-02-20
3,11,3,8,0,Burke,2023-02-21
3,21,3,18,0,Cabarrus,2022-11-21
3,13,3,10,0,Cabarrus,2023-03-28
3,9,3,6,0,Cabarrus,2023-04-12
3,10,3,7,0,Carteret,2023-01-25
3,4,3,1,0,Catawba,2023-05-02
3,16,3,13,0,Chatham,2022-12-08
3,22,3,19,0,Chatham,2022-12-19
3,24,3,21,0,Chatham,2023-01-10
3,9,3,6,0,Chatham,2023-01-22
3,6,3,3,0,Chatham,2023-03-06
3,10,3,7,0,Cherokee,2022-12-14
3,13,3,10,0,Cherokee,2023-01-03
3,13,3,10,0,Cherokee,2023-01-04
3,5,3,2,0,Clay,2023-01-18
3,14,3,11,0,Cleveland,2022-11-21
3,13,3,10,0,Cleveland,2023-01-15
3,14,3,11,0,Cleveland,2023-02-16
3,11,3,8,0,Cleveland,2023-02-22
3,10,3,7,0,Cleveland,2023-02-27
3,9,3,6,0,Columbus,2022-12-08
3,19,3,16,0,Craven,2023-01-13
3,14,3,11,0,Craven,2023-02-23
3,36,3,33,0,Cumberland,2022-11-09
3,7,3,4,0,Cumberland,2023-04-15
3,8,3,5,0,Cumberland,2023-05-02
3,14,3,11,0,Davidson,2023-02-19
3,8,3,5,0,Davidson,2023-03-04
3,8,3,5,0,Davidson,2023-04-13
3,5,3,2,0,Davidson,2023-04-22
3,11,3,8,0,Davidson,2023-05-01
3,15,3,12,0,Davie,2022-12-20
3,3,3,0,0,Davie,2023-03-29
3,10,3,7,0,Duplin,2023-02-28
3,26,3,23,0,Forsyth,2022-11-19
3,18,3,15,0,Franklin,2022-12-23
3,7,3,4,0,Franklin,2023-01-22
3,11,3,8,0,Franklin,2023-02-15
3,18,3,15,0,Gaston,2022-11-12
3,12,3,9,0,Gaston,2023-03-20
3,7,3,4,0,Gaston,2023-04-16
3,11,3,8,0,Granville,2022-12-15
3,8,3,5,0,Halifax,2022-11-23
3,10,3,7,0,Halifax,2023-01-31
3,5,3,2,0,Halifax,2023-02-11
3,6,3,3,0,Halifax,2023-03-03
3,5,3,2,0,Halifax,2023-04-10
3,5,3,2,0,Halifax,2023-04-14
3,24,3,21,0,Harnett,2022-12-01
3,12,3,9,0,Harnett,2023-02-23
3,11,3,8,0,Harnett,2023-03-27
3,10,3,7,0,Henderson,2023-03-13
3,8,3,5,0,Hertford,2022-12-27
3,10,3,7,0,Hertford,2022-12-29
3,7,3,4,0,Hoke,2022-11-23
3,5,3,2,0,Hoke,2022-12-07
3,12,3,9,0,Hoke,2022-12-20
3,23,3,20,0,Hoke,2022-12-27
3,12,3,9,0,Hoke,2023-01-02
3,7,3,4,0,Hoke,2023-02-05
3,12,3,9,0,Iredell,2023-03-20
3,5,3,2,0,Iredell,2023-04-18
3,5,3,2,0,Jackson,2022-12-16
3,7,3,4,0,Jackson,2023-01-05
3,7,3,4,0,Jackson,2023-01-20
3,11,3,8,0,Johnston,2023-03-11
3,11,3,8,0,Johnston,2023-04-12
3,5,3,2,0,Johnston,2023-05-04
3,6,3,3,0,Jones,2022-12-19
3,4,3,1,0,Jones,2022-12-27
3,18,3,15,0,Lee,2023-01-04
3,12,3,9,0,Lee,2023-01-23
3,8,3,5,0,Lee,2023-02-02
3,12,3,9,0,Lenoir,2023-01-22
3,10,3,7,0,Lenoir,2023-02-22
3,10,3,7,0,Lincoln,2022-12-10
3,9,3,6,0,Lincoln,2022-12-11
3,14,3,11,0,Lincoln,2023-01-26
3,9,3,6,0,Lincoln,2023-01-28
3,10,3,7,0,Lincoln,2023-02-27
3,6,3,3,0,Lincoln,2023-03-06
3,7,3,4,0,Lincoln,2023-03-16
3,8,3,5,0,McDowell,2022-12-11
3,10,3,7,0,McDowell,2023-01-13
3,7,3,4,0,McDowell,2023-02-14
3,7,3,4,0,McDowell,2023-04-18
3,4,3,1,0,McDowell,2023-04-29
3,7,3,4,0,Mitchell,2023-01-23
3,5,3,2,0,Montgomery,2022-11-10
3,6,3,3,0,Montgomery,2023-01-18
3,12,3,9,0,Moore,2023-01-29
3,11,3,8,0,Moore,2023-02-21
3,11,3,8,0,Nash,2022-11-21
3,12,3,9,0,Nash,2022-12-25
3,17,3,14,0,Nash,2023-01-13
3,8,3,5,0,Nash,2023-01-26
3,8,3,5,0,Nash,2023-03-27
3,8,3,5,0,New Hanover,2023-03-20
3,8,3,5,0,New Hanover,2023-04-11
3,6,3,3,0,New Hanover,2023-04-21
3,9,3,6,0,Northampton,2023-01-05
3,8,3,5,0,Northampton,2023-01-12
3,15,3,12,0,Onslow,2022-11-08
3,33,3,30,0,Orange,2022-12-06
3,15,3,12,0,Orange,2023-02-01
3,14,3,11,0,Pender,2022-12-15
3,5,3,2,0,Person,2023-02-01
3,3,3,0,0,Polk,2023-04-11
3,15,3,12,0,Richmond,2023-01-12
3,14,3,11,0,Richmond,2023-01-25
3,12,3,9,0,Richmond,2023-02-06
3,7,3,4,0,Robeson,2023-02-18
3,8,3,5,0,Robeson,2023-02-28
3,6,3,3,0,Robeson,2023-04-05
3,6,3,3,0,Robeson,2023-04-11
3,16,3,13,0,Rockingham,2022-11-30
3,16,3,13,0,Rockingham,2022-12-09
3,7,3,4,0,Rockingham,2023-04-21
3,8,3,5,0,Rowan,2023-02-25
3,6,3,3,0,Rowan,2023-04-22
3,10,3,7,0,Rutherford,2022-12-15
3,6,3,3,0,Scotland,2023-02-15
3,5,3,2,0,Scotland,2023-02-19
3,19,3,16,0,Stokes,2023-01-19
3,15,3,12,0,Stokes,2023-02-07
3,9,3,6,0,Stokes,2023-02-22
3,9,3,6,0,Surry,2023-03-22
3,7,3,4,0,Surry,2023-04-13
3,7,3,4,0,Swain,2023-01-08
3,8,3,5,0,Union,2023-03-21
3,16,3,13,0,Union,2023-04-06
3,6,3,3,0,Union,2023-04-07
3,15,3,12,0,Union,2023-04-26
3,13,3,10,0,Union,2023-05-01
3,10,3,7,0,Vance,2023-01-23
3,14,3,11,0,Warren,2022-12-19
3,10,3,7,0,Warren,2023-02-06
3,6,3,3,0,Washington,2023-02-13
3,7,3,4,0,Watauga,2022-12-01
3,7,3,4,0,Watauga,2023-01-09
3,7,3,4,0,Wayne,2022-11-25
3,8,3,5,0,Wilkes,2023-02-19
3,6,3,3,0,Wilkes,2023-03-04
3,5,3,2,0,Wilson,2023-03-03
3,15,3,12,0,Yadkin,2023-01-12
3,6,3,3,0,Yadkin,2023-01-24
3,11,3,8,0,Yadkin,2023-01-31
3,10,3,7,0,Yadkin,2023-02-07
3,11,3,8,0,Yadkin,2023-02-16
3,6,3,3,0,Yancey,2022-11-30
3,8,3,5,0,Yancey,2023-01-05
3,3,3,0,0,Yancey,2023-05-01
3,13,4,9,0,Alamance,2022-11-11
3,14,4,10,0,Alamance,2023-03-06
3,16,4,12,0,Alexander,2022-11-28
3,6,4,2,0,Alexander,2022-12-19
3,10,4,6,0,Alexander,2022-12-27
3,8,4,4,0,Alexander,2023-02-09
3,7,4,3,0,Anson,2023-01-04
3,5,4,1,0,Anson,2023-03-08
3,6,4,2,0,Avery,2022-12-08
3,15,4,11,0,Beaufort,2022-12-09
3,11,4,7,0,Beaufort,2022-12-15
3,11,4,7,0,Beaufort,2023-02-15
3,8,4,4,0,Beaufort,2023-03-13
3,18,4,14,0,Brunswick,2023-01-26
3,9,4,5,0,Brunswick,2023-03-03
3,13,4,9,0,Buncombe,2023-03-21
3,9,4,5,0,Buncombe,2023-04-06
3,7,4,3,0,Buncombe,2023-04-23
3,20,4,16,0,Burke,2023-01-24
3,15,4,11,0,Cabarrus,2022-11-11
3,27,4,23,0,Cabarrus,2022-11-15
3,15,4,11,0,Cabarrus,2023-03-03
3,7,4,3,0,Cabarrus,2023-03-09
3,8,4,4,0,Cabarrus,2023-03-12
3,11,4,7,0,Cabarrus,2023-04-23
3,13,4,9,0,Caldwell,2022-12-11
3,6,4,2,0,Carteret,2023-03-21
3,14,4,10,0,Catawba,2022-11-18
3,11,4,7,0,Catawba,2023-02-11
3,8,4,4,0,Catawba,2023-04-03
3,6,4,2,0,Catawba,2023-04-18
3,16,4,12,0,Chatham,2022-12-10
3,18,4,14,0,Chatham,2022-12-21
3,15,4,11,0,Chatham,2023-01-17
3,9,4,5,0,Chatham,2023-02-21
3,17,4,13,0,Columbus,2022-12-22
3,8,4,4,0,Columbus,2023-02-08
3,10,4,6,0,Craven,2023-02-03
3,26,4,22,0,Cumberland,2022-11-10
3,16,4,12,0,Cumberland,2023-03-09
3,13,4,9,0,Davidson,2023-03-23
3,16,4,12,0,Davie,2022-11-28
3,9,4,5,0,Davie,2023-01-31
3,10,4,6,0,Davie,2023-02-13
3,10,4,6,0,Duplin,2022-11-28
3,8,4,4,0,Duplin,2022-11-29
3,11,4,7,0,Duplin,2022-12-01
3,15,4,11,0,Duplin,2023-02-08
3,11,4,7,0,Duplin,2023-02-20
3,6,4,2,0,Duplin,2023-03-02
3,49,4,45,0,Durham,2022-12-01
3,13,4,9,0,Durham,2023-03-11
3,18,4,14,0,Durham,2023-04-01
3,15,4,11,0,Forsyth,2023-04-28
3,15,4,11,0,Franklin,2022-12-06
3,13,4,9,0,Gaston,2022-11-13
3,15,4,11,0,Gaston,2023-03-16
3,7,4,3,0,Gaston,2023-04-24
3,11,4,7,0,Granville,2022-11-18
3,11,4,7,0,Granville,2023-02-10
3,11,4,7,0,Granville,2023-02-16
3,9,4,5,0,Halifax,2022-12-09
3,5,4,1,0,Halifax,2023-04-06
3,7,4,3,0,Haywood,2023-01-28
3,5,4,1,0,Haywood,2023-03-24
3,8,4,4,0,Henderson,2023-04-06
3,9,4,5,0,Hertford,2022-12-08
3,8,4,4,0,Hertford,2023-01-04
3,12,4,8,0,Iredell,2023-03-15
3,8,4,4,0,Iredell,2023-05-03
3,5,4,1,0,Jackson,2023-04-23
3,4,4,0,0,Jackson,2023-04-25
3,17,4,13,0,Johnston,2022-11-17
3,8,4,4,0,Johnston,2023-04-18
3,8,4,4,0,Lee,2023-03-18
3,17,4,13,0,Lenoir,2023-01-10
3,7,4,3,0,Lincoln,2022-11-22
3,17,4,13,0,Lincoln,2023-02-08
3,14,4,10,0,McDowell,2022-11-30
3,10,4,6,0,McDowell,2023-01-03
3,17,4,13,0,McDowell,2023-01-06
3,10,4,6,0,McDowell,2023-01-26
3,13,4,9,0,McDowell,2023-02-06
3,5,4,1,0,Mitchell,2023-01-20
3,10,4,6,0,Montgomery,2023-01-03
3,10,4,6,0,Montgomery,2023-01-23
3,16,4,12,0,Moore,2023-02-13
3,15,4,11,0,Moore,2023-02-20
3,10,4,6,0,Nash,2022-12-07
3,14,4,10,0,Nash,2023-01-18
3,15,4,11,0,Nash,2023-01-19
3,17,4,13,0,Nash,2023-02-13
3,12,4,8,0,Nash,2023-02-23
3,7,4,3,0,Northampton,2023-01-09
3,13,4,9,0,Onslow,2022-12-10
3,15,4,11,0,Orange,2023-01-28
3,17,4,13,0,Orange,2023-02-03
3,9,4,5,0,Pitt,2023-03-17
3,12,4,8,0,Pitt,2023-03-24
3,4,4,0,0,Polk,2023-01-26
3,19,4,15,0,Randolph,2023-01-21
3,7,4,3,0,Randolph,2023-02-27
3,8,4,4,0,Randolph,2023-03-02
3,6,4,2,0,Randolph,2023-04-26
3,13,4,9,0,Richmond,2022-12-22
3,9,4,5,0,Robeson,2023-03-17
3,16,4,12,0,Rockingham,2023-02-15
3,16,4,12,0,Rowan,2023-02-22
3,9,4,5,0,Rowan,2023-04-06
3,11,4,7,0,Rutherford,2022-11-28
3,7,4,3,0,Rutherford,2022-12-18
3,6,4,2,0,Sampson,2023-02-19
3,7,4,3,0,Scotland,2023-01-18
3,18,4,14,0,Stanly,2023-01-11
3,12,4,8,0,Stokes,2023-01-20
3,12,4,8,0,Surry,2023-02-28
3,15,4,11,0,Transylvania,2022-12-15
3,21,4,17,0,Union,2022-11-11
3,7,4,3,0,Vance,2022-12-17
3,21,4,17,0,Wake,2023-04-09
3,8,4,4,0,Warren,2023-02-15
3,8,4,4,0,Watauga,2022-11-08
3,10,4,6,0,Wayne,2022-11-11
3,13,4,9,0,Wayne,2022-11-16
3,5,4,1,0,Wilkes,2022-11-13
3,11,4,7,0,Wilkes,2023-02-14
3,10,4,6,0,Yadkin,2022-12-10
3,12,4,8,0,Yadkin,2022-12-22
3,15,4,11,0,Yadkin,2022-12-23
3,13,4,9,0,Yadkin,2023-02-08
3,11,5,6,0,Alexander,2022-12-22
3,5,5,0,0,Anson,2022-12-25
3,8,5,3,0,Avery,2022-12-09
3,12,5,7,0,Beaufort,2023-01-09
3,9,5,4,0,Beaufort,2023-02-14
3,7,5,2,0,Beaufort,2023-02-22
3,8,5,3,0,Buncombe,2023-04-16
3,19,5,14,0,Cabarrus,2022-11-26
3,17,5,12,0,Caldwell,2022-11-17
3,11,5,6,0,Caldwell,2023-03-23
3,5,5,0,0,Carteret,2023-02-15
3,16,5,11,0,Catawba,2022-11-27
3,21,5,16,0,Catawba,2023-01-15
3,22,5,17,0,Chatham,2022-12-14
3,26,5,21,0,Chatham,2022-12-30
3,20,5,15,0,Chatham,2023-01-18
3,9,5,4,0,Chatham,2023-03-15
3,7,5,2,0,Cherokee,2023-02-06
3,27,5,22,0,Columbus,2022-12-28
3,17,5,12,0,Craven,2023-02-20
3,14,5,9,0,Davidson,2023-03-08
3,6,5,1,0,Davie,2022-12-02
3,8,5,3,0,Duplin,2022-12-06
3,13,5,8,0,Duplin,2023-02-09
3,11,5,6,0,Duplin,2023-02-24
3,37,5,32,0,Forsyth,2023-02-19
3,28,5,23,0,Forsyth,2023-04-10
3,16,5,11,0,Forsyth,2023-04-21
3,18,5,13,0,Franklin,2023-02-06
3,11,5,6,0,Gaston,2023-03-01
3,17,5,12,0,Gaston,2023-03-08
3,10,5,5,0,Gaston,2023-03-11
3,13,5,8,0,Gaston,2023-03-24
3,14,5,9,0,Gaston,2023-03-31
3,14,5,9,0,Granville,2023-01-08
3,12,5,7,0,Granville,2023-01-22
3,33,5,28,0,Guilford,2022-11-12
3,17,5,12,0,Guilford,2023-04-12
3,8,5,3,0,Guilford,2023-04-16
3,14,5,9,0,Halifax,2023-01-16
3,13,5,8,0,Haywood,2022-11-28
3,6,5,1,0,Haywood,2023-01-19
3,7,5,2,0,Haywood,2023-02-23
3,19,5,14,0,Henderson,2023-01-18
3,8,5,3,0,Henderson,2023-04-10
3,10,5,5,0,Hertford,2023-01-18
3,10,5,5,0,Hertford,2023-02-01
3,13,5,8,0,Hoke,2022-12-13
3,13,5,8,0,Hoke,2022-12-26
3,16,5,11,0,Iredell,2023-01-28
3,12,5,7,0,Iredell,2023-02-26
3,9,5,4,0,Iredell,2023-03-09
3,16,5,11,0,Johnston,2023-02-03
3,15,5,10,0,Johnston,2023-04-10
3,10,5,5,0,Lee,2022-12-05
3,17,5,12,0,Lee,2023-01-10
3,16,5,11,0,Lenoir,2023-01-17
3,5,5,0,0,Lincoln,2023-03-29
3,10,5,5,0,Macon,2022-12-30
3,7,5,2,0,Macon,2023-01-25
3,15,5,10,0,McDowell,2022-12-15
3,16,5,11,0,McDowell,2022-12-30
3,6,5,1,0,McDowell,2023-01-21
3,12,5,7,0,Montgomery,2023-01-12
3,8,5,3,0,Montgomery,2023-01-30
3,18,5,13,0,Nash,2022-12-23
3,19,5,14,0,Nash,2023-01-17
3,15,5,10,0,New Hanover,2022-12-04
3,18,5,13,0,New Hanover,2023-02-22
3,9,5,4,0,New Hanover,2023-03-31
3,11,5,6,0,New Hanover,2023-04-14
3,15,5,10,0,Northampton,2022-12-29
3,28,5,23,0,Orange,2023-01-23
3,12,5,7,0,Pasquotank,2022-12-27
3,16,5,11,0,Pender,2023-01-05
3,9,5,4,0,Randolph,2023-03-24
3,13,5,8,0,Richmond,2023-02-03
3,6,5,1,0,Robeson,2022-11-15
3,7,5,2,0,Robeson,2023-03-04
3,14,5,9,0,Rockingham,2022-11-22
3,12,5,7,0,Rockingham,2022-12-31
3,14,5,9,0,Rockingham,2023-04-03
3,15,5,10,0,Rutherford,2023-01-12
3,7,5,2,0,Sampson,2022-12-04
3,8,5,3,0,Sampson,2023-02-23
3,10,5,5,0,Scotland,2023-01-24
3,7,5,2,0,Scotland,2023-03-21
3,13,5,8,0,Stokes,2023-01-24
3,15,5,10,0,Surry,2023-02-08
3,10,5,5,0,Surry,2023-02-12
3,7,5,2,0,Swain,2023-01-25
3,9,5,4,0,Transylvania,2023-02-05
3,10,5,5,0,Union,2023-05-02
3,15,5,10,0,Vance,2022-12-21
3,13,5,8,0,Vance,2022-12-23
3,5,5,0,0,Washington,2023-01-03
3,11,5,6,0,Wilkes,2023-02-17
3,12,5,7,0,Wilkes,2023-02-24
3,16,5,11,0,Wilson,2023-02-10
3,11,5,6,0,Wilson,2023-02-11
3,8,5,3,0,Wilson,2023-03-14
3,16,5,11,0,Yadkin,2023-01-26
3,6,6,0,0,Alleghany,2022-12-01
3,12,6,6,0,Beaufort,2023-02-27
3,17,6,11,0,Brunswick,2022-11-23
3,15,6,9,0,Buncombe,2022-11-12
3,21,6,15,0,Burke,2022-12-09
3,21,6,15,0,Burke,2022-12-10
3,31,6,25,0,Burke,2023-01-06
3,8,6,2,0,Cabarrus,2023-03-27
3,17,6,11,0,Caldwell,2022-11-21
3,13,6,7,0,Catawba,2022-12-18
3,9,6,3,0,Catawba,2023-04-20
3,21,6,15,0,Chatham,2022-11-29
3,31,6,25,0,Cleveland,2022-12-21
3,12,6,6,0,Cleveland,2023-01-22
3,9,6,3,0,Columbus,2022-11-16
3,17,6,11,0,Craven,2023-01-16
3,19,6,13,0,Craven,2023-01-31
3,15,6,9,0,Cumberland,2023-04-25
3,16,6,10,0,Davidson,2023-03-03
3,12,6,6,0,Davie,2022-11-29
3,6,6,0,0,Duplin,2023-02-12
3,11,6,5,0,Granville,2022-12-24
3,15,6,9,0,Granville,2022-12-26
3,17,6,11,0,Granville,2023-01-25
3,16,6,10,0,Guilford,2023-04-20
3,17,6,11,0,Harnett,2023-02-03
3,20,6,14,0,Harnett,2023-02-14
3,12,6,6,0,Haywood,2022-12-13
3,7,6,1,0,Haywood,2022-12-23
3,12,6,6,0,Haywood,2023-02-21
3,19,6,13,0,Henderson,2022-11-22
3,19,6,13,0,Henderson,2022-12-02
3,18,6,12,0,Henderson,2023-01-25
3,11,6,5,0,Henderson,2023-05-01
3,10,6,4,0,Iredell,2023-03-25
3,12,6,6,0,Iredell,2023-03-30
3,12,6,6,0,Iredell,2023-04-11
3,9,6,3,0,Jackson,2022-12-28
3,18,6,12,0,Lee,2022-12-17
3,10,6,4,0,Lee,2023-02-06
3,7,6,1,0,Lee,2023-02-19
3,14,6,8,0,Lincoln,2023-01-07
3,16,6,10,0,Macon,2022-12-29
3,7,6,1,0,Madison,2023-02-20
3,14,6,8,0,McDowell,2023-01-10
3,30,6,24,0,Mecklenburg,2023-04-02
3,9,6,3,0,Nash,2023-03-06
3,13,6,7,0,New Hanover,2023-03-07
3,11,6,5,0,Northampton,2023-01-03
3,8,6,2,0,Pasquotank,2022-12-20
3,7,6,1,0,Polk,2023-04-09
3,11,6,5,0,Randolph,2022-11-18
3,14,6,8,0,Randolph,2023-02-17
3,11,6,5,0,Randolph,2023-02-24
3,9,6,3,0,Randolph,2023-03-28
3,8,6,2,0,Robeson,2022-11-16
3,9,6,3,0,Robeson,2023-03-03
3,22,6,16,0,Rockingham,2022-12-27
3,13,6,7,0,Rowan,2022-12-10
3,16,6,10,0,Sampson,2022-11-28
3,9,6,3,0,Sampson,2022-12-02
3,11,6,5,0,Sampson,2023-01-24
3,7,6,1,0,Scotland,2023-01-26
3,8,6,2,0,Scotland,2023-01-27
3,10,6,4,0,Surry,2023-02-16
3,33,6,27,0,Union,2023-02-21
3,9,6,3,0,Union,2023-03-19
3,12,6,6,0,Vance,2022-12-06
3,13,6,7,0,Vance,2023-01-30
3,12,6,6,0,Vance,2023-02-03
3,30,6,24,0,Wake,2023-05-06
3,10,6,4,0,Warren,2023-01-09
3,17,6,11,0,Watauga,2023-01-25
3,12,6,6,0,Wilkes,2022-12-11
3,12,7,5,0,Alexander,2022-12-14
3,7,7,0,0,Bladen,2022-11-26
3,13,7,6,0,Buncombe,2023-03-02
3,11,7,4,0,Catawba,2023-02-04
3,14,7,7,0,Catawba,2023-03-17
3,8,7,1,0,Catawba,2023-03-21
3,21,7,14,0,Cumberland,2022-11-20
3,12,7,5,0,Cumberland,2023-03-05
3,10,7,3,0,Cumberland,2023-04-18
3,10,7,3,0,Duplin,2022-11-22
3,24,7,17,0,Forsyth,2022-11-13
3,18,7,11,0,Gaston,2023-02-19
3,14,7,7,0,Gaston,2023-03-13
3,25,7,18,0,Granville,2022-12-21
3,17,7,10,0,Granville,2023-02-07
3,11,7,4,0,Harnett,2022-11-15
3,21,7,14,0,Henderson,2022-12-11
3,21,7,14,0,Henderson,2022-12-24
3,17,7,10,0,Henderson,2023-01-06
3,8,7,1,0,Jones,2022-12-30
3,12,7,5,0,Lee,2022-11-30
3,18,7,11,0,Lee,2022-12-13
3,16,7,9,0,Lee,2022-12-26
3,14,7,7,0,Lee,2023-01-24
3,17,7,10,0,Lincoln,2022-12-23
3,20,7,13,0,New Hanover,2022-11-25
3,9,7,2,0,Pasquotank,2023-01-19
3,15,7,8,0,Person,2022-12-26
3,23,7,16,0,Person,2022-12-28
3,17,7,10,0,Pitt,2022-11-09
3,18,7,11,0,Randolph,2022-11-23
3,12,7,5,0,Randolph,2023-03-30
3,15,7,8,0,Robeson,2022-11-22
3,12,7,5,0,Rockingham,2023-01-13
3,12,7,5,0,Sampson,2023-02-07
3,23,7,16,0,Union,2023-02-18
3,10,7,3,0,Wayne,2023-04-03
3,11,7,4,0,Wilkes,2023-01-13
3,17,7,10,0,Wilkes,2023-01-17
3,14,7,7,0,Wilkes,2023-02-05
3,10,7,3,0,Wilson,2023-03-02
3,8,7,1,0,Wilson,2023-03-13
3,14,8,6,0,Ashe,2022-12-19
3,13,8,5,0,Beaufort,2023-01-19
3,20,8,12,0,Brunswick,2023-01-19
3,28,8,20,0,Brunswick,2023-01-30
3,22,8,14,0,Brunswick,2023-02-20
3,24,8,16,0,Buncombe,2022-11-17
3,16,8,8,0,Buncombe,2023-03-29
3,27,8,19,0,Cabarrus,2022-11-17
3,31,8,23,0,Cabarrus,2023-02-03
3,28,8,20,0,Caldwell,2022-12-22
3,31,8,23,0,Chatham,2022-12-29
3,15,8,7,0,Chatham,2023-02-23
3,10,8,2,0,Chatham,2023-03-20
3,18,8,10,0,Davie,2022-12-12
3,12,8,4,0,Duplin,2023-01-12
3,10,8,2,0,Gates,2023-01-24
3,13,8,5,0,Haywood,2023-01-17
3,20,8,12,0,Henderson,2022-11-21
3,25,8,17,0,Henderson,2022-12-07
3,17,8,9,0,Henderson,2023-02-09
3,13,8,5,0,Iredell,2023-03-21
3,11,8,3,0,Iredell,2023-04-02
3,11,8,3,0,Jackson,2023-02-01
3,24,8,16,0,Johnston,2023-02-16
3,13,8,5,0,Johnston,2023-04-11
3,17,8,9,0,Lee,2022-12-22
3,11,8,3,0,Mitchell,2022-12-28
3,24,8,16,0,Moore,2022-12-23
3,13,8,5,0,Nash,2023-01-23
3,27,8,19,0,New Hanover,2022-11-22
3,17,8,9,0,New Hanover,2023-02-14
3,15,8,7,0,Pitt,2023-03-22
3,12,8,4,0,Randolph,2023-02-28
3,19,8,11,0,Richmond,2022-12-10
3,10,8,2,0,Robeson,2023-03-30
3,15,8,7,0,Robeson,2023-05-05
3,15,8,7,0,Rutherford,2023-01-13
3,17,8,9,0,Rutherford,2023-01-18
3,15,8,7,0,Sampson,2022-12-31
3,12,8,4,0,Surry,2023-03-27
3,9,8,1,0,Wilkes,2022-11-25
3,19,8,11,0,Wilson,2022-12-23
3,15,8,7,0,Wilson,2023-01-29
3,16,8,8,0,Yadkin,2022-12-12
3,14,9,5,0,Beaufort,2022-12-12
3,29,9,20,0,Brunswick,2022-12-24
3,23,9,14,0,Cabarrus,2022-11-27
3,20,9,11,0,Carteret,2022-12-30
3,13,9,4,0,Catawba,2023-03-22
3,11,9,2,0,Catawba,2023-03-23
3,22,9,13,0,Chatham,2022-12-12
3,24,9,15,0,Craven,2022-11-28
3,13,9,4,0,Davie,2022-12-13
3,12,9,3,0,Duplin,2023-02-02
3,27,9,18,0,Gaston,2022-11-16
3,17,9,8,0,Granville,2022-12-07
3,21,9,12,0,Henderson,2022-12-08
3,20,9,11,0,Iredell,2022-11-16
3,22,9,13,0,Iredell,2022-12-11
3,19,9,10,0,Johnston,2023-02-05
3,19,9,10,0,McDowell,2022-12-28
3,10,9,1,0,Mitchell,2023-01-14
3,14,9,5,0,New Hanover,2023-04-03
3,12,9,3,0,Randolph,2023-02-22
3,16,9,7,0,Richmond,2023-02-08
3,11,9,2,0,Robeson,2022-11-27
3,13,9,4,0,Sampson,2023-02-02
3,10,9,1,0,Scotland,2023-02-03
3,16,9,7,0,Stokes,2022-11-21
3,25,9,16,0,Surry,2023-01-10
3,23,9,14,0,Surry,2023-02-07
3,24,9,15,0,Surry,2023-02-13
3,11,9,2,0,Swain,2023-01-19
3,9,9,0,0,Vance,2023-04-12
3,11,9,2,0,Wayne,2023-01-28
3,11,9,2,0,Wayne,2023-03-28
3,16,9,7,0,Wilkes,2022-12-23
3,26,10,16,0,Buncombe,2023-02-14
3,18,10,8,0,Carteret,2023-01-20
3,14,10,4,0,Carteret,2023-01-30
3,16,10,6,0,Cumberland,2023-04-27
3,19,10,9,0,Forsyth,2023-03-18
3,34,10,24,0,Guilford,2023-02-25
3,19,10,9,0,Harnett,2022-12-10
3,25,10,15,0,Henderson,2022-12-05
3,24,10,14,0,Henderson,2022-12-16
3,15,10,5,0,Johnston,2023-02-24
3,15,10,5,0,Lenoir,2023-01-01
3,12,10,2,0,Lincoln,2023-02-28
3,21,10,11,0,Moore,2022-12-09
3,18,10,8,0,Nash,2023-02-03
3,16,10,6,0,Pender,2023-01-26
3,20,10,10,0,Pitt,2022-11-25
3,22,10,12,0,Randolph,2022-11-28
3,25,10,15,0,Rockingham,2023-01-17
3,15,10,5,0,Sampson,2022-12-06
3,14,10,4,0,Sampson,2022-12-16
3,14,10,4,0,Sampson,2023-01-20
3,10,10,0,0,Scotland,2022-12-15
3,19,10,9,0,Scotland,2023-01-04
3,15,10,5,0,Scotland,2023-01-10
3,37,11,26,0,Brunswick,2023-01-07
3,26,11,15,0,Carteret,2023-01-10
3,20,11,9,0,Catawba,2023-01-21
3,23,11,12,0,Craven,2023-01-02
3,13,11,2,0,Hertford,2022-12-22
3,20,11,9,0,Iredell,2022-11-10
3,23,11,12,0,Iredell,2022-11-26
3,15,11,4,0,Montgomery,2022-12-27
3,19,11,8,0,Randolph,2023-01-19
3,16,11,5,0,Sampson,2022-12-26
3,14,11,3,0,Sampson,2023-02-14
3,13,11,2,0,Scotland,2022-12-31
3,18,11,7,0,Surry,2023-02-23
3,24,12,12,0,Buncombe,2022-12-10
3,19,12,7,0,Iredell,2022-11-27
3,26,12,14,0,Iredell,2022-12-10
3,19,12,7,0,Lincoln,2023-01-25
3,15,12,3,0,Pasquotank,2023-02-01
3,26,12,14,0,Robeson,2023-02-11
3,30,12,18,0,Wake,2023-03-19
3,15,12,3,0,Wilkes,2022-12-31
3,16,13,3,0,Moore,2022-11-25
3,24,13,11,0,Wilkes,2022-12-02
3,38,14,24,0,Franklin,2023-01-02
3,25,14,11,0,New Hanover,2022-11-30
3,30,14,16,0,New Hanover,2023-02-15
3,21,15,6,0,Catawba,2022-11-29
3,16,15,1,0,Scotland,2022-12-26
3,21,15,6,0,Wayne,2022-11-09
3,23,16,7,0,Carteret,2022-12-23
3,25,16,9,0,Catawba,2022-11-08
3,26,17,9,0,Duplin,2023-01-23
3,31,17,14,0,New Hanover,2022-11-26
3,32,18,14,0,Buncombe,2022-11-25
3,26,18,8,0,Sampson,2022-12-19
3,27,18,9,0,Wayne,2023-02-10
3,25,19,6,0,Carteret,2022-12-26
3,33,19,14,0,Craven,2022-12-24
3,33,19,14,0,Sampson,2023-01-04
3,50,24,26,0,New Hanover,2022-12-14
4,12,0,12,0,Alamance,2022-11-19
4,5,0,5,0,Alamance,2023-04-25
4,9,0,9,0,Anson,2022-12-19
4,13,0,13,0,Beaufort,2022-12-27
4,9,0,9,0,Bertie,2023-02-02
4,6,0,6,0,Bertie,2023-02-06
4,8,0,8,0,Brunswick,2023-02-16
4,6,0,6,0,Burke,2023-04-21
4,13,0,13,0,Cabarrus,2023-02-26
4,15,0,15,0,Caldwell,2023-02-17
4,9,0,9,0,Caldwell,2023-04-13
4,11,0,11,0,Chowan,2023-01-05
4,10,0,10,0,Dare,2023-01-26
4,10,0,10,0,Dare,2023-02-01
4,7,0,7,0,Dare,2023-02-08
4,8,0,8,0,Dare,2023-02-12
4,7,0,7,0,Davidson,2023-04-17
4,11,0,11,0,Edgecombe,2022-11-29
4,10,0,10,0,Edgecombe,2023-02-01
4,9,0,9,0,Edgecombe,2023-02-03
4,18,0,18,0,Gaston,2022-11-17
4,10,0,10,0,Granville,2023-02-15
4,8,0,8,0,Hertford,2023-02-22
4,15,0,15,0,Hoke,2023-02-13
4,7,0,7,0,Johnston,2023-03-31
4,9,0,9,0,Lenoir,2022-12-05
4,13,0,13,0,McDowell,2022-11-17
4,12,0,12,0,McDowell,2022-12-12
4,5,0,5,0,Nash,2023-01-22
4,13,0,13,0,Onslow,2023-03-02
4,11,0,11,0,Onslow,2023-03-22
4,35,0,35,0,Orange,2023-01-10
4,10,0,10,0,Pender,2023-01-02
4,5,0,5,0,Richmond,2023-03-01
4,10,0,10,0,Richmond,2023-04-27
4,11,0,11,0,Rowan,2022-12-01
4,8,0,8,0,Rowan,2023-03-16
4,8,0,8,0,Rutherford,2022-12-03
4,11,0,11,0,Rutherford,2023-01-15
4,7,0,7,0,Stanly,2022-11-14
4,13,0,13,0,Stanly,2022-12-05
4,13,0,13,0,Wayne,2022-12-25
4,14,1,13,0,Alamance,2023-03-14
4,6,1,5,0,Bertie,2022-12-06
4,8,1,7,0,Brunswick,2023-02-18
4,9,1,8,0,Burke,2023-02-02
4,13,1,12,0,Caldwell,2023-02-05
4,8,1,7,0,Catawba,2022-11-20
4,11,1,10,0,Chatham,2022-11-21
4,11,1,10,0,Chatham,2023-01-26
4,14,1,13,0,Chatham,2023-01-31
4,7,1,6,0,Chowan,2023-01-26
4,15,1,14,0,Chowan,2023-01-31
4,9,1,8,0,Cleveland,2022-11-08
4,7,1,6,0,Cleveland,2022-11-26
4,7,1,6,0,Cleveland,2023-01-08
4,19,1,18,0,Cleveland,2023-02-15
4,4,1,3,0,Cleveland,2023-04-06
4,11,1,10,0,Columbus,2023-01-01
4,7,1,6,0,Columbus,2023-02-16
4,15,1,14,0,Davidson,2023-02-04
4,9,1,8,0,Davidson,2023-03-27
4,14,1,13,0,Davidson,2023-03-28
4,18,1,17,0,Duplin,2023-01-02
4,12,1,11,0,Durham,2022-11-13
4,28,1,27,0,Durham,2022-12-04
4,13,1,12,0,Durham,2023-04-25
4,16,1,15,0,Edgecombe,2022-12-22
4,10,1,9,0,Edgecombe,2023-01-11
4,12,1,11,0,Franklin,2022-11-30
4,17,1,16,0,Gaston,2023-03-06
4,11,1,10,0,Granville,2023-02-20
4,16,1,15,0,Greene,2023-01-09
4,9,1,8,0,Halifax,2022-12-24
4,5,1,4,0,Halifax,2023-03-04
4,13,1,12,0,Harnett,2023-02-21
4,14,1,13,0,Hoke,2023-02-15
4,13,1,12,0,Johnston,2023-02-25
4,11,1,10,0,Lee,2023-01-01
4,9,1,8,0,Lee,2023-01-30
4,13,1,12,0,Lenoir,2022-11-30
4,13,1,12,0,Lenoir,2023-02-14
4,12,1,11,0,Lincoln,2022-12-17
4,5,1,4,0,Lincoln,2023-02-19
4,10,1,9,0,McDowell,2022-12-26
4,6,1,5,0,McDowell,2023-02-07
4,11,1,10,0,Moore,2023-02-28
4,10,1,9,0,Moore,2023-03-21
4,29,1,28,0,Onslow,2023-02-15
4,19,1,18,0,Onslow,2023-03-20
4,10,1,9,0,Person,2022-12-13
4,13,1,12,0,Pitt,2022-12-04
4,10,1,9,0,Rockingham,2023-02-22
4,24,1,23,0,Rowan,2022-11-08
4,9,1,8,0,Rutherford,2022-12-17
4,6,1,5,0,Rutherford,2023-02-02
4,6,1,5,0,Rutherford,2023-02-14
4,15,1,14,0,Stanly,2023-01-26
4,7,1,6,0,Stanly,2023-02-02
4,17,1,16,0,Stanly,2023-02-21
4,8,1,7,0,Stokes,2023-02-18
4,9,1,8,0,Surry,2022-11-10
4,6,1,5,0,Swain,2023-01-12
4,15,1,14,0,Vance,2022-12-13
4,7,1,6,0,Vance,2023-03-02
4,9,1,8,0,Warren,2023-01-05
4,7,1,6,0,Washington,2022-12-14
4,8,1,7,0,Washington,2023-01-18
4,8,1,7,0,Washington,2023-01-31
4,9,1,8,0,Yadkin,2023-01-15
4,6,1,5,0,Yadkin,2023-02-04
4,8,2,6,0,Alamance,2023-04-05
4,9,2,7,0,Alexander,2023-02-06
4,11,2,9,0,Anson,2023-02-02
4,8,2,6,0,Beaufort,2023-02-28
4,18,2,16,0,Bladen,2023-01-13
4,13,2,11,0,Bladen,2023-01-30
4,21,2,19,0,Brunswick,2022-11-29
4,28,2,26,0,Brunswick,2022-12-05
4,16,2,14,0,Burke,2022-11-26
4,6,2,4,0,Burke,2023-03-28
4,9,2,7,0,Cabarrus,2023-04-18
4,15,2,13,0,Caldwell,2023-02-16
4,12,2,10,0,Caldwell,2023-02-23
4,10,2,8,0,Caldwell,2023-04-19
4,7,2,5,0,Caswell,2023-01-09
4,5,2,3,0,Catawba,2023-04-05
4,18,2,16,0,Chatham,2023-01-25
4,9,2,7,0,Chatham,2023-02-24
4,9,2,7,0,Cherokee,2022-12-28
4,8,2,6,0,Cherokee,2023-01-22
4,8,2,6,0,Chowan,2023-01-20
4,11,2,9,0,Cleveland,2023-02-08
4,9,2,7,0,Cleveland,2023-02-19
4,6,2,4,0,Columbus,2022-12-05
4,10,2,8,0,Columbus,2023-01-25
4,24,2,22,0,Davidson,2022-12-11
4,9,2,7,0,Davidson,2023-02-25
4,8,2,6,0,Davie,2023-02-24
4,14,2,12,0,Durham,2023-04-26
4,12,2,10,0,Durham,2023-05-02
4,12,2,10,0,Edgecombe,2022-12-12
4,15,2,13,0,Edgecombe,2022-12-14
4,9,2,7,0,Edgecombe,2022-12-15
4,7,2,5,0,Edgecombe,2023-02-13
4,14,2,12,0,Franklin,2023-01-23
4,7,2,5,0,Franklin,2023-02-20
4,17,2,15,0,Granville,2022-12-31
4,20,2,18,0,Granville,2023-01-04
4,14,2,12,0,Granville,2023-01-13
4,8,2,6,0,Halifax,2022-12-25
4,24,2,22,0,Harnett,2022-12-02
4,19,2,17,0,Harnett,2023-02-07
4,13,2,11,0,Harnett,2023-03-20
4,9,2,7,0,Hertford,2022-12-26
4,19,2,17,0,Hoke,2022-12-30
4,16,2,14,0,Hoke,2023-01-12
4,6,2,4,0,Iredell,2023-03-18
4,17,2,15,0,Johnston,2022-11-10
4,11,2,9,0,Johnston,2023-03-18
4,5,2,3,0,Johnston,2023-04-19
4,7,2,5,0,Johnston,2023-04-25
4,10,2,8,0,Lee,2023-01-21
4,11,2,9,0,Lenoir,2022-11-28
4,8,2,6,0,Lenoir,2022-11-29
4,14,2,12,0,Lenoir,2022-12-26
4,8,2,6,0,Lenoir,2023-01-24
4,15,2,13,0,Lincoln,2022-11-28
4,15,2,13,0,Lincoln,2022-12-08
4,21,2,19,0,Lincoln,2022-12-13
4,12,2,10,0,Lincoln,2023-01-12
4,11,2,9,0,Lincoln,2023-03-22
4,4,2,2,0,Montgomery,2022-12-07
4,15,2,13,0,Moore,2023-01-08
4,16,2,14,0,Nash,2022-11-30
4,8,2,6,0,Northampton,2023-01-19
4,5,2,3,0,Northampton,2023-01-25
4,24,2,22,0,Orange,2023-01-31
4,17,2,15,0,Orange,2023-02-27
4,9,2,7,0,Orange,2023-03-03
4,11,2,9,0,Pitt,2022-12-24
4,11,2,9,0,Pitt,2023-03-19
4,12,2,10,0,Randolph,2023-01-14
4,13,2,11,0,Richmond,2022-12-31
4,9,2,7,0,Rockingham,2023-01-14
4,12,2,10,0,Rockingham,2023-01-27
4,12,2,10,0,Rockingham,2023-02-17
4,6,2,4,0,Rockingham,2023-04-10
4,18,2,16,0,Rowan,2023-01-28
4,10,2,8,0,Rowan,2023-04-03
4,14,2,12,0,Rutherford,2022-12-20
4,10,2,8,0,Rutherford,2023-02-08
4,23,2,21,0,Stanly,2022-12-21
4,8,2,6,0,Stanly,2023-03-09
4,13,2,11,0,Stokes,2022-12-15
4,9,2,7,0,Stokes,2023-01-13
4,12,2,10,0,Surry,2023-02-10
4,16,2,14,0,Union,2023-03-22
4,17,2,15,0,Vance,2022-12-14
4,8,2,6,0,Vance,2022-12-15
4,9,2,7,0,Warren,2022-12-22
4,6,2,4,0,Watauga,2023-03-08
4,10,2,8,0,Wilson,2022-11-18
4,9,2,7,0,Yadkin,2023-01-19
4,24,3,21,0,Alamance,2022-12-04
4,25,3,22,0,Alamance,2023-02-17
4,6,3,3,0,Alamance,2023-03-15
4,12,3,9,0,Alamance,2023-04-17
4,11,3,8,0,Beaufort,2023-01-03
4,5,3,2,0,Beaufort,2023-03-17
4,9,3,6,0,Brunswick,2023-03-02
4,15,3,12,0,Brunswick,2023-03-24
4,7,3,4,0,Burke,2023-03-20
4,13,3,10,0,Caldwell,2022-11-09
4,17,3,14,0,Caldwell,2023-02-27
4,10,3,7,0,Caldwell,2023-03-01
4,11,3,8,0,Caldwell,2023-03-13
4,10,3,7,0,Caldwell,2023-03-22
4,14,3,11,0,Carteret,2022-12-31
4,13,3,10,0,Catawba,2022-11-11
4,13,3,10,0,Cleveland,2023-01-13
4,16,3,13,0,Cleveland,2023-02-02
4,11,3,8,0,Columbus,2023-01-24
4,14,3,11,0,Craven,2023-01-23
4,7,3,4,0,Craven,2023-05-01
4,11,3,8,0,Cumberland,2023-03-04
4,12,3,9,0,Cumberland,2023-03-26
4,21,3,18,0,Davidson,2022-12-25
4,14,3,11,0,Davidson,2023-02-12
4,13,3,10,0,Davidson,2023-03-06
4,12,3,9,0,Davidson,2023-03-21
4,13,3,10,0,Davidson,2023-04-24
4,21,3,18,0,Davie,2022-12-30
4,9,3,6,0,Davie,2023-02-14
4,7,3,4,0,Davie,2023-02-17
4,24,3,21,0,Durham,2023-04-05
4,20,3,17,0,Durham,2023-04-27
4,16,3,13,0,Edgecombe,2023-01-31
4,8,3,5,0,Franklin,2023-02-09
4,13,3,10,0,Gaston,2022-11-20
4,10,3,7,0,Granville,2023-02-24
4,11,3,8,0,Guilford,2023-05-04
4,9,3,6,0,Halifax,2022-11-18
4,9,3,6,0,Halifax,2022-11-30
4,16,3,13,0,Halifax,2023-01-07
4,15,3,12,0,Harnett,2022-12-17
4,12,3,9,0,Harnett,2023-02-28
4,10,3,7,0,Harnett,2023-03-01
4,9,3,6,0,Henderson,2023-03-21
4,9,3,6,0,Hertford,2023-01-13
4,12,3,9,0,Hoke,2022-12-09
4,9,3,6,0,Johnston,2023-04-04
4,19,3,16,0,Lenoir,2022-12-31
4,11,3,8,0,Lenoir,2023-02-27
4,7,3,4,0,Lincoln,2023-01-01
4,10,3,7,0,Lincoln,2023-02-12
4,9,3,6,0,McDowell,2022-12-31
4,9,3,6,0,McDowell,2023-02-17
4,18,3,15,0,Mecklenburg,2023-04-09
4,4,3,1,0,Montgomery,2023-03-22
4,17,3,14,0,Nash,2022-12-05
4,16,3,13,0,Nash,2023-01-10
4,8,3,5,0,Nash,2023-03-09
4,7,3,4,0,Northampton,2023-01-17
4,36,3,33,0,Onslow,2023-01-19
4,18,3,15,0,Orange,2022-11-25
4,41,3,38,0,Orange,2023-01-03
4,22,3,19,0,Orange,2023-01-08
4,17,3,14,0,Orange,2023-03-29
4,18,3,15,0,Person,2022-12-29
4,11,3,8,0,Person,2023-01-20
4,17,3,14,0,Pitt,2023-03-20
4,14,3,11,0,Richmond,2022-12-07
4,14,3,11,0,Rockingham,2023-01-31
4,18,3,15,0,Rockingham,2023-02-08
4,24,3,21,0,Rowan,2022-11-30
4,12,3,9,0,Rowan,2023-03-02
4,15,3,12,0,Stanly,2023-01-16
4,17,3,14,0,Surry,2022-11-25
4,20,3,17,0,Surry,2023-02-09
4,13,3,10,0,Union,2023-04-04
4,9,3,6,0,Vance,2023-01-26
4,10,3,7,0,Yadkin,2023-02-21
4,24,4,20,0,Alamance,2022-11-20
4,13,4,9,0,Alamance,2023-03-07
4,15,4,11,0,Alamance,2023-03-21
4,9,4,5,0,Alamance,2023-04-18
4,17,4,13,0,Alexander,2022-12-28
4,13,4,9,0,Ashe,2022-12-24
4,15,4,11,0,Beaufort,2023-02-06
4,16,4,12,0,Bladen,2022-12-20
4,16,4,12,0,Bladen,2022-12-22
4,17,4,13,0,Bladen,2023-01-25
4,12,4,8,0,Brunswick,2022-11-15
4,19,4,15,0,Brunswick,2023-01-22
4,10,4,6,0,Buncombe,2023-02-25
4,13,4,9,0,Burke,2023-02-25
4,13,4,9,0,Cabarrus,2023-03-10
4,13,4,9,0,Cabarrus,2023-03-21
4,15,4,11,0,Chatham,2023-01-16
4,10,4,6,0,Clay,2023-01-16
4,13,4,9,0,Cumberland,2023-03-11
4,21,4,17,0,Davidson,2022-11-26
4,22,4,18,0,Davie,2022-11-30
4,13,4,9,0,Davie,2022-12-18
4,33,4,29,0,Durham,2022-11-23
4,15,4,11,0,Durham,2023-04-19
4,28,4,24,0,Forsyth,2023-04-03
4,18,4,14,0,Forsyth,2023-04-14
4,15,4,11,0,Forsyth,2023-04-19
4,13,4,9,0,Franklin,2023-01-16
4,19,4,15,0,Franklin,2023-01-18
4,18,4,14,0,Franklin,2023-01-30
4,25,4,21,0,Gaston,2022-11-18
4,15,4,11,0,Granville,2022-12-12
4,12,4,8,0,Greene,2022-12-19
4,18,4,14,0,Halifax,2022-12-28
4,12,4,8,0,Halifax,2023-01-08
4,15,4,11,0,Harnett,2022-12-18
4,23,4,19,0,Harnett,2023-01-17
4,13,4,9,0,Haywood,2023-01-05
4,15,4,11,0,Haywood,2023-02-14
4,16,4,12,0,Henderson,2022-11-18
4,9,4,5,0,Henderson,2023-02-19
4,10,4,6,0,Hertford,2023-01-23
4,24,4,20,0,Hoke,2023-01-10
4,8,4,4,0,Iredell,2023-02-24
4,9,4,5,0,Iredell,2023-03-11
4,17,4,13,0,Johnston,2023-03-02
4,9,4,5,0,Johnston,2023-03-20
4,17,4,13,0,Lee,2022-12-21
4,15,4,11,0,Lincoln,2023-03-17
4,12,4,8,0,McDowell,2023-02-01
4,12,4,8,0,McDowell,2023-02-10
4,8,4,4,0,McDowell,2023-02-21
4,18,4,14,0,Moore,2023-01-15
4,27,4,23,0,Moore,2023-01-31
4,17,4,13,0,Moore,2023-02-07
4,24,4,20,0,New Hanover,2023-02-09
4,8,4,4,0,New Hanover,2023-03-26
4,27,4,23,0,Onslow,2022-11-30
4,21,4,17,0,Onslow,2022-12-02
4,32,4,28,0,Onslow,2022-12-21
4,18,4,14,0,Orange,2022-12-04
4,23,4,19,0,Orange,2022-12-31
4,17,4,13,0,Orange,2023-01-15
4,21,4,17,0,Orange,2023-02-13
4,13,4,9,0,Orange,2023-03-06
4,20,4,16,0,Pender,2022-12-14
4,13,4,9,0,Pender,2023-01-17
4,6,4,2,0,Perquimans,2023-02-06
4,15,4,11,0,Person,2023-01-30
4,12,4,8,0,Pitt,2022-11-18
4,12,4,8,0,Pitt,2023-03-10
4,15,4,11,0,Richmond,2022-12-13
4,10,4,6,0,Richmond,2022-12-23
4,14,4,10,0,Richmond,2022-12-28
4,11,4,7,0,Richmond,2023-02-21
4,7,4,3,0,Robeson,2022-11-20
4,6,4,2,0,Robeson,2023-05-06
4,10,4,6,0,Rockingham,2023-01-15
4,6,4,2,0,Rockingham,2023-04-27
4,14,4,10,0,Rowan,2023-02-27
4,15,4,11,0,Rowan,2023-04-13
4,7,4,3,0,Scotland,2023-02-05
4,13,4,9,0,Stokes,2022-11-09
4,5,4,1,0,Stokes,2023-03-02
4,19,4,15,0,Union,2022-11-13
4,15,4,11,0,Union,2022-11-24
4,12,4,8,0,Union,2023-04-14
4,12,4,8,0,Watauga,2022-12-06
4,9,4,5,0,Wayne,2023-03-18
4,7,4,3,0,Wayne,2023-04-06
4,7,4,3,0,Wilkes,2023-03-14
4,8,4,4,0,Wilkes,2023-05-02
4,14,4,10,0,Yadkin,2022-12-11
4,11,5,6,0,Alamance,2023-04-21
4,16,5,11,0,Brunswick,2022-11-09
4,18,5,13,0,Brunswick,2023-01-21
4,16,5,11,0,Brunswick,2023-02-15
4,19,5,14,0,Burke,2022-11-28
4,26,5,21,0,Burke,2023-02-08
4,17,5,12,0,Burke,2023-02-16
4,15,5,10,0,Cabarrus,2023-03-22
4,25,5,20,0,Caldwell,2022-12-31
4,11,5,6,0,Caswell,2022-12-27
4,14,5,9,0,Catawba,2022-12-25
4,9,5,4,0,Catawba,2023-04-06
4,20,5,15,0,Chatham,2022-11-28
4,7,5,2,0,Clay,2023-01-04
4,22,5,17,0,Columbus,2023-01-18
4,22,5,17,0,Craven,2022-12-12
4,16,5,11,0,Craven,2023-02-02
4,14,5,9,0,Davie,2023-01-19
4,12,5,7,0,Davie,2023-01-25
4,12,5,7,0,Duplin,2022-12-16
4,22,5,17,0,Forsyth,2023-04-16
4,17,5,12,0,Granville,2022-12-13
4,12,5,7,0,Halifax,2022-12-23
4,16,5,11,0,Hoke,2023-01-21
4,11,5,6,0,Iredell,2023-03-28
4,7,5,2,0,Iredell,2023-04-06
4,10,5,5,0,Jackson,2023-04-18
4,7,5,2,0,Jackson,2023-04-24
4,23,5,18,0,Johnston,2023-02-27
4,18,5,13,0,Moore,2022-12-02
4,17,5,12,0,New Hanover,2022-11-09
4,20,5,15,0,New Hanover,2023-02-05
4,11,5,6,0,New Hanover,2023-03-27
4,31,5,26,0,Onslow,2022-12-05
4,22,5,17,0,Onslow,2023-01-16
4,17,5,12,0,Onslow,2023-02-23
4,16,5,11,0,Person,2022-12-12
4,13,5,8,0,Pitt,2023-03-09
4,9,5,4,0,Randolph,2023-03-03
4,9,5,4,0,Richmond,2023-02-01
4,11,5,6,0,Richmond,2023-02-13
4,8,5,3,0,Robeson,2022-11-19
4,13,5,8,0,Robeson,2022-11-21
4,6,5,1,0,Robeson,2022-11-25
4,9,5,4,0,Robeson,2023-03-29
4,17,5,12,0,Rockingham,2023-02-09
4,22,5,17,0,Rowan,2023-01-21
4,21,5,16,0,Rowan,2023-02-28
4,11,5,6,0,Rutherford,2023-01-26
4,7,5,2,0,Sampson,2022-11-16
4,14,5,9,0,Surry,2022-12-04
4,11,5,6,0,Surry,2023-01-08
4,27,5,22,0,Union,2022-11-21
4,25,5,20,0,Union,2022-12-03
4,13,5,8,0,Union,2023-03-10
4,13,5,8,0,Union,2023-03-16
4,13,5,8,0,Union,2023-04-25
4,16,5,11,0,Wayne,2023-03-23
4,20,5,15,0,Wilkes,2023-01-23
4,9,5,4,0,Wilson,2022-11-30
4,15,5,10,0,Wilson,2023-01-19
4,10,5,5,0,Wilson,2023-02-05
4,8,5,3,0,Wilson,2023-02-28
4,17,6,11,0,Alamance,2022-11-26
4,10,6,4,0,Alamance,2023-03-28
4,6,6,0,0,Bertie,2023-03-26
4,10,6,4,0,Buncombe,2023-04-21
4,15,6,9,0,Buncombe,2023-04-27
4,23,6,17,0,Cabarrus,2022-11-10
4,17,6,11,0,Cabarrus,2022-11-24
4,14,6,8,0,Cabarrus,2023-03-04
4,25,6,19,0,Caldwell,2023-01-16
4,9,6,3,0,Carteret,2023-01-31
4,10,6,4,0,Catawba,2023-04-10
4,17,6,11,0,Chatham,2023-01-19
4,7,6,1,0,Clay,2023-01-05
4,9,6,3,0,Columbus,2022-11-21
4,7,6,1,0,Columbus,2022-11-30
4,10,6,4,0,Craven,2022-11-14
4,9,6,3,0,Duplin,2023-01-20
4,13,6,7,0,Duplin,2023-02-15
4,19,6,13,0,Durham,2023-02-19
4,20,6,14,0,Forsyth,2023-03-05
4,23,6,17,0,Forsyth,2023-04-05
4,20,6,14,0,Forsyth,2023-04-12
4,10,6,4,0,Gaston,2023-03-17
4,20,6,14,0,Guilford,2023-03-18
4,13,6,7,0,Guilford,2023-04-15
4,22,6,16,0,Halifax,2023-01-30
4,7,6,1,0,Halifax,2023-04-26
4,9,6,3,0,Haywood,2023-01-12
4,16,6,10,0,Henderson,2023-01-31
4,13,6,7,0,Henderson,2023-02-27
4,24,6,18,0,Iredell,2022-11-08
4,11,6,5,0,Iredell,2023-03-05
4,12,6,6,0,Jackson,2023-01-12
4,12,6,6,0,Lenoir,2023-02-16
4,9,6,3,0,Lincoln,2022-11-10
4,19,6,13,0,Lincoln,2023-02-15
4,9,6,3,0,McDowell,2023-01-19
4,15,6,9,0,Moore,2023-01-07
4,20,6,14,0,Moore,2023-01-13
4,22,6,16,0,Nash,2022-12-13
4,21,6,15,0,New Hanover,2023-01-28
4,21,6,15,0,Pitt,2022-11-21
4,19,6,13,0,Pitt,2023-02-18
4,6,6,0,0,Randolph,2023-03-20
4,8,6,2,0,Randolph,2023-03-23
4,14,6,8,0,Richmond,2022-12-26
4,23,6,17,0,Rowan,2022-12-31
4,15,6,9,0,Rutherford,2023-01-23
4,9,6,3,0,Scotland,2023-02-27
4,13,6,7,0,Stokes,2023-02-21
4,22,6,16,0,Union,2022-11-18
4,19,6,13,0,Vance,2023-01-24
4,6,6,0,0,Warren,2023-04-13
4,17,6,11,0,Watauga,2022-12-22
4,10,6,4,0,Wilkes,2022-11-27
4,14,6,8,0,Wilkes,2023-01-30
4,8,6,2,0,Wilkes,2023-04-12
4,15,6,9,0,Wilson,2022-12-02
4,15,6,9,0,Wilson,2022-12-05
4,11,6,5,0,Wilson,2023-01-16
4,18,6,12,0,Yadkin,2022-12-16
4,16,6,10,0,Yadkin,2023-01-10
4,15,7,8,0,Alexander,2022-12-29
4,14,7,7,0,Bladen,2022-11-28
4,25,7,18,0,Brunswick,2023-01-25
4,25,7,18,0,Brunswick,2023-02-08
4,14,7,7,0,Brunswick,2023-03-21
4,27,7,20,0,Buncombe,2023-01-27
4,24,7,17,0,Buncombe,2023-02-28
4,13,7,6,0,Buncombe,2023-04-14
4,12,7,5,0,Buncombe,2023-05-02
4,11,7,4,0,Burke,2022-12-04
4,20,7,13,0,Cabarrus,2023-02-27
4,20,7,13,0,Cabarrus,2023-03-13
4,22,7,15,0,Cleveland,2022-12-13
4,28,7,21,0,Cumberland,2023-03-15
4,17,7,10,0,Cumberland,2023-04-03
4,12,7,5,0,Cumberland,2023-04-20
4,25,7,18,0,Davidson,2023-02-28
4,10,7,3,0,Davie,2023-02-15
4,15,7,8,0,Duplin,2023-02-10
4,24,7,17,0,Forsyth,2023-03-28
4,20,7,13,0,Forsyth,2023-04-27
4,15,7,8,0,Forsyth,2023-05-05
4,18,7,11,0,Gaston,2022-11-26
4,22,7,15,0,Gaston,2023-02-28
4,11,7,4,0,Gaston,2023-04-17
4,17,7,10,0,Halifax,2022-12-07
4,13,7,6,0,Henderson,2022-11-26
4,19,7,12,0,Henderson,2023-01-14
4,11,7,4,0,Henderson,2023-04-23
4,17,7,10,0,Hoke,2023-01-26
4,14,7,7,0,Iredell,2023-03-03
4,7,7,0,0,Jackson,2023-04-16
4,22,7,15,0,Johnston,2022-11-14
4,15,7,8,0,Johnston,2023-02-12
4,23,7,16,0,Lincoln,2023-01-11
4,18,7,11,0,McDowell,2023-01-05
4,17,7,10,0,Moore,2022-12-24
4,16,7,9,0,Nash,2023-01-12
4,18,7,11,0,New Hanover,2023-01-29
4,41,7,34,0,Onslow,2022-11-29
4,29,7,22,0,Onslow,2022-12-06
4,34,7,27,0,Onslow,2022-12-13
4,32,7,25,0,Onslow,2023-01-13
4,12,7,5,0,Pasquotank,2022-12-28
4,16,7,9,0,Person,2022-12-21
4,18,7,11,0,Pitt,2022-11-26
4,9,7,2,0,Robeson,2022-11-18
4,22,7,15,0,Rockingham,2022-12-12
4,23,7,16,0,Rowan,2022-11-14
4,14,7,7,0,Rutherford,2022-12-05
4,15,7,8,0,Rutherford,2023-01-21
4,12,7,5,0,Rutherford,2023-02-05
4,11,7,4,0,Scotland,2022-12-22
4,8,7,1,0,Scotland,2022-12-24
4,7,7,0,0,Scotland,2023-01-31
4,14,7,7,0,Stokes,2023-02-11
4,8,7,1,0,Swain,2023-01-18
4,18,7,11,0,Union,2023-03-01
4,9,7,2,0,Warren,2023-02-07
4,11,7,4,0,Wayne,2023-01-22
4,19,7,12,0,Wayne,2023-03-03
4,8,7,1,0,Wayne,2023-03-08
4,14,7,7,0,Wilkes,2023-02-04
4,13,7,6,0,Wilkes,2023-02-15
4,16,7,9,0,Wilson,2022-12-16
4,15,7,8,0,Yadkin,2022-11-29
4,22,8,14,0,Buncombe,2023-02-17
4,20,8,12,0,Buncombe,2023-04-24
4,22,8,14,0,Cabarrus,2023-03-01
4,18,8,10,0,Carteret,2023-01-17
4,11,8,3,0,Catawba,2023-01-22
4,10,8,2,0,Cherokee,2023-02-12
4,19,8,11,0,Craven,2022-12-05
4,20,8,12,0,Craven,2023-01-26
4,26,8,18,0,Davidson,2022-11-25
4,13,8,5,0,Gaston,2023-03-22
4,16,8,8,0,Guilford,2023-03-26
4,22,8,14,0,Guilford,2023-04-06
4,20,8,12,0,Guilford,2023-04-21
4,21,8,13,0,Harnett,2023-01-18
4,22,8,14,0,Haywood,2022-11-21
4,12,8,4,0,Haywood,2023-01-30
4,13,8,5,0,Henderson,2023-03-15
4,12,8,4,0,Iredell,2023-03-23
4,17,8,9,0,Iredell,2023-03-31
4,22,8,14,0,Johnston,2023-01-22
4,12,8,4,0,McDowell,2023-01-04
4,19,8,11,0,Moore,2022-12-31
4,24,8,16,0,Nash,2022-12-21
4,16,8,8,0,Nash,2023-02-07
4,49,8,41,0,Orange,2023-01-05
4,17,8,9,0,Pitt,2022-11-10
4,12,8,4,0,Randolph,2023-02-19
4,18,8,10,0,Robeson,2022-12-24
4,18,8,10,0,Robeson,2023-01-01
4,15,8,7,0,Robeson,2023-03-15
4,16,8,8,0,Rockingham,2022-12-02
4,12,8,4,0,Sampson,2023-01-08
4,14,8,6,0,Sampson,2023-02-08
4,25,8,17,0,Surry,2023-01-07
4,26,8,18,0,Wake,2023-04-28
4,15,8,7,0,Wilkes,2023-01-18
4,9,8,1,0,Wilkes,2023-04-30
4,15,9,6,0,Buncombe,2023-04-13
4,18,9,9,0,Buncombe,2023-04-18
4,35,9,26,0,Cabarrus,2023-02-14
4,13,9,4,0,Carteret,2022-12-25
4,11,9,2,0,Catawba,2023-03-15
4,12,9,3,0,Catawba,2023-03-30
4,15,9,6,0,Catawba,2023-04-24
4,13,9,4,0,Clay,2023-01-02
4,26,9,17,0,Craven,2022-12-08
4,21,9,12,0,Duplin,2023-01-26
4,26,9,17,0,Guilford,2023-04-18
4,14,9,5,0,Haywood,2022-12-29
4,18,9,9,0,Haywood,2023-01-02
4,18,9,9,0,Iredell,2022-11-15
4,21,9,12,0,Iredell,2023-01-15
4,19,9,10,0,Iredell,2023-02-17
4,16,9,7,0,Macon,2022-12-22
4,36,9,27,0,Mecklenburg,2023-03-18
4,38,9,29,0,Mecklenburg,2023-04-29
4,15,9,6,0,Montgomery,2022-12-22
4,12,9,3,0,Montgomery,2023-03-15
4,14,9,5,0,New Hanover,2023-05-03
4,12,9,3,0,Pasquotank,2023-02-07
4,12,9,3,0,Sampson,2023-01-27
4,13,9,4,0,Sampson,2023-02-16
4,15,9,6,0,Scotland,2023-01-20
4,15,9,6,0,Stokes,2022-11-17
4,18,9,9,0,Surry,2023-02-14
4,23,9,14,0,Wayne,2022-12-31
4,13,9,4,0,Wayne,2023-03-02
4,23,9,14,0,Wilkes,2022-12-06
4,12,9,3,0,Wilkes,2023-01-29
4,14,9,5,0,Wilkes,2023-02-16
4,21,9,12,0,Wilson,2022-12-07
4,16,9,7,0,Wilson,2023-02-20
4,31,10,21,0,Burke,2022-12-19
4,14,10,4,0,Carteret,2022-12-24
4,17,10,7,0,Catawba,2023-03-01
4,15,10,5,0,Catawba,2023-03-09
4,14,10,4,0,Catawba,2023-03-13
4,22,10,12,0,Cleveland,2022-12-01
4,20,10,10,0,Duplin,2023-01-30
4,23,10,13,0,Forsyth,2023-04-11
4,30,10,20,0,Forsyth,2023-05-01
4,30,10,20,0,Harnett,2022-12-31
4,12,10,2,0,Haywood,2023-02-07
4,22,10,12,0,Iredell,2023-02-12
4,27,10,17,0,Johnston,2023-01-15
4,14,10,4,0,Lee,2023-01-11
4,29,10,19,0,New Hanover,2023-02-01
4,28,10,18,0,Pitt,2023-01-16
4,15,10,5,0,Robeson,2022-11-08
4,14,10,4,0,Scotland,2023-01-23
4,21,10,11,0,Stokes,2022-12-08
4,24,11,13,0,Burke,2023-02-15
4,20,11,9,0,Catawba,2022-12-03
4,14,11,3,0,Catawba,2023-02-05
4,19,11,8,0,Columbus,2022-12-15
4,20,11,9,0,Columbus,2023-01-04
4,22,11,11,0,Duplin,2023-01-06
4,25,11,14,0,Duplin,2023-01-18
4,20,11,9,0,Haywood,2022-11-08
4,21,11,10,0,Iredell,2023-01-13
4,34,11,23,0,Johnston,2023-01-20
4,26,11,15,0,Lincoln,2023-01-17
4,20,11,9,0,Lincoln,2023-01-23
4,20,11,9,0,McDowell,2022-12-20
4,25,11,14,0,Nash,2022-12-12
4,19,11,8,0,Randolph,2023-01-31
4,15,11,4,0,Sampson,2022-12-09
4,15,11,4,0,Scotland,2023-01-02
4,17,11,6,0,Stokes,2022-11-14
4,20,11,9,0,Watauga,2022-12-16
4,12,11,1,0,Wayne,2023-04-04
4,23,12,11,0,Buncombe,2023-03-27
4,22,12,10,0,Catawba,2023-01-18
4,17,12,5,0,Davidson,2023-04-19
4,25,12,13,0,Duplin,2023-01-05
4,14,12,2,0,New Hanover,2023-04-10
4,16,12,4,0,Pasquotank,2023-01-26
4,15,12,3,0,Polk,2022-11-21
4,22,12,10,0,Robeson,2022-12-02
4,24,12,12,0,Rowan,2022-11-15
4,19,12,7,0,Sampson,2023-01-11
4,13,12,1,0,Scotland,2022-12-21
4,22,12,10,0,Stokes,2022-12-23
4,20,12,8,0,Wayne,2023-03-14
4,36,13,23,0,Craven,2023-01-06
4,65,13,52,0,Durham,2022-12-17
4,16,13,3,0,Haywood,2023-01-31
4,23,13,10,0,Iredell,2022-11-14
4,23,13,10,0,Iredell,2022-11-20
4,27,13,14,0,New Hanover,2023-02-13
4,29,13,16,0,Pitt,2023-01-27
4,14,13,1,0,Warren,2023-04-19
4,28,13,15,0,Wilkes,2022-12-26
4,20,13,7,0,Wilson,2022-12-12
4,31,14,17,0,Buncombe,2023-02-09
4,22,14,8,0,Carteret,2022-12-19
4,24,14,10,0,Catawba,2022-12-02
4,18,14,4,0,Catawba,2022-12-10
4,19,14,5,0,Iredell,2023-02-19
4,28,14,14,0,Pitt,2022-12-01
4,25,14,11,0,Sampson,2022-12-30
4,17,14,3,0,Sampson,2023-01-02
4,15,14,1,0,Scotland,2022-12-19
4,19,14,5,0,Wayne,2022-11-21
4,24,15,9,0,Catawba,2022-12-06
4,30,15,15,0,Gaston,2023-02-14
4,19,15,4,0,Haywood,2022-12-19
4,15,15,0,0,Polk,2022-11-15
4,16,15,1,0,Sampson,2023-01-30
4,18,15,3,0,Wilson,2022-12-09
4,28,16,12,0,Buncombe,2022-11-18
4,26,16,10,0,Buncombe,2022-12-25
4,28,16,12,0,Carteret,2022-12-27
4,25,16,9,0,Wayne,2022-12-06
4,24,17,7,0,Haywood,2022-12-22
4,36,18,18,0,Buncombe,2023-02-20
4,25,18,7,0,Sampson,2023-02-01
4,37,19,18,0,Buncombe,2023-02-02
4,35,19,16,0,Randolph,2022-12-15
4,30,19,11,0,Randolph,2022-12-17
4,41,20,21,0,Buncombe,2022-12-17
4,37,20,17,0,Iredell,2023-01-26
4,24,21,3,0,Carteret,2022-12-21
4,45,23,22,0,Iredell,2023-01-30
4,53,29,24,0,Wayne,2023-01-19
5,12,0,12,0,Beaufort,2023-01-11
5,13,0,13,0,Brunswick,2022-11-14
5,10,0,10,0,Burke,2023-02-10
5,21,0,21,0,Cabarrus,2023-02-28
5,8,0,8,0,Caldwell,2023-03-26
5,8,0,8,0,Chowan,2022-12-28
5,10,0,10,0,Chowan,2023-02-03
5,9,0,9,0,Dare,2022-12-19
5,7,0,7,0,Duplin,2023-01-15
5,6,0,6,0,Lincoln,2022-11-17
5,6,0,6,0,Martin,2023-01-25
5,11,0,11,0,Onslow,2023-03-07
5,10,0,10,0,Onslow,2023-03-13
5,18,0,18,0,Stanly,2022-12-01
5,20,0,20,0,Stanly,2022-12-22
5,8,0,8,0,Stanly,2022-12-24
5,15,0,15,0,Stanly,2023-01-25
5,13,0,13,0,Stanly,2023-01-31
5,11,0,11,0,Union,2023-02-26
5,14,0,14,0,Vance,2023-01-25
5,15,1,14,0,Alamance,2022-11-13
5,8,1,7,0,Anson,2023-02-06
5,12,1,11,0,Bladen,2022-12-26
5,12,1,11,0,Brunswick,2023-03-19
5,16,1,15,0,Chatham,2022-12-13
5,13,1,12,0,Chowan,2023-02-02
5,12,1,11,0,Cleveland,2023-02-09
5,14,1,13,0,Cleveland,2023-03-05
5,11,1,10,0,Craven,2022-12-07
5,16,1,15,0,Davidson,2022-11-10
5,15,1,14,0,Davidson,2023-02-11
5,36,1,35,0,Durham,2022-11-18
5,36,1,35,0,Durham,2022-11-21
5,11,1,10,0,Durham,2023-04-11
5,15,1,14,0,Durham,2023-05-01
5,13,1,12,0,Edgecombe,2023-01-13
5,13,1,12,0,Edgecombe,2023-02-08
5,5,1,4,0,Granville,2023-03-04
5,14,1,13,0,Halifax,2022-12-12
5,16,1,15,0,Halifax,2023-01-20
5,10,1,9,0,Hoke,2022-12-14
5,12,1,11,0,Lenoir,2022-12-06
5,14,1,13,0,Lenoir,2022-12-12
5,12,1,11,0,Moore,2023-02-17
5,28,1,27,0,Onslow,2022-12-31
5,12,1,11,0,Stanly,2022-11-23
5,14,1,13,0,Stanly,2022-12-07
5,12,1,11,0,Stanly,2023-02-14
5,7,1,6,0,Vance,2023-01-12
5,7,1,6,0,Vance,2023-03-16
5,12,2,10,0,Alamance,2023-03-05
5,11,2,9,0,Anson,2023-01-03
5,10,2,8,0,Bladen,2022-12-06
5,18,2,16,0,Brunswick,2022-12-04
5,39,2,37,0,Brunswick,2022-12-15
5,18,2,16,0,Burke,2023-01-25
5,24,2,22,0,Caldwell,2022-12-15
5,8,2,6,0,Caldwell,2023-04-26
5,12,2,10,0,Chatham,2023-01-28
5,9,2,7,0,Cleveland,2022-11-14
5,25,2,23,0,Cleveland,2023-01-18
5,12,2,10,0,Duplin,2022-12-05
5,17,2,15,0,Durham,2023-05-03
5,12,2,10,0,Edgecombe,2022-12-23
5,16,2,14,0,Edgecombe,2023-01-12
5,9,2,7,0,Edgecombe,2023-01-23
5,10,2,8,0,Franklin,2022-11-19
5,29,2,27,0,Gaston,2022-11-09
5,16,2,14,0,Granville,2022-12-22
5,14,2,12,0,Granville,2023-01-26
5,13,2,11,0,Guilford,2023-04-07
5,11,2,9,0,Halifax,2022-12-31
5,7,2,5,0,Halifax,2023-02-23
5,15,2,13,0,Harnett,2022-11-14
5,29,2,27,0,Harnett,2023-01-19
5,18,2,16,0,Harnett,2023-02-22
5,7,2,5,0,Hoke,2023-02-27
5,14,2,12,0,Johnston,2022-11-12
5,14,2,12,0,Johnston,2023-03-23
5,18,2,16,0,Lenoir,2023-02-03
5,12,2,10,0,McDowell,2022-12-07
5,8,2,6,0,Moore,2023-03-10
5,13,2,11,0,Nash,2023-02-17
5,13,2,11,0,New Hanover,2023-03-15
5,7,2,5,0,New Hanover,2023-05-05
5,34,2,32,0,Onslow,2023-02-14
5,11,2,9,0,Robeson,2023-03-22
5,15,2,13,0,Rockingham,2023-01-18
5,34,2,32,0,Rowan,2022-12-08
5,8,2,6,0,Rowan,2023-03-04
5,10,2,8,0,Rowan,2023-05-01
5,26,2,24,0,Stanly,2022-12-13
5,11,2,9,0,Stokes,2023-02-27
5,11,2,9,0,Union,2023-04-13
5,22,2,20,0,Vance,2022-12-26
5,20,2,18,0,Wake,2023-04-20
5,11,2,9,0,Warren,2023-01-06
5,8,3,5,0,Alexander,2023-01-17
5,13,3,10,0,Beaufort,2023-01-16
5,21,3,18,0,Bladen,2023-01-05
5,20,3,17,0,Bladen,2023-01-23
5,13,3,10,0,Bladen,2023-02-03
5,6,3,3,0,Bladen,2023-02-22
5,8,3,5,0,Brunswick,2022-11-26
5,19,3,16,0,Cleveland,2022-12-17
5,20,3,17,0,Columbus,2022-12-20
5,13,3,10,0,Columbus,2023-01-02
5,7,3,4,0,Cumberland,2023-04-01
5,15,3,12,0,Cumberland,2023-04-19
5,6,3,3,0,Davidson,2023-04-21
5,28,3,25,0,Durham,2022-12-25
5,26,3,23,0,Durham,2023-03-31
5,21,3,18,0,Edgecombe,2023-01-02
5,20,3,17,0,Edgecombe,2023-01-09
5,19,3,16,0,Franklin,2023-01-25
5,33,3,30,0,Gaston,2022-11-14
5,23,3,20,0,Gaston,2023-02-12
5,17,3,14,0,Gaston,2023-03-09
5,10,3,7,0,Gaston,2023-03-30
5,15,3,12,0,Granville,2023-01-27
5,21,3,18,0,Halifax,2022-12-22
5,21,3,18,0,Harnett,2022-12-26
5,12,3,9,0,Harnett,2023-01-29
5,20,3,17,0,Harnett,2023-01-30
5,11,3,8,0,Henderson,2023-02-22
5,10,3,7,0,Hoke,2022-12-08
5,17,3,14,0,Hoke,2022-12-12
5,11,3,8,0,Hoke,2023-01-08
5,16,3,13,0,Hoke,2023-02-10
5,6,3,3,0,Hoke,2023-02-12
5,14,3,11,0,Lenoir,2022-12-07
5,7,3,4,0,Lenoir,2023-01-16
5,17,3,14,0,McDowell,2022-12-01
5,27,3,24,0,Orange,2023-01-12
5,20,3,17,0,Pitt,2022-11-16
5,12,3,9,0,Robeson,2022-12-25
5,18,3,15,0,Rockingham,2023-02-01
5,10,3,7,0,Rockingham,2023-02-03
5,20,3,17,0,Rowan,2023-02-10
5,16,3,13,0,Rowan,2023-02-19
5,9,3,6,0,Rowan,2023-04-19
5,28,3,25,0,Stanly,2023-01-03
5,12,3,9,0,Surry,2023-03-20
5,19,3,16,0,Union,2023-03-23
5,11,3,8,0,Union,2023-04-15
5,13,3,10,0,Vance,2023-02-02
5,26,3,23,0,Yadkin,2022-12-30
5,17,3,14,0,Yadkin,2023-02-01
5,20,4,16,0,Alamance,2022-11-15
5,25,4,21,0,Alamance,2023-02-11
5,12,4,8,0,Alexander,2023-01-11
5,13,4,9,0,Bladen,2023-01-19
5,10,4,6,0,Bladen,2023-01-26
5,32,4,28,0,Burke,2022-12-15
5,12,4,8,0,Burke,2023-01-01
5,10,4,6,0,Cabarrus,2023-04-14
5,19,4,15,0,Caldwell,2023-02-01
5,14,4,10,0,Catawba,2023-01-14
5,19,4,15,0,Cleveland,2022-11-30
5,20,4,16,0,Cleveland,2023-01-20
5,19,4,15,0,Davidson,2022-11-18
5,13,4,9,0,Davie,2022-12-14
5,26,4,22,0,Davie,2022-12-29
5,29,4,25,0,Durham,2023-02-23
5,23,4,19,0,Forsyth,2022-11-26
5,21,4,17,0,Forsyth,2023-03-04
5,18,4,14,0,Granville,2023-01-18
5,7,4,3,0,Hertford,2022-12-20
5,28,4,24,0,Johnston,2022-12-03
5,19,4,15,0,Johnston,2023-02-19
5,18,4,14,0,Johnston,2023-03-01
5,21,4,17,0,Lenoir,2023-01-30
5,16,4,12,0,Lincoln,2022-12-18
5,21,4,17,0,Lincoln,2023-02-02
5,13,4,9,0,Lincoln,2023-02-10
5,10,4,6,0,Lincoln,2023-03-03
5,19,4,15,0,McDowell,2022-12-05
5,18,4,14,0,McDowell,2022-12-06
5,11,4,7,0,McDowell,2023-01-16
5,11,4,7,0,McDowell,2023-01-25
5,15,4,11,0,Moore,2023-02-03
5,25,4,21,0,Nash,2022-12-31
5,9,4,5,0,New Hanover,2023-04-24
5,26,4,22,0,Orange,2022-12-26
5,28,4,24,0,Orange,2023-01-25
5,12,4,8,0,Orange,2023-03-24
5,11,4,7,0,Pender,2023-01-23
5,9,4,5,0,Pender,2023-02-09
5,16,4,12,0,Pitt,2023-03-03
5,9,4,5,0,Randolph,2023-03-22
5,24,4,20,0,Rockingham,2022-12-26
5,16,4,12,0,Rockingham,2023-02-07
5,6,4,2,0,Rockingham,2023-04-02
5,27,4,23,0,Rowan,2022-12-14
5,14,4,10,0,Rutherford,2022-11-30
5,12,4,8,0,Stokes,2022-12-01
5,20,4,16,0,Stokes,2023-01-18
5,19,4,15,0,Surry,2022-12-02
5,12,4,8,0,Union,2023-04-18
5,20,4,16,0,Yadkin,2022-12-21
5,17,4,13,0,Yadkin,2023-02-13
5,8,5,3,0,Alexander,2023-02-02
5,18,5,13,0,Bladen,2023-01-18
5,23,5,18,0,Brunswick,2023-01-27
5,18,5,13,0,Buncombe,2023-01-22
5,15,5,10,0,Cabarrus,2023-02-05
5,18,5,13,0,Cleveland,2022-12-12
5,22,5,17,0,Cleveland,2022-12-24
5,14,5,9,0,Cleveland,2023-02-01
5,29,5,24,0,Cumberland,2022-11-18
5,14,5,9,0,Davidson,2022-11-21
5,26,5,21,0,Davidson,2023-02-10
5,18,5,13,0,Duplin,2022-12-27
5,12,5,7,0,Duplin,2023-02-03
5,20,5,15,0,Forsyth,2023-03-12
5,20,5,15,0,Forsyth,2023-03-31
5,21,5,16,0,Franklin,2022-12-22
5,19,5,14,0,Guilford,2023-04-28
5,12,5,7,0,Guilford,2023-05-05
5,17,5,12,0,Halifax,2023-01-26
5,20,5,15,0,Harnett,2023-01-20
5,9,5,4,0,Haywood,2023-03-02
5,12,5,7,0,Henderson,2022-11-23
5,15,5,10,0,Hoke,2022-12-28
5,18,5,13,0,Hoke,2023-01-11
5,21,5,16,0,Hoke,2023-01-20
5,18,5,13,0,Hoke,2023-02-02
5,15,5,10,0,Iredell,2023-01-20
5,16,5,11,0,Johnston,2022-11-18
5,38,5,33,0,Johnston,2023-02-07
5,11,5,6,0,Johnston,2023-05-01
5,20,5,15,0,Lee,2022-12-31
5,14,5,9,0,Lincoln,2022-11-25
5,17,5,12,0,Lincoln,2023-01-18
5,15,5,10,0,Moore,2022-11-09
5,24,5,19,0,Nash,2023-01-11
5,20,5,15,0,New Hanover,2023-02-03
5,37,5,32,0,Orange,2022-12-09
5,26,5,21,0,Orange,2023-01-27
5,18,5,13,0,Pender,2022-12-29
5,23,5,18,0,Pender,2023-01-04
5,16,5,11,0,Person,2023-01-04
5,13,5,8,0,Pitt,2022-11-11
5,24,5,19,0,Pitt,2022-11-22
5,14,5,9,0,Richmond,2023-01-30
5,11,5,6,0,Robeson,2023-02-12
5,22,5,17,0,Rockingham,2023-01-19
5,21,5,16,0,Rowan,2023-01-14
5,30,5,25,0,Rowan,2023-01-26
5,20,5,15,0,Rutherford,2022-12-06
5,14,5,9,0,Rutherford,2023-01-20
5,27,5,22,0,Surry,2023-02-01
5,7,5,2,0,Swain,2023-01-15
5,29,5,24,0,Union,2022-11-08
5,19,5,14,0,Union,2022-12-04
5,13,5,8,0,Union,2023-02-19
5,18,5,13,0,Watauga,2022-12-29
5,14,5,9,0,Wayne,2023-01-08
5,17,5,12,0,Wilson,2022-12-18
5,36,6,30,0,Alamance,2022-12-18
5,22,6,16,0,Alamance,2023-01-01
5,16,6,10,0,Beaufort,2022-12-19
5,39,6,33,0,Brunswick,2022-12-23
5,26,6,20,0,Buncombe,2023-03-09
5,27,6,21,0,Burke,2022-12-13
5,14,6,8,0,Carteret,2023-01-13
5,25,6,19,0,Chatham,2023-01-04
5,8,6,2,0,Chowan,2023-01-21
5,36,6,30,0,Cumberland,2022-11-08
5,25,6,19,0,Cumberland,2023-02-11
5,30,6,24,0,Davidson,2022-11-30
5,31,6,25,0,Davidson,2022-12-17
5,15,6,9,0,Davidson,2023-03-02
5,15,6,9,0,Davidson,2023-03-05
5,29,6,23,0,Davie,2023-01-02
5,16,6,10,0,Davie,2023-01-18
5,11,6,5,0,Duplin,2022-12-09
5,35,6,29,0,Gaston,2022-12-10
5,21,6,15,0,Granville,2022-11-28
5,19,6,13,0,Granville,2023-01-24
5,17,6,11,0,Hoke,2023-01-24
5,27,6,21,0,Hoke,2023-02-07
5,13,6,7,0,Moore,2023-01-25
5,12,6,6,0,Nash,2023-02-22
5,20,6,14,0,New Hanover,2023-02-08
5,9,6,3,0,New Hanover,2023-03-17
5,28,6,22,0,Pender,2022-12-28
5,17,6,11,0,Pitt,2022-11-14
5,23,6,17,0,Richmond,2023-01-05
5,16,6,10,0,Robeson,2022-12-11
5,21,6,15,0,Rowan,2022-12-18
5,11,6,5,0,Scotland,2023-01-12
5,10,6,4,0,Scotland,2023-02-08
5,26,6,20,0,Stokes,2022-12-07
5,28,6,22,0,Stokes,2022-12-21
5,16,6,10,0,Stokes,2023-01-17
5,15,6,9,0,Surry,2022-12-18
5,15,6,9,0,Surry,2023-02-24
5,23,6,17,0,Union,2023-01-28
5,30,6,24,0,Union,2023-02-17
5,24,6,18,0,Vance,2022-12-29
5,23,6,17,0,Vance,2023-01-03
5,31,6,25,0,Wake,2023-04-27
5,17,6,11,0,Wayne,2022-12-11
5,15,6,9,0,Wayne,2023-02-12
5,8,6,2,0,Wilkes,2023-02-27
5,16,6,10,0,Yadkin,2022-12-19
5,21,7,14,0,Brunswick,2023-02-07
5,24,7,17,0,Buncombe,2023-03-22
5,21,7,14,0,Cabarrus,2023-01-28
5,16,7,9,0,Caldwell,2022-12-25
5,23,7,16,0,Cumberland,2023-04-06
5,19,7,12,0,Davidson,2023-03-07
5,25,7,18,0,Durham,2023-03-22
5,24,7,17,0,Durham,2023-03-23
5,26,7,19,0,Forsyth,2022-12-04
5,23,7,16,0,Forsyth,2023-03-10
5,22,7,15,0,Guilford,2023-04-19
5,20,7,13,0,Harnett,2023-01-27
5,15,7,8,0,Henderson,2022-11-19
5,28,7,21,0,Henderson,2022-12-31
5,26,7,19,0,Hoke,2023-01-03
5,13,7,6,0,Lee,2023-02-21
5,28,7,21,0,Lenoir,2022-12-21
5,15,7,8,0,McDowell,2022-12-27
5,11,7,4,0,Montgomery,2023-01-04
5,9,7,2,0,Montgomery,2023-03-20
5,23,7,16,0,Onslow,2023-01-27
5,40,7,33,0,Orange,2022-12-12
5,39,7,32,0,Orange,2022-12-19
5,20,7,13,0,Pender,2023-01-25
5,13,7,6,0,Richmond,2022-12-09
5,17,7,10,0,Richmond,2023-01-24
5,14,7,7,0,Rutherford,2023-01-11
5,16,7,9,0,Stokes,2023-02-15
5,33,7,26,0,Surry,2022-11-29
5,15,7,8,0,Union,2023-03-06
5,19,7,12,0,Union,2023-04-17
5,23,7,16,0,Wake,2023-04-23
5,20,7,13,0,Wayne,2022-12-24
5,16,7,9,0,Yadkin,2023-01-25
5,7,7,0,0,Yancey,2023-04-11
5,31,8,23,0,Alamance,2023-01-31
5,15,8,7,0,Alexander,2023-01-03
5,22,8,14,0,Brunswick,2022-12-10
5,27,8,19,0,Burke,2022-12-31
5,22,8,14,0,Cabarrus,2023-01-01
5,30,8,22,0,Cabarrus,2023-02-16
5,12,8,4,0,Catawba,2023-03-27
5,20,8,12,0,Cleveland,2023-01-17
5,16,8,8,0,Columbus,2022-12-12
5,39,8,31,0,Cumberland,2022-11-26
5,28,8,20,0,Cumberland,2023-03-22
5,25,8,17,0,Davie,2022-12-21
5,24,8,16,0,Franklin,2022-12-12
5,9,8,1,0,Graham,2023-01-03
5,18,8,10,0,Granville,2023-01-23
5,44,8,36,0,Guilford,2023-02-11
5,23,8,15,0,Guilford,2023-04-05
5,33,8,25,0,Henderson,2022-12-14
5,16,8,8,0,Henderson,2023-02-03
5,13,8,5,0,Jackson,2023-01-09
5,26,8,18,0,Lincoln,2022-12-21
5,13,8,5,0,Lincoln,2023-01-22
5,16,8,8,0,Randolph,2023-02-15
5,13,8,5,0,Robeson,2022-12-03
5,16,8,8,0,Rockingham,2023-01-12
5,35,8,27,0,Rowan,2022-12-07
5,29,8,21,0,Rowan,2023-02-07
5,9,8,1,0,Scotland,2023-01-21
5,8,8,0,0,Scotland,2023-03-08
5,17,8,9,0,Stokes,2023-02-09
5,26,8,18,0,Surry,2023-01-16
5,24,9,15,0,Burke,2022-12-24
5,21,9,12,0,Burke,2023-01-11
5,21,9,12,0,Catawba,2022-11-09
5,13,9,4,0,Catawba,2022-11-17
5,14,9,5,0,Clay,2022-12-29
5,26,9,17,0,Cumberland,2022-11-17
5,23,9,14,0,Davidson,2023-01-08
5,33,9,24,0,Forsyth,2022-11-27
5,46,9,37,0,Forsyth,2023-02-23
5,20,9,11,0,Franklin,2023-02-01
5,32,9,23,0,Granville,2022-12-27
5,18,9,9,0,Granville,2023-01-01
5,41,9,32,0,Guilford,2022-12-03
5,14,9,5,0,Halifax,2022-12-02
5,31,9,22,0,Halifax,2023-01-05
5,25,9,16,0,Harnett,2023-01-01
5,23,9,14,0,Henderson,2023-02-01
5,14,9,5,0,Hertford,2023-01-03
5,17,9,8,0,Iredell,2023-01-21
5,29,9,20,0,Johnston,2023-02-15
5,27,9,18,0,Lenoir,2022-12-15
5,22,9,13,0,Lincoln,2023-01-24
5,19,9,10,0,McDowell,2022-12-19
5,18,9,9,0,Montgomery,2023-01-02
5,25,9,16,0,Nash,2022-12-22
5,22,9,13,0,Nash,2022-12-24
5,37,9,28,0,Nash,2023-01-03
5,16,9,7,0,Pasquotank,2022-12-30
5,22,9,13,0,Robeson,2023-02-16
5,19,9,10,0,Robeson,2023-02-23
5,15,9,6,0,Sampson,2023-02-10
5,14,9,5,0,Scotland,2022-12-28
5,14,9,5,0,Stokes,2023-02-17
5,37,9,28,0,Union,2022-11-23
5,23,9,14,0,Wayne,2022-12-17
5,15,9,6,0,Wilkes,2023-02-02
5,15,9,6,0,Wilkes,2023-02-20
5,16,9,7,0,Wilson,2022-11-28
5,22,9,13,0,Wilson,2023-01-06
5,16,10,6,0,Buncombe,2023-04-19
5,18,10,8,0,Carteret,2022-12-20
5,19,10,9,0,Catawba,2023-01-08
5,22,10,12,0,Catawba,2023-02-21
5,17,10,7,0,Catawba,2023-03-02
5,45,10,35,0,Cleveland,2022-12-28
5,30,10,20,0,Davie,2022-12-19
5,30,10,20,0,Davie,2022-12-26
5,16,10,6,0,Duplin,2022-12-12
5,39,10,29,0,Forsyth,2023-01-08
5,21,10,11,0,Forsyth,2023-04-18
5,25,10,15,0,Forsyth,2023-05-02
5,23,10,13,0,Granville,2023-01-20
5,21,10,11,0,Halifax,2022-12-14
5,14,10,4,0,Iredell,2023-04-10
5,38,10,28,0,Johnston,2023-02-21
5,21,10,11,0,Lee,2022-12-12
5,27,10,17,0,Moore,2022-12-17
5,21,10,11,0,Moore,2023-01-05
5,20,10,10,0,Nash,2022-12-26
5,22,10,12,0,Randolph,2023-02-07
5,29,10,19,0,Rowan,2023-01-12
5,19,10,9,0,Rutherford,2023-01-24
5,23,10,13,0,Sampson,2023-01-03
5,12,10,2,0,Swain,2023-01-17
5,15,10,5,0,Wayne,2023-03-21
5,20,10,10,0,Wilkes,2022-12-07
5,20,10,10,0,Wilson,2023-01-05
5,19,11,8,0,Catawba,2022-11-23
5,21,11,10,0,Catawba,2022-12-11
5,20,11,9,0,Catawba,2023-01-20
5,20,11,9,0,Gaston,2023-03-07
5,19,11,8,0,Haywood,2023-01-03
5,24,11,13,0,Henderson,2022-12-25
5,27,11,16,0,Iredell,2022-11-09
5,19,11,8,0,Iredell,2023-02-28
5,15,11,4,0,Lincoln,2023-02-25
5,30,11,19,0,Nash,2022-12-15
5,27,11,16,0,New Hanover,2022-12-16
5,17,11,6,0,Wilson,2023-01-30
5,31,12,19,0,Cabarrus,2022-12-11
5,19,12,7,0,Craven,2022-12-13
5,27,12,15,0,Forsyth,2023-03-24
5,35,12,23,0,Gaston,2022-12-04
5,21,12,9,0,Henderson,2023-01-21
5,27,12,15,0,Iredell,2022-12-24
5,24,12,12,0,Iredell,2023-01-25
5,27,12,15,0,Nash,2023-02-01
5,26,12,14,0,New Hanover,2023-01-15
5,15,12,3,0,Pasquotank,2022-12-23
5,12,12,0,0,Person,2023-03-09
5,26,12,14,0,Richmond,2023-01-23
5,17,12,5,0,Sampson,2023-01-12
5,25,12,13,0,Wayne,2023-01-15
5,23,12,11,0,Wilkes,2022-12-15
5,22,12,10,0,Wilson,2023-02-14
5,17,12,5,0,Yadkin,2023-02-09
5,17,13,4,0,Cherokee,2023-02-13
5,49,13,36,0,Cumberland,2022-12-11
5,17,13,4,0,Haywood,2023-01-23
5,21,13,8,0,Henderson,2023-01-26
5,28,13,15,0,New Hanover,2023-01-20
5,40,13,27,0,New Hanover,2023-01-27
5,20,13,7,0,Randolph,2023-01-23
5,34,13,21,0,Surry,2023-01-09
5,18,13,5,0,Watauga,2023-01-20
5,19,13,6,0,Wayne,2022-11-15
5,22,13,9,0,Wilkes,2023-01-11
5,31,14,17,0,Brunswick,2023-01-20
5,26,14,12,0,Catawba,2023-02-16
5,23,14,9,0,Craven,2022-12-17
5,14,14,0,0,Gates,2023-01-25
5,49,14,35,0,Guilford,2022-11-16
5,17,14,3,0,Moore,2023-01-19
5,25,14,11,0,Wayne,2023-02-06
5,19,15,4,0,Iredell,2023-04-03
5,20,15,5,0,Robeson,2023-02-03
5,43,15,28,0,Rutherford,2022-12-29
5,18,15,3,0,Scotland,2022-12-20
5,41,16,25,0,Buncombe,2023-01-24
5,20,16,4,0,Iredell,2023-03-01
5,27,16,11,0,Moore,2022-12-14
5,22,16,6,0,Sampson,2022-12-21
5,28,16,12,0,Wilson,2022-12-27
5,39,17,22,0,Buncombe,2022-11-08
5,36,17,19,0,Cabarrus,2022-12-24
5,30,17,13,0,Moore,2022-12-27
5,27,17,10,0,Randolph,2023-02-08
5,22,17,5,0,Randolph,2023-02-12
5,33,18,15,0,Catawba,2022-12-01
5,50,18,32,0,Durham,2023-02-27
5,32,18,14,0,Gaston,2023-02-21
5,39,18,21,0,Iredell,2023-01-23
5,34,18,16,0,New Hanover,2022-12-18
5,25,18,7,0,Wilkes,2022-12-09
5,42,19,23,0,Catawba,2022-12-31
5,23,19,4,0,Hoke,2023-02-04
5,24,19,5,0,Scotland,2023-01-05
5,30,21,9,0,Catawba,2023-02-09
5,38,21,17,0,Wayne,2022-12-26
5,44,22,22,0,Buncombe,2022-12-16
5,40,22,18,0,Iredell,2023-01-19
5,34,26,8,0,Sampson,2022-12-28
5,43,26,17,0,Wayne,2022-12-05
5,34,28,6,0,Sampson,2023-01-31
5,73,38,35,0,New Hanover,2022-12-26
6,10,0,10,0,Brunswick,2023-02-05
6,14,0,14,0,Person,2023-01-03
6,8,1,7,0,Beaufort,2022-12-18
6,17,1,16,0,Caldwell,2023-01-19
6,16,1,15,0,Cleveland,2023-02-21
6,29,1,28,0,Durham,2023-03-27
6,12,1,11,0,Edgecombe,2022-11-28
6,19,1,18,0,Franklin,2023-01-12
6,28,1,27,0,Gaston,2022-11-27
6,11,1,10,0,Gaston,2023-03-15
6,13,1,12,0,Lee,2023-01-26
6,20,1,19,0,Orange,2023-02-28
6,15,1,14,0,Stanly,2023-01-18
6,13,1,12,0,Stanly,2023-02-07
6,14,1,13,0,Surry,2022-11-14
6,14,1,13,0,Union,2023-04-03
6,10,1,9,0,Yadkin,2023-01-18
6,9,2,7,0,Beaufort,2023-02-07
6,12,2,10,0,Brunswick,2023-03-20
6,24,2,22,0,Cabarrus,2023-02-17
6,18,2,16,0,Caldwell,2023-02-13
6,12,2,10,0,Caldwell,2023-02-15
6,21,2,19,0,Caldwell,2023-02-22
6,9,2,7,0,Chatham,2022-11-15
6,19,2,17,0,Cleveland,2023-01-31
6,16,2,14,0,Cleveland,2023-02-03
6,10,2,8,0,Davidson,2023-04-20
6,13,2,11,0,Davie,2023-02-07
6,51,2,49,0,Durham,2022-11-09
6,44,2,42,0,Durham,2022-12-10
6,20,2,18,0,Edgecombe,2022-12-13
6,21,2,19,0,Edgecombe,2022-12-26
6,21,2,19,0,Gaston,2022-11-21
6,29,2,27,0,Harnett,2023-01-31
6,19,2,17,0,Johnston,2022-12-04
6,13,2,11,0,Lenoir,2023-02-06
6,16,2,14,0,Lincoln,2022-11-29
6,19,2,17,0,Nash,2023-02-08
6,35,2,33,0,Onslow,2023-01-20
6,26,2,24,0,Rowan,2023-02-14
6,22,2,20,0,Stanly,2023-01-23
6,18,2,16,0,Surry,2023-01-27
6,29,3,26,0,Alamance,2023-01-18
6,32,3,29,0,Alamance,2023-02-22
6,22,3,19,0,Alamance,2023-02-28
6,11,3,8,0,Beaufort,2023-01-10
6,10,3,7,0,Bladen,2023-01-22
6,13,3,10,0,Cabarrus,2023-03-17
6,12,3,9,0,Caldwell,2022-11-14
6,18,3,15,0,Caldwell,2023-02-14
6,12,3,9,0,Catawba,2023-01-29
6,16,3,13,0,Cleveland,2023-01-24
6,21,3,18,0,Cumberland,2023-03-13
6,15,3,12,0,Davidson,2023-02-18
6,25,3,22,0,Davidson,2023-02-22
6,15,3,12,0,Davie,2023-01-16
6,41,3,38,0,Durham,2022-11-17
6,50,3,47,0,Durham,2022-12-11
6,17,3,14,0,Forsyth,2023-05-04
6,20,3,17,0,Franklin,2023-01-31
6,13,3,10,0,Gaston,2023-02-25
6,14,3,11,0,Gaston,2023-03-25
6,17,3,14,0,Hoke,2023-01-17
6,24,3,21,0,Johnston,2022-11-26
6,13,3,10,0,Johnston,2023-03-24
6,21,3,18,0,Lee,2023-01-03
6,21,3,18,0,Lenoir,2023-01-05
6,18,3,15,0,Lenoir,2023-01-25
6,20,3,17,0,Lenoir,2023-02-01
6,17,3,14,0,Lenoir,2023-02-07
6,29,3,26,0,Lincoln,2022-12-19
6,22,3,19,0,Lincoln,2023-02-07
6,18,3,15,0,Nash,2023-02-14
6,31,3,28,0,Orange,2023-01-18
6,28,3,25,0,Orange,2023-01-30
6,21,3,18,0,Rowan,2023-02-21
6,14,3,11,0,Rowan,2023-03-08
6,19,3,16,0,Union,2023-02-05
6,11,3,8,0,Union,2023-03-28
6,17,3,14,0,Vance,2022-12-22
6,28,3,25,0,Vance,2023-01-04
6,19,3,16,0,Vance,2023-02-01
6,18,4,14,0,Bladen,2023-01-04
6,20,4,16,0,Brunswick,2023-01-31
6,10,4,6,0,Burke,2023-02-03
6,17,4,13,0,Caldwell,2022-11-23
6,19,4,15,0,Cleveland,2023-01-16
6,32,4,28,0,Cumberland,2022-11-15
6,36,4,32,0,Cumberland,2022-11-27
6,18,4,14,0,Davidson,2023-01-14
6,12,4,8,0,Davie,2022-12-06
6,41,4,37,0,Durham,2022-11-27
6,26,4,22,0,Durham,2023-03-07
6,20,4,16,0,Edgecombe,2022-12-28
6,25,4,21,0,Gaston,2023-01-29
6,21,4,17,0,Gaston,2023-02-26
6,18,4,14,0,Granville,2022-12-14
6,27,4,23,0,Granville,2022-12-19
6,17,4,13,0,Halifax,2023-01-25
6,16,4,12,0,Henderson,2022-11-16
6,23,4,19,0,Hoke,2022-12-19
6,10,4,6,0,Iredell,2023-03-22
6,29,4,25,0,Johnston,2023-01-21
6,28,4,24,0,Johnston,2023-02-20
6,15,4,11,0,Lincoln,2023-02-05
6,27,4,23,0,Mecklenburg,2023-04-15
6,40,4,36,0,Onslow,2022-11-28
6,24,4,20,0,Onslow,2022-12-17
6,42,4,38,0,Orange,2023-01-02
6,16,4,12,0,Richmond,2023-01-11
6,16,4,12,0,Rockingham,2023-02-14
6,26,4,22,0,Rowan,2022-11-16
6,14,4,10,0,Rutherford,2023-01-01
6,17,4,13,0,Stokes,2023-01-12
6,23,4,19,0,Surry,2022-12-07
6,24,4,20,0,Wake,2023-04-13
6,16,5,11,0,Cabarrus,2022-11-18
6,18,5,13,0,Caldwell,2023-02-09
6,16,5,11,0,Columbus,2023-01-19
6,11,5,6,0,Davidson,2023-03-09
6,22,5,17,0,Durham,2023-03-18
6,39,5,34,0,Forsyth,2022-11-15
6,17,5,12,0,Forsyth,2023-03-26
6,24,5,19,0,Gaston,2023-01-22
6,28,5,23,0,Gaston,2023-02-04
6,28,5,23,0,Gaston,2023-02-23
6,15,5,10,0,Halifax,2022-11-14
6,30,5,25,0,Harnett,2022-11-30
6,28,5,23,0,Harnett,2022-12-08
6,20,5,15,0,Henderson,2023-01-13
6,18,5,13,0,Henderson,2023-01-19
6,7,5,2,0,Henderson,2023-04-28
6,44,5,39,0,Johnston,2022-12-31
6,17,5,12,0,Moore,2023-02-16
6,17,5,12,0,Nash,2023-02-09
6,13,5,8,0,New Hanover,2023-03-21
6,26,5,21,0,Orange,2022-12-21
6,51,5,46,0,Orange,2022-12-22
6,9,5,4,0,Richmond,2022-11-30
6,10,5,5,0,Robeson,2023-04-03
6,20,5,15,0,Rutherford,2022-12-13
6,20,5,15,0,Stokes,2022-12-14
6,22,5,17,0,Stokes,2022-12-16
6,27,5,22,0,Surry,2023-01-20
6,19,5,14,0,Surry,2023-02-15
6,23,5,18,0,Union,2022-11-16
6,32,5,27,0,Union,2023-01-22
6,14,5,9,0,Vance,2023-01-28
6,28,5,23,0,Wake,2023-04-08
6,12,5,7,0,Wilkes,2023-05-01
6,14,5,9,0,Yadkin,2023-02-06
6,17,6,11,0,Beaufort,2023-01-17
6,17,6,11,0,Brunswick,2023-01-08
6,24,6,18,0,Caldwell,2023-01-08
6,17,6,11,0,Chatham,2022-11-08
6,18,6,12,0,Chatham,2022-12-15
6,20,6,14,0,Craven,2023-01-12
6,37,6,31,0,Durham,2022-11-14
6,24,6,18,0,Forsyth,2023-04-04
6,17,6,11,0,Gaston,2023-03-10
6,16,6,10,0,Granville,2023-01-31
6,28,6,22,0,Guilford,2023-02-26
6,22,6,16,0,Guilford,2023-04-17
6,30,6,24,0,Harnett,2022-11-28
6,15,6,9,0,Henderson,2023-02-14
6,11,6,5,0,Iredell,2023-04-04
6,15,6,9,0,Lee,2022-12-14
6,20,6,14,0,Lenoir,2022-12-22
6,23,6,17,0,Lincoln,2022-12-14
6,12,6,6,0,Lincoln,2023-02-04
6,30,6,24,0,Mecklenburg,2023-05-05
6,19,6,13,0,Northampton,2023-01-04
6,29,6,23,0,Orange,2023-01-06
6,11,6,5,0,Robeson,2023-02-24
6,21,6,15,0,Rockingham,2022-11-28
6,23,6,17,0,Rutherford,2023-01-05
6,21,6,15,0,Surry,2022-11-30
6,21,6,15,0,Union,2023-03-13
6,20,6,14,0,Vance,2023-02-07
6,43,6,37,0,Wake,2023-04-05
6,20,6,14,0,Wayne,2023-03-01
6,33,7,26,0,Alamance,2023-02-21
6,38,7,31,0,Cabarrus,2023-02-20
6,21,7,14,0,Cleveland,2023-01-09
6,23,7,16,0,Cleveland,2023-01-25
6,26,7,19,0,Davidson,2023-01-24
6,30,7,23,0,Durham,2023-03-08
6,25,7,18,0,Forsyth,2023-02-26
6,18,7,11,0,Guilford,2023-03-22
6,13,7,6,0,Guilford,2023-04-23
6,19,7,12,0,Halifax,2022-12-21
6,16,7,9,0,Henderson,2023-04-21
6,24,7,17,0,Iredell,2023-02-21
6,40,7,33,0,Johnston,2022-12-17
6,21,7,14,0,Lenoir,2023-01-31
6,27,7,20,0,Lincoln,2022-12-09
6,13,7,6,0,Lincoln,2023-03-01
6,21,7,14,0,New Hanover,2023-02-17
6,58,7,51,0,Orange,2023-01-04
6,14,7,7,0,Pitt,2023-03-13
6,15,7,8,0,Randolph,2022-12-04
6,16,7,9,0,Randolph,2023-02-03
6,12,7,5,0,Randolph,2023-03-01
6,18,7,11,0,Robeson,2023-01-15
6,36,7,29,0,Union,2023-01-07
6,23,7,16,0,Union,2023-02-27
6,14,7,7,0,Union,2023-03-30
6,25,7,18,0,Vance,2022-12-20
6,39,7,32,0,Wake,2023-04-21
6,17,7,10,0,Wayne,2023-02-03
6,19,7,12,0,Wilson,2023-02-22
6,17,8,9,0,Alexander,2023-01-05
6,10,8,2,0,Ashe,2023-01-13
6,34,8,26,0,Burke,2022-12-12
6,35,8,27,0,Burke,2022-12-16
6,25,8,17,0,Cabarrus,2022-11-23
6,30,8,22,0,Cabarrus,2022-12-17
6,29,8,21,0,Caldwell,2023-02-10
6,24,8,16,0,Columbus,2022-12-27
6,14,8,6,0,Columbus,2023-01-17
6,37,8,29,0,Cumberland,2022-11-14
6,19,8,11,0,Duplin,2023-02-13
6,22,8,14,0,Gaston,2023-03-27
6,27,8,19,0,Harnett,2023-01-24
6,15,8,7,0,Harnett,2023-02-02
6,21,8,13,0,Henderson,2023-01-20
6,21,8,13,0,Henderson,2023-02-02
6,23,8,15,0,Henderson,2023-02-16
6,36,8,28,0,Lenoir,2023-01-04
6,33,8,25,0,Onslow,2023-01-02
6,24,8,16,0,Orange,2023-02-10
6,16,8,8,0,Pitt,2023-03-15
6,17,8,9,0,Randolph,2022-12-03
6,18,8,10,0,Richmond,2022-12-21
6,16,8,8,0,Robeson,2023-03-02
6,41,8,33,0,Surry,2022-12-29
6,54,8,46,0,Union,2022-12-08
6,28,8,20,0,Wilson,2023-02-02
6,20,8,12,0,Yadkin,2022-12-14
6,19,8,11,0,Yadkin,2023-01-17
6,17,9,8,0,Catawba,2022-11-10
6,11,9,2,0,Cherokee,2023-02-09
6,21,9,12,0,Cleveland,2022-11-29
6,9,9,0,0,Currituck,2023-03-18
6,19,9,10,0,Duplin,2022-12-29
6,18,9,9,0,Duplin,2023-01-19
6,58,9,49,0,Forsyth,2023-01-07
6,31,9,22,0,Forsyth,2023-02-11
6,26,9,17,0,Forsyth,2023-03-30
6,34,9,25,0,Gaston,2023-01-16
6,34,9,25,0,Granville,2023-01-11
6,17,9,8,0,Halifax,2022-12-16
6,23,9,14,0,Henderson,2023-01-15
6,21,9,12,0,Henderson,2023-02-15
6,22,9,13,0,New Hanover,2023-01-14
6,41,9,32,0,Orange,2022-12-30
6,25,9,16,0,Pitt,2023-03-02
6,19,9,10,0,Rutherford,2023-01-25
6,20,9,11,0,Sampson,2022-12-13
6,20,9,11,0,Wayne,2023-02-20
6,20,10,10,0,Cabarrus,2023-02-12
6,17,10,7,0,Catawba,2023-03-08
6,23,10,13,0,Chatham,2022-12-05
6,40,10,30,0,Chatham,2023-01-03
6,23,10,13,0,Cumberland,2023-03-23
6,19,10,9,0,Davie,2022-12-22
6,35,10,25,0,Forsyth,2023-02-05
6,17,10,7,0,Halifax,2022-12-19
6,14,10,4,0,Scotland,2022-12-23
6,22,10,12,0,Stokes,2022-12-31
6,17,10,7,0,Wilkes,2023-02-08
6,16,10,6,0,Wilson,2023-01-27
6,48,11,37,0,Cabarrus,2023-01-20
6,14,11,3,0,Chowan,2023-01-22
6,40,11,29,0,Cumberland,2023-02-23
6,27,11,16,0,Gaston,2023-01-28
6,29,11,18,0,Guilford,2023-04-04
6,20,11,9,0,Halifax,2022-12-13
6,37,11,26,0,Harnett,2022-12-05
6,28,11,17,0,Henderson,2022-12-13
6,24,11,13,0,Iredell,2022-12-04
6,25,11,14,0,Iredell,2023-01-27
6,21,11,10,0,Iredell,2023-03-02
6,30,11,19,0,Johnston,2022-12-01
6,28,11,17,0,Johnston,2022-12-10
6,32,11,21,0,New Hanover,2022-12-24
6,31,11,20,0,Stokes,2022-12-30
6,27,11,16,0,Vance,2023-01-06
6,19,11,8,0,Wilson,2023-01-20
6,17,11,6,0,Wilson,2023-02-09
6,27,11,16,0,Yadkin,2023-01-03
6,19,12,7,0,Bladen,2022-12-12
6,44,12,32,0,Caldwell,2023-01-09
6,15,12,3,0,Clay,2023-01-20
6,30,12,18,0,Cumberland,2023-03-06
6,36,12,24,0,Forsyth,2023-03-15
6,31,12,19,0,Guilford,2023-03-03
6,25,12,13,0,Halifax,2023-02-07
6,27,12,15,0,Henderson,2023-02-06
6,14,12,2,0,Jackson,2023-04-17
6,42,12,30,0,Lincoln,2023-01-04
6,30,12,18,0,Pitt,2023-02-28
6,21,12,9,0,Randolph,2022-12-01
6,33,12,21,0,Rowan,2023-02-13
6,18,12,6,0,Wilkes,2022-12-22
6,48,13,35,0,Alamance,2022-12-31
6,67,13,54,0,Brunswick,2022-12-29
6,33,13,20,0,Cumberland,2023-03-20
6,27,13,14,0,Guilford,2023-04-11
6,35,13,22,0,Harnett,2023-01-05
6,19,13,6,0,Hertford,2022-12-19
6,32,13,19,0,New Hanover,2022-12-01
6,40,13,27,0,Pitt,2022-11-29
6,35,13,22,0,Randolph,2022-12-31
6,24,13,11,0,Sampson,2022-12-29
6,28,13,15,0,Wayne,2023-01-01
6,26,13,13,0,Wilkes,2023-01-02
6,19,13,6,0,Wilson,2023-01-23
6,32,14,18,0,Buncombe,2022-12-02
6,28,14,14,0,Carteret,2023-01-03
6,23,14,9,0,Cumberland,2023-02-19
6,30,14,16,0,Henderson,2022-12-12
6,33,14,19,0,Iredell,2023-02-03
6,43,14,29,0,New Hanover,2022-12-13
6,27,14,13,0,Wayne,2023-02-07
6,15,14,1,0,Wilkes,2022-12-17
6,29,14,15,0,Wilkes,2022-12-27
6,27,15,12,0,Anson,2022-12-28
6,27,15,12,0,Catawba,2022-12-17
6,26,15,11,0,Duplin,2023-01-27
6,19,15,4,0,Gaston,2023-03-21
6,23,15,8,0,Henderson,2022-11-17
6,30,15,15,0,Moore,2022-12-16
6,22,15,7,0,Nash,2023-01-27
6,19,15,4,0,Nash,2023-02-27
6,29,15,14,0,Randolph,2022-12-10
6,19,15,4,0,Sampson,2023-02-13
6,19,15,4,0,Sampson,2023-02-15
6,29,15,14,0,Wayne,2023-01-27
6,34,15,19,0,Wilson,2023-01-04
6,35,16,19,0,Craven,2022-12-21
6,43,16,27,0,Cumberland,2023-01-28
6,35,16,19,0,Duplin,2023-01-04
6,37,16,21,0,Guilford,2023-03-17
6,43,16,27,0,Henderson,2022-12-19
6,23,16,7,0,Wayne,2022-12-02
6,24,16,8,0,Wilson,2023-01-26
6,32,17,15,0,Henderson,2023-01-01
6,36,17,19,0,Iredell,2023-01-01
6,20,17,3,0,Scotland,2022-12-30
6,33,18,15,0,Iredell,2023-02-02
6,25,19,6,0,Robeson,2022-12-01
6,44,19,25,0,Surry,2022-12-14
6,41,20,21,0,Cabarrus,2022-11-22
6,52,21,31,0,Alamance,2022-12-23
6,29,21,8,0,Buncombe,2022-12-18
6,28,21,7,0,Catawba,2023-02-15
6,41,21,20,0,Henderson,2023-01-05
6,49,21,28,0,Johnston,2022-12-15
6,38,22,16,0,Carteret,2022-12-28
6,42,22,20,0,Gaston,2023-01-27
6,35,22,13,0,Sampson,2022-12-27
6,55,24,31,0,Buncombe,2022-12-14
6,55,24,31,0,Buncombe,2022-12-15
6,45,24,21,0,Burke,2022-12-20
7,12,0,12,0,Franklin,2023-03-07
7,22,0,22,0,Onslow,2023-03-23
7,22,0,22,0,Stanly,2022-12-20
7,20,0,20,0,Stanly,2023-01-05
7,11,1,10,0,Caswell,2023-01-05
7,31,1,30,0,Durham,2023-02-12
7,13,1,12,0,Franklin,2023-02-08
7,15,1,14,0,Johnston,2022-11-21
7,29,1,28,0,Orange,2022-12-16
7,17,1,16,0,Stanly,2022-12-09
7,26,1,25,0,Stanly,2023-01-04
7,14,1,13,0,Union,2023-03-29
7,22,2,20,0,Caldwell,2023-02-20
7,29,2,27,0,Chatham,2022-12-22
7,23,2,21,0,Durham,2023-03-13
7,30,2,28,0,Durham,2023-03-20
7,10,2,8,0,Franklin,2023-02-18
7,16,2,14,0,Guilford,2023-05-03
7,15,2,13,0,Halifax,2023-02-13
7,23,2,21,0,Hoke,2022-12-31
7,21,2,19,0,Lincoln,2023-02-03
7,26,2,24,0,Onslow,2022-12-08
7,32,2,30,0,Orange,2023-01-24
7,18,2,16,0,Rockingham,2023-02-21
7,17,2,15,0,Stanly,2023-01-09
7,24,3,21,0,Alamance,2022-11-17
7,35,3,32,0,Alamance,2022-12-11
7,15,3,12,0,Beaufort,2022-12-28
7,20,3,17,0,Bladen,2022-12-27
7,16,3,13,0,Caldwell,2023-02-28
7,10,3,7,0,Cumberland,2023-05-01
7,21,3,18,0,Durham,2023-04-10
7,24,3,21,0,Harnett,2022-12-06
7,33,3,30,0,Hoke,2023-02-06
7,12,3,9,0,Lenoir,2023-01-27
7,13,3,10,0,McDowell,2022-11-29
7,45,3,42,0,Onslow,2023-01-18
7,26,3,23,0,Onslow,2023-02-03
7,26,3,23,0,Rowan,2022-12-06
7,16,3,13,0,Rowan,2023-02-15
7,21,3,18,0,Rowan,2023-02-20
7,26,3,23,0,Stanly,2023-01-19
7,29,4,25,0,Alamance,2022-11-10
7,33,4,29,0,Alamance,2022-12-09
7,44,4,40,0,Alamance,2023-01-20
7,25,4,21,0,Alamance,2023-02-15
7,26,4,22,0,Bladen,2022-12-19
7,18,4,14,0,Bladen,2022-12-29
7,37,4,33,0,Cabarrus,2023-01-27
7,19,4,15,0,Caldwell,2022-12-02
7,26,4,22,0,Caldwell,2023-01-20
7,28,4,24,0,Cumberland,2023-02-27
7,26,4,22,0,Cumberland,2023-03-14
7,10,4,6,0,Cumberland,2023-03-25
7,31,4,27,0,Davidson,2022-12-05
7,37,4,33,0,Durham,2022-11-26
7,44,4,40,0,Durham,2023-02-16
7,21,4,17,0,Gaston,2023-02-18
7,13,4,9,0,Granville,2023-01-19
7,11,4,7,0,Henderson,2023-04-14
7,27,4,23,0,Johnston,2023-02-28
7,38,4,34,0,Onslow,2022-12-26
7,25,4,21,0,Orange,2022-12-07
7,21,4,17,0,Rutherford,2022-12-14
7,30,4,26,0,Union,2022-12-10
7,28,4,24,0,Union,2023-01-21
7,29,4,25,0,Yadkin,2022-12-29
7,41,5,36,0,Burke,2022-12-22
7,37,5,32,0,Cabarrus,2022-12-09
7,32,5,27,0,Caldwell,2022-12-16
7,21,5,16,0,Caldwell,2023-01-25
7,31,5,26,0,Cleveland,2022-12-23
7,50,5,45,0,Durham,2022-11-22
7,35,5,30,0,Forsyth,2023-04-06
7,20,5,15,0,Forsyth,2023-04-20
7,17,5,12,0,Franklin,2022-12-26
7,21,5,16,0,Gaston,2023-03-03
7,21,5,16,0,Lenoir,2023-01-23
7,25,5,20,0,Lincoln,2023-01-06
7,23,5,18,0,Lincoln,2023-01-20
7,36,5,31,0,Onslow,2022-12-14
7,40,5,35,0,Orange,2022-12-23
7,17,5,12,0,Richmond,2022-12-27
7,21,5,16,0,Rockingham,2023-02-16
7,16,5,11,0,Rowan,2023-01-15
7,25,5,20,0,Stanly,2023-01-12
7,30,5,25,0,Wake,2023-04-15
7,25,5,20,0,Wake,2023-04-22
7,40,5,35,0,Wake,2023-04-25
7,21,5,16,0,Yadkin,2022-12-20
7,40,6,34,0,Cabarrus,2022-11-09
7,23,6,17,0,Columbus,2022-12-30
7,34,6,28,0,Davie,2022-12-28
7,20,6,14,0,Davie,2023-01-05
7,41,6,35,0,Gaston,2023-01-01
7,20,6,14,0,Guilford,2023-04-27
7,17,6,11,0,Halifax,2023-01-23
7,14,6,8,0,Halifax,2023-02-02
7,33,6,27,0,Harnett,2022-12-12
7,29,6,23,0,Harnett,2023-01-25
7,29,6,23,0,Henderson,2022-11-28
7,16,6,10,0,Johnston,2023-02-11
7,21,6,15,0,Johnston,2023-03-06
7,29,6,23,0,Lenoir,2022-12-28
7,32,6,26,0,Lenoir,2022-12-29
7,36,6,30,0,Mecklenburg,2023-04-12
7,34,6,28,0,Nash,2022-12-28
7,22,6,16,0,New Hanover,2022-12-09
7,39,6,33,0,Rockingham,2023-01-03
7,20,6,14,0,Rowan,2023-02-16
7,29,6,23,0,Rutherford,2022-12-21
7,19,6,13,0,Stokes,2022-12-13
7,26,6,20,0,Surry,2023-01-25
7,46,7,39,0,Alamance,2023-01-16
7,15,7,8,0,Brunswick,2022-11-25
7,26,7,19,0,Burke,2023-01-12
7,24,7,17,0,Cabarrus,2023-02-04
7,22,7,15,0,Columbus,2022-12-21
7,45,7,38,0,Durham,2023-02-14
7,25,7,18,0,Forsyth,2023-04-24
7,37,7,30,0,Gaston,2022-12-01
7,29,7,22,0,Guilford,2023-04-25
7,22,7,15,0,Guilford,2023-05-02
7,22,7,15,0,Harnett,2022-12-23
7,36,7,29,0,Johnston,2023-01-25
7,31,7,24,0,Johnston,2023-01-26
7,23,7,16,0,Lee,2022-12-29
7,26,7,19,0,Lincoln,2023-02-13
7,40,7,33,0,Mecklenburg,2023-05-04
7,17,7,10,0,Nash,2022-12-14
7,11,7,4,0,Randolph,2023-02-11
7,13,7,6,0,Robeson,2023-02-05
7,25,7,18,0,Rockingham,2023-01-11
7,33,7,26,0,Rowan,2023-01-10
7,27,7,20,0,Surry,2023-01-04
7,28,7,21,0,Surry,2023-01-23
7,29,7,22,0,Surry,2023-01-26
7,36,7,29,0,Wake,2023-03-11
7,39,8,31,0,Alamance,2022-12-17
7,15,8,7,0,Anson,2022-12-26
7,16,8,8,0,Bladen,2022-12-15
7,41,8,33,0,Brunswick,2022-12-21
7,30,8,22,0,Brunswick,2023-02-01
7,30,8,22,0,Buncombe,2023-02-08
7,35,8,27,0,Cabarrus,2023-02-10
7,22,8,14,0,Cumberland,2023-03-31
7,19,8,11,0,Duplin,2023-01-25
7,33,8,25,0,Forsyth,2023-03-03
7,20,8,12,0,Halifax,2023-01-27
7,16,8,8,0,Iredell,2022-12-03
7,28,8,20,0,Iredell,2023-02-14
7,17,8,9,0,Jackson,2023-02-07
7,31,8,23,0,McDowell,2022-12-29
7,36,8,28,0,Mecklenburg,2023-04-08
7,32,8,24,0,Moore,2022-12-13
7,20,8,12,0,Moore,2023-01-26
7,35,8,27,0,Onslow,2022-12-19
7,39,8,31,0,Pitt,2023-01-18
7,38,8,30,0,Rockingham,2022-12-21
7,16,8,8,0,Sampson,2023-01-06
7,31,8,23,0,Surry,2022-12-09
7,34,8,26,0,Vance,2022-12-28
7,17,8,9,0,Wilson,2023-02-16
7,28,9,19,0,Alamance,2023-02-05
7,37,9,28,0,Chatham,2022-12-27
7,26,9,17,0,Cleveland,2022-12-05
7,20,9,11,0,Franklin,2023-01-05
7,17,9,8,0,Gaston,2023-04-05
7,28,9,19,0,Granville,2022-12-29
7,19,9,10,0,Granville,2023-01-16
7,59,9,50,0,Guilford,2022-11-27
7,20,9,11,0,Guilford,2023-04-26
7,35,9,26,0,Harnett,2023-01-23
7,15,9,6,0,Iredell,2023-03-13
7,27,9,18,0,Randolph,2023-01-25
7,24,9,15,0,Richmond,2022-12-19
7,24,9,15,0,Surry,2022-12-10
7,34,9,25,0,Union,2022-12-24
7,19,9,10,0,Wilkes,2023-02-09
7,17,9,8,0,Wilson,2023-02-13
7,33,10,23,0,Brunswick,2022-12-16
7,26,10,16,0,Buncombe,2023-02-16
7,36,10,26,0,Cumberland,2022-12-10
7,33,10,23,0,Cumberland,2023-02-24
7,25,10,15,0,Forsyth,2023-04-25
7,26,10,16,0,Lincoln,2023-01-10
7,32,10,22,0,Nash,2022-12-20
7,35,10,25,0,Pitt,2022-11-30
7,21,10,11,0,Randolph,2023-02-10
7,19,10,9,0,Randolph,2023-02-14
7,38,10,28,0,Rowan,2023-01-18
7,20,10,10,0,Rutherford,2023-01-02
7,23,10,13,0,Surry,2022-11-28
7,18,10,8,0,Surry,2023-03-06
7,52,10,42,0,Union,2022-12-01
7,50,10,40,0,Wake,2023-02-26
7,19,10,9,0,Wilson,2022-12-15
7,20,10,10,0,Wilson,2023-02-07
7,55,11,44,0,Brunswick,2022-12-20
7,39,11,28,0,Brunswick,2023-01-16
7,38,11,27,0,Buncombe,2022-11-16
7,30,11,19,0,Buncombe,2023-02-10
7,34,11,23,0,Cabarrus,2022-11-25
7,33,11,22,0,Cabarrus,2023-01-08
7,20,11,9,0,Catawba,2022-11-25
7,61,11,50,0,Cumberland,2022-12-01
7,29,11,18,0,Cumberland,2022-12-04
7,19,11,8,0,Davie,2023-01-06
7,29,11,18,0,Guilford,2023-03-23
7,40,11,29,0,Johnston,2023-01-08
7,37,11,26,0,Johnston,2023-01-24
7,12,11,1,0,Madison,2023-02-16
7,25,11,14,0,Moore,2023-01-17
7,18,11,7,0,Moore,2023-01-18
7,32,11,21,0,New Hanover,2023-01-13
7,28,11,17,0,Randolph,2023-01-20
7,33,11,22,0,Rowan,2022-12-23
7,29,11,18,0,Rutherford,2022-12-30
7,37,11,26,0,Union,2022-11-25
7,45,12,33,0,Burke,2023-01-03
7,29,12,17,0,Carteret,2022-12-29
7,22,12,10,0,Catawba,2023-02-27
7,40,12,28,0,Forsyth,2023-03-01
7,19,12,7,0,Hoke,2023-02-17
7,34,12,22,0,Iredell,2022-12-09
7,43,12,31,0,Johnston,2023-02-02
7,19,12,7,0,Lee,2023-02-20
7,47,12,35,0,Mecklenburg,2023-04-18
7,31,12,19,0,New Hanover,2023-02-10
7,22,12,10,0,Robeson,2023-01-14
7,18,12,6,0,Robeson,2023-02-19
7,46,12,34,0,Stokes,2022-12-27
7,21,12,9,0,Wilkes,2023-02-10
7,14,13,1,0,Pasquotank,2023-02-06
7,35,13,22,0,Randolph,2022-12-11
7,38,13,25,0,Stokes,2022-12-29
7,57,13,44,0,Wake,2023-03-30
7,21,13,8,0,Wilkes,2022-12-04
7,26,14,12,0,Cumberland,2023-03-28
7,42,14,28,0,Harnett,2022-12-14
7,27,14,13,0,Iredell,2023-02-27
7,42,14,28,0,Johnston,2022-11-28
7,20,14,6,0,Stokes,2023-02-13
7,27,15,12,0,Catawba,2023-01-17
7,41,15,26,0,Cumberland,2023-01-15
7,43,15,28,0,Gaston,2023-01-20
7,41,15,26,0,Harnett,2022-12-20
7,31,15,16,0,Iredell,2022-12-01
7,39,15,24,0,Moore,2022-12-22
7,34,15,19,0,Randolph,2023-01-07
7,44,16,28,0,Cumberland,2022-11-22
7,29,16,13,0,Randolph,2022-11-29
7,27,16,11,0,Robeson,2023-02-08
7,35,16,19,0,Stokes,2022-12-28
7,26,16,10,0,Wayne,2022-11-30
7,36,16,20,0,Wilkes,2022-12-28
7,58,17,41,0,Guilford,2022-11-17
7,37,17,20,0,New Hanover,2023-01-24
7,31,17,14,0,Robeson,2022-11-28
7,30,18,12,0,Iredell,2022-11-25
7,27,19,8,0,Anson,2023-01-17
7,60,19,41,0,Cumberland,2023-01-13
7,42,19,23,0,Wayne,2023-01-02
7,33,20,13,0,Robeson,2022-12-31
7,36,21,15,0,Catawba,2022-11-14
7,45,22,23,0,Craven,2023-01-03
7,41,22,19,0,Henderson,2022-12-30
7,42,22,20,0,Surry,2022-12-26
7,35,23,12,0,Catawba,2023-01-25
7,37,23,14,0,Rutherford,2022-12-31
7,35,23,12,0,Wayne,2023-01-31
7,48,25,23,0,Buncombe,2023-01-25
7,45,27,18,0,Wayne,2022-12-22
7,31,27,4,0,Wilkes,2022-12-05
7,53,32,21,0,Buncombe,2023-01-13
7,48,33,15,0,Wayne,2022-12-29
8,25,0,25,0,Caldwell,2023-01-13
8,20,1,19,0,Franklin,2022-12-15
8,14,1,13,0,Mitchell,2023-01-17
8,27,1,26,0,Onslow,2023-02-02
8,22,1,21,0,Onslow,2023-03-28
8,19,1,18,0,Stanly,2023-01-02
8,15,1,14,0,Stanly,2023-01-27
8,25,2,23,0,Franklin,2022-12-20
8,12,2,10,0,Franklin,2023-02-16
8,23,2,21,0,Hoke,2023-01-04
8,14,2,12,0,Lincoln,2023-02-06
8,21,2,19,0,Rowan,2022-11-25
8,15,2,13,0,Stanly,2022-12-12
8,35,3,32,0,Alamance,2022-11-21
8,27,3,24,0,Davidson,2023-02-23
8,47,3,44,0,Onslow,2023-02-01
8,10,3,7,0,Rockingham,2023-03-02
8,22,3,19,0,Rowan,2023-02-08
8,27,3,24,0,Surry,2023-01-18
8,22,3,19,0,Surry,2023-02-06
8,25,3,22,0,Union,2022-11-09
8,38,4,34,0,Alamance,2022-12-08
8,17,4,13,0,Halifax,2023-01-19
8,24,4,20,0,Hoke,2023-01-23
8,29,4,25,0,Onslow,2023-01-24
8,49,4,45,0,Orange,2022-12-20
8,22,4,18,0,Pender,2023-01-06
8,29,4,25,0,Rowan,2022-12-16
8,35,4,31,0,Rowan,2023-01-11
8,39,4,35,0,Wake,2023-03-12
8,17,4,13,0,Wayne,2023-03-15
8,13,4,9,0,Yadkin,2022-12-26
8,53,5,48,0,Brunswick,2022-12-19
8,25,5,20,0,Cabarrus,2023-02-22
8,26,5,21,0,Caldwell,2022-12-06
8,34,5,29,0,Caldwell,2023-01-06
8,25,5,20,0,Cleveland,2022-12-15
8,23,5,18,0,Cumberland,2023-03-02
8,24,5,19,0,Davidson,2023-02-17
8,38,5,33,0,Edgecombe,2023-01-03
8,28,5,23,0,Gaston,2022-11-22
8,29,5,24,0,Harnett,2023-02-06
8,16,5,11,0,Moore,2022-11-28
8,19,5,14,0,Surry,2022-11-21
8,29,5,24,0,Union,2023-01-29
8,33,5,28,0,Union,2023-02-13
8,34,5,29,0,Wake,2023-04-01
8,26,6,20,0,Alamance,2022-12-10
8,42,6,36,0,Alamance,2023-02-06
8,21,6,15,0,Catawba,2022-11-16
8,25,6,19,0,Cleveland,2023-02-07
8,30,6,24,0,Davidson,2022-11-14
8,20,6,14,0,Davidson,2022-12-01
8,26,6,20,0,Davidson,2023-01-15
8,30,6,24,0,Durham,2023-03-03
8,27,6,21,0,Forsyth,2023-03-17
8,21,6,15,0,Gaston,2022-11-10
8,26,6,20,0,Johnston,2022-11-23
8,33,6,27,0,Lenoir,2023-01-02
8,21,6,15,0,Lincoln,2023-01-02
8,31,6,25,0,Nash,2022-12-27
8,31,6,25,0,Onslow,2023-01-12
8,38,6,32,0,Onslow,2023-01-31
8,32,6,26,0,Pitt,2023-01-20
8,33,6,27,0,Pitt,2023-02-01
8,15,6,9,0,Randolph,2022-11-15
8,31,6,25,0,Rowan,2022-12-13
8,25,6,19,0,Rowan,2023-01-27
8,36,6,30,0,Wake,2023-04-12
8,34,6,28,0,Wake,2023-05-05
8,23,7,16,0,Alamance,2022-11-25
8,38,7,31,0,Brunswick,2023-01-17
8,32,7,25,0,Caldwell,2022-12-26
8,23,7,16,0,Caldwell,2023-02-21
8,33,7,26,0,Cumberland,2022-12-03
8,40,7,33,0,Forsyth,2022-11-25
8,19,7,12,0,Gaston,2023-02-05
8,26,7,19,0,Guilford,2023-04-10
8,38,7,31,0,Harnett,2023-01-06
8,39,7,32,0,Johnston,2022-11-30
8,21,7,14,0,Lenoir,2022-12-30
8,42,7,35,0,Orange,2022-11-30
8,24,7,17,0,Rutherford,2023-01-06
8,35,7,28,0,Wake,2023-04-07
8,45,8,37,0,Cumberland,2023-02-22
8,28,8,20,0,Forsyth,2023-03-08
8,31,8,23,0,Forsyth,2023-03-20
8,29,8,21,0,Forsyth,2023-04-17
8,28,8,20,0,Gaston,2023-01-08
8,22,8,14,0,Halifax,2023-01-17
8,34,8,26,0,Harnett,2022-12-15
8,44,8,36,0,Onslow,2023-01-23
8,19,8,11,0,Rockingham,2022-11-29
8,30,8,22,0,Rowan,2023-02-01
8,50,8,42,0,Union,2022-12-17
8,43,8,35,0,Wake,2023-05-02
8,23,8,15,0,Wayne,2023-02-24
8,15,8,7,0,Wilkes,2023-02-03
8,14,8,6,0,Wilkes,2023-02-07
8,33,9,24,0,Brunswick,2023-01-24
8,30,9,21,0,Cleveland,2022-12-16
8,26,9,17,0,Durham,2023-03-01
8,25,9,16,0,Durham,2023-04-06
8,28,9,19,0,Forsyth,2023-04-13
8,60,9,51,0,Guilford,2023-01-01
8,24,9,15,0,Halifax,2023-01-02
8,31,9,22,0,Halifax,2023-01-11
8,19,9,10,0,Haywood,2023-01-09
8,26,9,17,0,Lincoln,2022-12-06
8,32,9,23,0,Rowan,2022-12-09
8,25,9,16,0,Rowan,2023-01-01
8,20,9,11,0,Rutherford,2022-12-22
8,18,9,9,0,Rutherford,2023-01-08
8,37,9,28,0,Wake,2023-05-04
8,19,9,10,0,Wayne,2022-12-01
8,30,10,20,0,Alamance,2023-01-14
8,39,10,29,0,Brunswick,2022-12-18
8,34,10,24,0,Brunswick,2023-01-23
8,28,10,18,0,Cumberland,2023-03-10
8,41,10,31,0,Gaston,2023-02-07
8,41,10,31,0,Guilford,2023-03-24
8,38,10,28,0,Pitt,2022-12-05
8,19,10,9,0,Robeson,2023-03-14
8,11,10,1,0,Scotland,2023-01-06
8,24,10,14,0,Stokes,2022-11-28
8,46,10,36,0,Union,2022-12-11
8,21,10,11,0,Wilson,2023-01-02
8,17,10,7,0,Wilson,2023-01-10
8,28,10,18,0,Yadkin,2022-12-27
8,41,11,30,0,Alamance,2023-02-03
8,24,11,13,0,Catawba,2023-01-13
8,27,11,16,0,Cumberland,2023-02-12
8,28,11,17,0,Cumberland,2023-02-18
8,40,11,29,0,Davidson,2022-12-07
8,26,11,15,0,Gaston,2023-02-15
8,27,11,16,0,Halifax,2023-01-12
8,38,11,27,0,New Hanover,2023-02-07
8,31,11,20,0,Pitt,2022-12-14
8,38,11,27,0,Pitt,2023-02-08
8,36,11,25,0,Richmond,2023-01-03
8,21,11,10,0,Robeson,2023-01-27
8,31,11,20,0,Union,2023-01-14
8,52,11,41,0,Wake,2023-03-04
8,25,12,13,0,Catawba,2023-01-24
8,46,12,34,0,Craven,2023-01-04
8,23,12,11,0,Duplin,2023-01-31
8,33,12,21,0,Henderson,2022-12-23
8,28,12,16,0,Moore,2023-01-12
8,24,12,12,0,Robeson,2023-02-10
8,22,12,10,0,Robeson,2023-02-17
8,25,12,13,0,Robeson,2023-02-20
8,44,12,32,0,Union,2022-12-18
8,28,12,16,0,Wilson,2022-12-31
8,45,13,32,0,Brunswick,2023-01-12
8,33,13,20,0,Burke,2022-12-06
8,44,13,31,0,Cabarrus,2023-02-09
8,35,13,22,0,Craven,2022-12-22
8,42,13,29,0,Cumberland,2023-02-17
8,36,13,23,0,Cumberland,2023-03-07
8,25,13,12,0,Halifax,2022-12-05
8,34,13,21,0,Henderson,2022-12-22
8,54,13,41,0,Johnston,2022-12-23
8,47,13,34,0,New Hanover,2022-12-12
8,39,13,26,0,New Hanover,2023-01-25
8,34,13,21,0,Robeson,2022-12-06
8,20,13,7,0,Scotland,2022-12-27
8,28,13,15,0,Wayne,2023-02-14
8,32,14,18,0,Burke,2022-12-29
8,50,14,36,0,Cumberland,2022-11-21
8,22,14,8,0,Duplin,2022-12-19
8,27,14,13,0,Duplin,2023-01-03
8,60,14,46,0,Orange,2022-12-29
8,36,14,22,0,Pitt,2023-02-16
8,43,14,29,0,Randolph,2022-12-09
8,51,14,37,0,Union,2023-01-10
8,24,14,10,0,Wayne,2023-02-09
8,19,14,5,0,Wayne,2023-03-13
8,41,15,26,0,Brunswick,2022-12-26
8,30,15,15,0,Buncombe,2022-12-01
8,43,15,28,0,Caldwell,2022-12-23
8,35,15,20,0,Catawba,2022-11-30
8,36,15,21,0,Catawba,2022-12-05
8,23,15,8,0,Catawba,2023-02-14
8,44,15,29,0,Johnston,2023-01-16
8,58,15,43,0,Mecklenburg,2023-04-19
8,46,15,31,0,New Hanover,2023-01-31
8,41,15,26,0,Randolph,2023-01-01
8,57,15,42,0,Union,2022-11-28
8,27,15,12,0,Wayne,2022-12-07
8,28,15,13,0,Wilson,2023-01-24
8,31,16,15,0,Buncombe,2023-02-21
8,29,16,13,0,Duplin,2023-02-01
8,39,16,23,0,Forsyth,2023-03-13
8,35,16,19,0,Halifax,2022-12-26
8,34,16,18,0,Wilson,2022-12-21
8,43,17,26,0,Brunswick,2023-01-10
8,49,17,32,0,Mecklenburg,2023-04-11
8,61,17,44,0,Union,2022-12-09
8,31,17,14,0,Wayne,2022-12-13
8,30,18,12,0,Catawba,2023-01-12
8,43,18,25,0,Cumberland,2022-11-23
8,34,19,15,0,Buncombe,2022-11-21
8,41,19,22,0,Surry,2022-12-15
8,44,20,24,0,Buncombe,2023-01-20
8,29,20,9,0,Cumberland,2023-03-03
8,42,20,22,0,Harnett,2023-01-11
8,44,20,24,0,New Hanover,2023-02-06
8,32,21,11,0,Catawba,2022-12-24
8,52,21,31,0,Cumberland,2023-01-01
8,35,21,14,0,Iredell,2023-01-24
8,38,22,16,0,Buncombe,2022-12-24
8,72,22,50,0,Cabarrus,2022-12-22
8,40,22,18,0,Robeson,2023-01-05
8,41,23,18,0,Buncombe,2023-01-07
8,67,23,44,0,Forsyth,2023-01-27
8,34,24,10,0,Burke,2023-01-02
8,76,24,52,0,New Hanover,2022-12-29
8,43,25,18,0,Wayne,2022-12-12
8,38,27,11,0,Catawba,2023-02-10
8,60,27,33,0,Harnett,2022-12-29
8,45,29,16,0,Wilson,2022-12-29
8,47,30,17,0,Wayne,2023-01-06
8,45,30,15,0,Wayne,2023-01-12
8,59,32,27,0,Buncombe,2022-12-13
8,50,33,17,0,Wayne,2023-01-10
8,54,35,19,0,Craven,2022-12-30
9,22,1,21,0,Caldwell,2023-01-29
9,16,1,15,0,Hoke,2022-12-05
9,24,1,23,0,Stanly,2022-12-19
9,38,2,36,0,Brunswick,2022-12-12
9,36,2,34,0,Durham,2022-11-08
9,47,3,44,0,Durham,2022-12-02
9,48,3,45,0,Durham,2023-02-03
9,33,3,30,0,Durham,2023-02-24
9,37,3,34,0,Forsyth,2023-03-09
9,60,3,57,0,Onslow,2023-02-07
9,17,3,14,0,Richmond,2022-12-20
9,32,3,29,0,Union,2023-02-10
9,25,4,21,0,Caldwell,2023-02-06
9,20,4,16,0,Cleveland,2022-12-09
9,24,4,20,0,Cleveland,2022-12-22
9,43,4,39,0,Durham,2023-02-11
9,42,4,38,0,Johnston,2023-01-19
9,41,4,37,0,Mecklenburg,2023-04-14
9,30,4,26,0,Onslow,2023-01-26
9,31,4,27,0,Union,2023-02-03
9,35,5,30,0,Alamance,2023-02-14
9,30,5,25,0,Alamance,2023-02-16
9,22,5,17,0,Alamance,2023-02-27
9,41,5,36,0,Caldwell,2022-12-28
9,23,5,18,0,Cleveland,2023-01-23
9,40,5,35,0,Davidson,2023-02-07
9,21,5,16,0,Durham,2023-03-04
9,26,5,21,0,Johnston,2023-02-22
9,18,5,13,0,Johnston,2023-03-15
9,25,5,20,0,Yadkin,2022-12-28
9,25,6,19,0,Caldwell,2022-12-13
9,28,6,22,0,Caldwell,2023-02-03
9,39,6,33,0,Davidson,2022-12-08
9,25,6,19,0,Granville,2023-01-03
9,28,6,22,0,Lenoir,2022-12-14
9,34,6,28,0,Mecklenburg,2023-04-16
9,35,6,29,0,Onslow,2022-12-20
9,21,6,15,0,Randolph,2023-02-16
9,25,6,19,0,Richmond,2022-12-29
9,35,6,29,0,Rowan,2022-12-05
9,29,6,23,0,Rowan,2023-01-19
9,24,6,18,0,Union,2023-02-04
9,31,6,25,0,Wake,2023-04-11
9,47,6,41,0,Wake,2023-04-17
9,26,7,19,0,Alamance,2023-01-26
9,50,7,43,0,Cabarrus,2022-12-16
9,39,7,32,0,Davidson,2023-01-01
9,39,7,32,0,Durham,2023-02-17
9,40,7,33,0,Gaston,2022-11-30
9,18,7,11,0,Halifax,2023-02-06
9,41,7,34,0,Johnston,2022-12-18
9,36,7,29,0,Johnston,2022-12-24
9,36,7,29,0,Johnston,2023-02-10
9,39,7,32,0,Lincoln,2022-12-20
9,27,7,20,0,Pitt,2022-12-09
9,18,7,11,0,Rutherford,2022-12-19
9,41,7,34,0,Wake,2023-04-06
9,30,7,23,0,Wake,2023-04-19
9,48,8,40,0,Alamance,2022-11-28
9,43,8,35,0,Alamance,2022-12-07
9,43,8,35,0,Cabarrus,2022-12-07
9,38,8,30,0,Cleveland,2022-12-14
9,56,8,48,0,Forsyth,2022-11-30
9,39,8,31,0,Gaston,2023-01-18
9,31,8,23,0,Rutherford,2022-12-28
9,19,8,11,0,Stokes,2023-01-10
9,42,8,34,0,Union,2023-02-08
9,42,8,34,0,Wake,2023-04-04
9,41,8,33,0,Wake,2023-04-26
9,47,9,38,0,Caldwell,2022-12-27
9,45,9,36,0,Caldwell,2023-01-03
9,48,9,39,0,Davidson,2023-02-06
9,29,9,20,0,Halifax,2022-12-30
9,24,9,15,0,Johnston,2023-02-09
9,40,9,31,0,Lenoir,2022-12-27
9,29,9,20,0,Lincoln,2023-01-05
9,28,9,19,0,Rockingham,2023-01-06
9,32,9,23,0,Surry,2022-12-23
9,64,9,55,0,Wake,2022-11-20
9,53,9,44,0,Wake,2023-03-08
9,32,9,23,0,Wake,2023-04-18
9,36,10,26,0,Cabarrus,2023-02-15
9,51,10,41,0,Davidson,2023-01-06
9,31,10,21,0,Guilford,2023-03-27
9,41,10,31,0,Orange,2022-11-29
9,58,10,48,0,Orange,2022-12-27
9,32,10,22,0,Stokes,2022-12-19
9,53,10,43,0,Union,2022-12-02
9,43,11,32,0,Cabarrus,2023-02-08
9,41,11,30,0,Cleveland,2022-12-19
9,37,11,26,0,Gaston,2022-12-02
9,25,11,14,0,Lenoir,2022-12-19
9,25,11,14,0,Lenoir,2023-02-09
9,39,11,28,0,Mecklenburg,2023-04-27
9,38,11,27,0,New Hanover,2023-01-30
9,45,12,33,0,Cabarrus,2022-12-14
9,50,12,38,0,Cabarrus,2023-01-24
9,27,12,15,0,Iredell,2023-01-14
9,36,12,24,0,Mecklenburg,2023-04-17
9,31,12,19,0,New Hanover,2022-12-08
9,40,12,28,0,Pitt,2022-12-02
9,26,12,14,0,Robeson,2023-02-01
9,26,12,14,0,Robeson,2023-02-02
9,46,12,34,0,Surry,2022-12-13
9,51,12,39,0,Union,2023-01-25
9,71,13,58,0,Brunswick,2022-12-30
9,32,13,19,0,Davie,2022-12-27
9,34,13,21,0,Gaston,2023-01-15
9,28,13,15,0,Halifax,2023-01-06
9,39,13,26,0,Randolph,2023-01-06
9,25,13,12,0,Robeson,2022-11-09
9,73,13,60,0,Wake,2023-03-21
9,39,14,25,0,Henderson,2023-01-16
9,30,14,16,0,Mecklenburg,2023-04-21
9,34,14,20,0,Rockingham,2022-12-28
9,24,14,10,0,Sampson,2023-02-06
9,33,14,19,0,Wayne,2022-12-18
9,27,14,13,0,Wilkes,2022-12-20
9,29,14,15,0,Wilson,2022-12-26
9,53,15,38,0,Cabarrus,2023-01-23
9,25,15,10,0,Cumberland,2023-03-17
9,28,15,13,0,Iredell,2023-01-22
9,30,15,15,0,Randolph,2022-12-05
9,74,15,59,0,Wake,2023-02-12
9,21,15,6,0,Wilkes,2023-01-05
9,37,16,21,0,Caldwell,2022-12-12
9,35,16,19,0,Franklin,2022-12-27
9,34,16,18,0,Lincoln,2022-12-05
9,42,16,26,0,Pitt,2022-12-12
9,25,16,9,0,Wayne,2023-02-16
9,23,16,7,0,Wilkes,2022-12-14
9,69,17,52,0,Forsyth,2022-11-29
9,38,17,21,0,Forsyth,2023-03-22
9,35,17,18,0,Gaston,2023-02-16
9,69,18,51,0,Guilford,2022-11-23
9,41,18,23,0,Iredell,2022-12-05
9,46,18,28,0,Iredell,2023-01-10
9,24,18,6,0,Iredell,2023-01-16
9,27,18,9,0,Robeson,2022-12-10
9,26,18,8,0,Robeson,2023-02-14
9,68,19,49,0,Cumberland,2023-02-03
9,26,19,7,0,Wayne,2023-01-26
9,48,20,28,0,Buncombe,2022-11-14
9,36,20,16,0,Iredell,2022-11-30
9,28,20,8,0,Wilson,2022-12-14
9,51,21,30,0,Cabarrus,2022-11-28
9,61,21,40,0,Cabarrus,2022-12-26
9,60,21,39,0,Henderson,2023-01-03
9,37,22,15,0,Catawba,2023-02-01
9,38,22,16,0,Iredell,2023-02-09
9,27,23,4,0,Duplin,2023-02-07
9,43,23,20,0,Iredell,2023-01-12
9,44,23,21,0,Robeson,2023-01-18
9,48,24,24,0,Moore,2022-12-26
9,38,24,14,0,Wayne,2023-02-01
9,41,24,17,0,Wilkes,2022-12-12
9,48,25,23,0,Moore,2022-12-19
9,40,25,15,0,New Hanover,2022-12-17
9,45,27,18,0,Cumberland,2023-01-29
9,91,28,63,0,Guilford,2022-12-24
9,44,28,16,0,Wayne,2023-01-05
9,41,28,13,0,Wayne,2023-01-23
9,62,30,32,0,Buncombe,2022-12-07
9,42,31,11,0,Wayne,2022-11-28
9,64,32,32,0,Cumberland,2022-12-17
9,59,32,27,0,Wayne,2022-12-27
9,55,33,22,0,Catawba,2022-12-14
9,44,33,11,0,Wayne,2022-12-20
9,53,36,17,0,Henderson,2022-12-29
10,32,1,31,0,Onslow,2023-02-16
10,35,2,33,0,Cumberland,2023-02-28
10,21,2,19,0,Surry,2023-01-17
10,39,3,36,0,Alamance,2023-01-30
10,21,3,18,0,Alamance,2023-02-12
10,33,3,30,0,Davidson,2023-01-07
10,36,3,33,0,Granville,2023-01-02
10,39,3,36,0,Orange,2023-01-26
10,17,3,14,0,Pitt,2022-11-23
10,35,3,32,0,Stanly,2022-12-27
10,22,4,18,0,Beaufort,2023-01-04
10,43,4,39,0,Franklin,2023-01-03
10,42,4,38,0,Orange,2023-01-19
10,31,4,27,0,Rowan,2023-02-09
10,31,4,27,0,Stanly,2023-01-06
10,45,4,41,0,Wake,2023-03-14
10,39,5,34,0,Durham,2023-01-28
10,26,5,21,0,Lincoln,2022-12-22
10,28,5,23,0,Lincoln,2022-12-27
10,33,5,28,0,Orange,2023-01-13
10,32,5,27,0,Rockingham,2023-01-09
10,49,5,44,0,Rowan,2022-11-28
10,28,5,23,0,Rowan,2023-02-06
10,23,5,18,0,Union,2022-11-17
10,18,5,13,0,Wayne,2023-02-17
10,16,6,10,0,Bladen,2023-02-01
10,49,6,43,0,Caldwell,2022-12-29
10,33,6,27,0,Craven,2022-12-20
10,32,6,26,0,Davidson,2023-02-02
10,24,6,18,0,Granville,2023-01-09
10,21,6,15,0,Henderson,2023-04-17
10,47,6,41,0,Onslow,2022-12-16
10,48,7,41,0,Alamance,2023-01-11
10,37,7,30,0,Alamance,2023-01-27
10,30,7,23,0,Caldwell,2022-12-14
10,27,7,20,0,Chatham,2023-01-09
10,27,7,20,0,Cumberland,2023-03-27
10,41,7,34,0,Davidson,2023-01-18
10,23,7,16,0,Gaston,2023-02-17
10,30,7,23,0,Johnston,2023-01-27
10,23,7,16,0,Johnston,2023-03-13
10,37,7,30,0,Lincoln,2022-12-12
10,24,7,17,0,Lincoln,2022-12-29
10,39,7,32,0,Orange,2022-11-28
10,34,7,27,0,Pitt,2023-02-07
10,31,7,24,0,Surry,2023-01-24
10,59,7,52,0,Wake,2023-03-28
10,23,8,15,0,Alamance,2023-02-24
10,52,8,44,0,Brunswick,2022-12-13
10,30,8,22,0,Cabarrus,2023-02-24
10,34,8,26,0,Caldwell,2023-01-12
10,38,8,30,0,Davidson,2023-01-26
10,28,8,20,0,Franklin,2022-12-29
10,28,8,20,0,Guilford,2023-05-01
10,55,8,47,0,Union,2022-12-05
10,46,9,37,0,Brunswick,2022-12-22
10,45,9,36,0,Forsyth,2023-01-22
10,37,9,28,0,Forsyth,2023-03-07
10,27,9,18,0,Forsyth,2023-03-23
10,47,9,38,0,Harnett,2022-12-22
10,25,9,16,0,Lenoir,2022-12-20
10,37,9,28,0,Mecklenburg,2023-05-02
10,55,9,46,0,Onslow,2023-01-17
10,35,9,26,0,Pitt,2023-02-15
10,34,9,25,0,Stanly,2023-01-13
10,31,10,21,0,Burke,2022-12-05
10,48,10,38,0,Burke,2023-01-05
10,45,10,35,0,Forsyth,2023-02-24
10,34,10,24,0,Johnston,2022-12-11
10,39,10,29,0,Johnston,2023-02-14
10,35,10,25,0,Mecklenburg,2023-04-07
10,56,10,46,0,New Hanover,2022-12-22
10,52,10,42,0,Onslow,2022-12-28
10,32,10,22,0,Union,2023-02-14
10,35,11,24,0,Alamance,2022-12-24
10,51,11,40,0,Brunswick,2023-01-04
10,52,11,41,0,Brunswick,2023-01-05
10,79,11,68,0,Cumberland,2023-01-11
10,43,11,32,0,Davidson,2022-12-13
10,32,11,21,0,Davidson,2023-02-21
10,64,11,53,0,Durham,2022-12-09
10,33,11,22,0,Hoke,2022-12-29
10,35,11,24,0,Johnston,2022-12-02
10,29,11,18,0,Moore,2023-02-01
10,28,11,17,0,Pitt,2023-02-02
10,40,11,29,0,Surry,2023-01-03
10,32,11,21,0,Surry,2023-01-05
10,60,11,49,0,Union,2023-01-24
10,48,11,37,0,Wake,2023-04-10
10,33,11,22,0,Wake,2023-05-01
10,60,12,48,0,Cabarrus,2022-12-12
10,49,12,37,0,Johnston,2022-11-29
10,46,12,34,0,Moore,2023-01-04
10,33,12,21,0,Pitt,2023-02-03
10,29,12,17,0,Randolph,2023-01-26
10,68,12,56,0,Union,2022-12-07
10,67,12,55,0,Wake,2023-03-06
10,36,13,23,0,Gaston,2023-02-01
10,29,13,16,0,Wilson,2022-12-19
10,60,14,46,0,Alamance,2022-12-14
10,49,14,35,0,Gaston,2023-01-17
10,33,14,19,0,Guilford,2023-03-21
10,46,14,32,0,Mecklenburg,2023-03-04
10,47,14,33,0,New Hanover,2022-11-28
10,48,14,34,0,New Hanover,2022-12-19
10,54,14,40,0,Rowan,2022-12-29
10,20,14,6,0,Surry,2023-02-22
10,67,15,52,0,Brunswick,2022-12-28
10,35,15,20,0,Buncombe,2023-02-01
10,53,15,38,0,Cabarrus,2022-12-31
10,40,15,25,0,Gaston,2023-01-26
10,35,15,20,0,Iredell,2022-11-21
10,35,15,20,0,Surry,2022-12-08
10,24,15,9,0,Wayne,2023-03-06
10,51,16,35,0,Davidson,2023-01-27
10,27,16,11,0,Wayne,2023-02-21
10,40,16,24,0,Wilson,2023-01-03
10,42,17,25,0,Buncombe,2022-12-09
10,47,17,30,0,Cabarrus,2023-01-26
10,42,17,25,0,Mecklenburg,2023-04-24
10,42,17,25,0,Moore,2022-12-28
10,35,17,18,0,Robeson,2022-12-09
10,46,18,28,0,Henderson,2022-12-27
10,77,18,59,0,Mecklenburg,2023-02-11
10,42,19,23,0,Davidson,2023-01-23
10,45,19,26,0,Johnston,2023-01-13
10,31,19,12,0,Pitt,2023-02-11
10,29,19,10,0,Wayne,2023-01-24
10,25,20,5,0,Henderson,2023-04-24
10,49,20,29,0,Rockingham,2022-12-29
10,49,21,28,0,Moore,2022-12-20
10,46,22,24,0,Craven,2022-12-29
10,38,22,16,0,Iredell,2022-11-28
10,39,22,17,0,Iredell,2022-12-18
10,53,22,31,0,New Hanover,2022-12-15
10,58,22,36,0,New Hanover,2022-12-23
10,41,22,19,0,Randolph,2022-12-12
10,44,22,22,0,Randolph,2022-12-13
10,47,23,24,0,Buncombe,2022-11-30
10,38,23,15,0,New Hanover,2023-01-08
10,31,23,8,0,Pasquotank,2022-12-21
10,36,23,13,0,Stokes,2023-01-02
10,48,24,24,0,Randolph,2022-12-30
10,54,25,29,0,Buncombe,2023-01-16
10,39,26,13,0,Wilkes,2022-12-21
10,43,28,15,0,Iredell,2022-11-29
10,59,29,30,0,Moore,2022-12-29
10,47,31,16,0,Randolph,2022-12-08
11,39,0,39,0,Stanly,2022-12-29
11,52,1,51,0,Durham,2022-11-30
11,34,3,31,0,Harnett,2023-01-12
11,33,4,29,0,Alamance,2022-12-02
11,61,4,57,0,Durham,2022-12-06
11,38,4,34,0,Pitt,2022-12-26
11,33,5,28,0,Franklin,2022-12-30
11,47,5,42,0,Onslow,2023-01-05
11,42,5,37,0,Onslow,2023-02-09
11,29,5,24,0,Stokes,2022-12-12
11,30,6,24,0,Alamance,2022-11-22
11,43,6,37,0,Johnston,2022-12-05
11,41,6,35,0,Lincoln,2022-12-28
11,33,6,27,0,Vance,2022-12-27
11,36,7,29,0,Davidson,2023-02-01
11,55,7,48,0,Forsyth,2022-12-02
11,43,7,36,0,Forsyth,2022-12-03
11,32,7,25,0,Lenoir,2023-01-03
11,46,7,39,0,Union,2023-01-30
11,33,8,25,0,Cleveland,2022-12-06
11,42,8,34,0,Forsyth,2022-11-23
11,43,8,35,0,Gaston,2023-02-08
11,25,8,17,0,Mecklenburg,2023-04-23
11,38,8,30,0,Pitt,2023-02-10
11,32,8,24,0,Union,2023-01-27
11,47,9,38,0,Caldwell,2022-12-30
11,30,9,21,0,Cumberland,2023-03-16
11,33,9,24,0,Rockingham,2022-12-14
11,28,9,19,0,Rockingham,2023-01-16
11,57,10,47,0,Cabarrus,2022-12-05
11,44,10,34,0,Caldwell,2023-01-02
11,25,10,15,0,Davie,2023-01-03
11,48,10,38,0,Lincoln,2023-01-03
11,50,10,40,0,Pitt,2022-11-28
11,28,10,18,0,Robeson,2023-01-19
11,39,10,29,0,Wake,2023-03-18
11,35,11,24,0,Burke,2023-01-09
11,46,11,35,0,Cabarrus,2023-02-01
11,29,11,18,0,Cumberland,2023-03-21
11,35,11,24,0,Halifax,2022-12-29
11,43,11,32,0,Johnston,2023-01-01
11,54,11,43,0,Pitt,2022-12-22
11,34,11,23,0,Rutherford,2023-01-04
11,42,11,31,0,Surry,2022-12-12
11,25,12,13,0,Brunswick,2022-11-21
11,47,12,35,0,Forsyth,2022-11-22
11,25,12,13,0,Randolph,2023-02-01
11,29,12,17,0,Wilkes,2022-12-30
11,36,13,23,0,Cumberland,2023-01-21
11,60,13,47,0,Cumberland,2023-02-07
11,42,13,29,0,Gaston,2022-11-25
11,29,13,16,0,McDowell,2023-01-18
11,42,14,28,0,Brunswick,2023-01-06
11,78,14,64,0,Cumberland,2022-12-09
11,36,14,22,0,Davidson,2023-01-25
11,27,14,13,0,Randolph,2023-01-24
11,35,14,21,0,Stokes,2022-12-20
11,47,15,32,0,Cumberland,2023-01-22
11,53,15,38,0,Guilford,2023-01-15
11,66,15,51,0,Guilford,2023-01-29
11,28,15,13,0,Guilford,2023-03-28
11,41,15,26,0,Harnett,2022-12-13
11,36,16,20,0,Franklin,2022-12-28
11,53,16,37,0,Gaston,2022-12-16
11,49,16,33,0,Gaston,2023-01-12
11,28,16,12,0,Iredell,2023-02-20
11,43,16,27,0,Mecklenburg,2023-05-01
11,28,16,12,0,Nash,2023-02-20
11,31,16,15,0,Surry,2022-12-01
11,42,17,25,0,Halifax,2023-01-09
11,20,17,3,0,McDowell,2023-04-25
11,46,17,29,0,New Hanover,2022-12-31
11,36,17,19,0,Randolph,2022-11-30
11,47,17,30,0,Stokes,2023-01-03
11,43,18,25,0,Craven,2023-01-05
11,64,19,45,0,Cabarrus,2023-01-06
11,27,19,8,0,Catawba,2023-01-26
11,40,19,21,0,Cleveland,2022-11-28
11,40,19,21,0,Iredell,2023-02-16
11,54,19,35,0,Johnston,2023-01-11
11,53,20,33,0,Harnett,2023-01-03
11,55,21,34,0,Davidson,2022-12-23
11,36,21,15,0,Iredell,2023-02-07
11,49,21,28,0,Johnston,2022-12-09
11,34,21,13,0,Stokes,2022-12-26
11,39,21,18,0,Wilkes,2022-12-13
11,40,21,19,0,Wilson,2022-12-30
11,28,22,6,0,Randolph,2023-01-22
11,41,22,19,0,Wayne,2023-01-20
11,40,22,18,0,Wilkes,2022-12-19
11,65,23,42,0,New Hanover,2022-12-30
11,73,24,49,0,Cumberland,2023-01-16
11,72,24,48,0,Cumberland,2023-02-15
11,92,24,68,0,Wake,2023-02-28
11,38,25,13,0,Wayne,2023-01-30
11,44,27,17,0,Buncombe,2023-01-01
11,41,27,14,0,Buncombe,2023-02-03
11,53,27,26,0,Catawba,2022-12-15
11,57,30,27,0,Randolph,2022-12-26
11,62,35,27,0,Henderson,2022-12-28
11,54,38,16,0,Randolph,2022-12-20
12,17,2,15,0,Yadkin,2022-12-15
12,48,3,45,0,Alamance,2023-01-19
12,32,3,29,0,Lincoln,2022-12-30
12,23,3,20,0,Montgomery,2023-02-01
12,46,3,43,0,Onslow,2023-02-10
12,69,5,64,0,Durham,2022-12-05
12,36,5,31,0,Harnett,2022-12-21
12,31,5,26,0,Rowan,2023-01-25
12,42,6,36,0,Cleveland,2022-12-27
12,53,6,47,0,Forsyth,2022-12-10
12,35,6,29,0,Onslow,2022-12-22
12,40,6,34,0,Onslow,2023-01-25
12,35,7,28,0,Caldwell,2023-02-02
12,36,7,29,0,Cleveland,2023-01-05
12,41,7,34,0,Rowan,2022-11-29
12,59,8,51,0,Guilford,2023-02-12
12,31,8,23,0,Pitt,2023-01-19
12,38,8,30,0,Pitt,2023-01-25
12,46,8,38,0,Vance,2023-01-02
12,40,9,31,0,Davidson,2023-02-14
12,27,9,18,0,Nash,2022-12-19
12,50,9,41,0,Onslow,2022-12-30
12,53,10,43,0,Alamance,2022-12-15
12,39,10,29,0,Alamance,2023-02-08
12,40,10,30,0,Pitt,2023-01-12
12,34,10,24,0,Rowan,2022-12-12
12,63,10,53,0,Wake,2023-04-03
12,33,11,22,0,Gaston,2022-11-23
12,28,11,17,0,Halifax,2022-12-20
12,38,11,27,0,Mecklenburg,2023-05-03
12,66,11,55,0,Wake,2023-02-25
12,50,12,38,0,Gaston,2023-01-19
12,62,13,49,0,Davidson,2022-12-12
12,35,13,22,0,Surry,2022-12-22
12,64,14,50,0,Johnston,2022-12-22
12,40,14,26,0,Johnston,2023-01-30
12,60,14,46,0,Mecklenburg,2023-04-10
12,33,14,19,0,Rutherford,2023-01-03
12,71,14,57,0,Union,2023-01-02
12,85,14,71,0,Wake,2022-11-16
12,82,15,67,0,Cumberland,2022-11-28
12,62,15,47,0,Harnett,2022-12-28
12,36,15,21,0,Pitt,2022-12-06
12,44,15,29,0,Robeson,2022-11-30
12,86,15,71,0,Wake,2022-11-11
12,35,16,19,0,Nash,2023-01-02
12,67,17,50,0,Mecklenburg,2023-03-21
12,47,17,30,0,Pitt,2023-01-23
12,30,18,12,0,Cleveland,2023-02-06
12,44,18,26,0,Forsyth,2023-03-06
12,55,18,37,0,Guilford,2022-12-04
12,36,18,18,0,Robeson,2023-01-13
12,63,19,44,0,Guilford,2022-11-22
12,39,19,20,0,Iredell,2023-02-06
12,36,19,17,0,Wayne,2023-02-08
12,33,20,13,0,Duplin,2022-12-20
12,40,20,20,0,Wayne,2022-12-14
12,32,21,11,0,Wilkes,2022-12-29
12,43,22,21,0,Iredell,2022-12-08
12,53,23,30,0,Catawba,2022-11-28
12,39,23,16,0,Wayne,2022-12-08
12,50,25,25,0,Buncombe,2022-12-06
12,43,25,18,0,Wilson,2022-12-28
12,41,26,15,0,Catawba,2023-02-07
12,35,26,9,0,Catawba,2023-02-13
12,64,26,38,0,New Hanover,2023-01-05
12,38,26,12,0,Wayne,2022-12-09
12,51,26,25,0,Wayne,2022-12-30
12,34,26,8,0,Wayne,2023-02-13
12,92,27,65,0,Johnston,2022-12-21
12,52,28,24,0,Iredell,2022-12-15
12,61,30,31,0,Iredell,2022-12-20
12,75,33,42,0,Harnett,2022-12-30
13,39,2,37,0,Onslow,2023-01-06
13,42,4,38,0,Durham,2023-03-02
13,48,4,44,0,Onslow,2023-02-06
13,57,5,52,0,Durham,2023-01-07
13,42,6,36,0,Cabarrus,2023-01-16
13,31,6,25,0,Caldwell,2023-01-27
13,45,6,39,0,Davidson,2023-02-09
13,62,6,56,0,Durham,2023-02-01
13,17,7,10,0,Rutherford,2022-12-26
13,42,8,34,0,Davidson,2023-02-15
13,37,8,29,0,Gaston,2023-01-31
13,54,8,46,0,Granville,2022-12-28
13,74,8,66,0,Wake,2022-11-12
13,70,9,61,0,Durham,2023-01-13
13,38,10,28,0,Cleveland,2022-12-20
13,25,10,15,0,Davie,2023-01-04
13,31,10,21,0,Nash,2023-01-30
13,63,11,52,0,Brunswick,2023-01-02
13,45,11,34,0,Burke,2023-01-04
13,53,11,42,0,Cabarrus,2023-01-13
13,39,11,28,0,Cabarrus,2023-02-07
13,37,11,26,0,Davidson,2022-12-18
13,57,11,46,0,Mecklenburg,2023-04-05
13,39,11,28,0,Mecklenburg,2023-04-28
13,38,11,27,0,Rockingham,2023-01-05
13,45,11,34,0,Union,2023-02-09
13,35,11,24,0,Union,2023-02-15
13,54,12,42,0,Cabarrus,2023-01-12
13,65,12,53,0,Forsyth,2023-02-17
13,35,12,23,0,Johnston,2022-12-06
13,46,12,34,0,Pitt,2023-02-14
13,51,13,38,0,Forsyth,2022-11-08
13,32,13,19,0,Johnston,2023-02-13
13,34,13,21,0,Robeson,2022-12-05
13,41,13,28,0,Robeson,2023-02-07
13,61,13,48,0,Union,2023-01-23
13,40,14,26,0,Cumberland,2023-03-08
13,44,14,30,0,Davidson,2023-01-12
13,52,14,38,0,Gaston,2022-12-11
13,62,14,48,0,Mecklenburg,2023-02-26
13,60,14,46,0,Moore,2023-01-02
13,33,14,19,0,Pitt,2022-12-23
13,95,14,81,0,Wake,2022-11-18
13,80,14,66,0,Wake,2023-02-04
13,56,14,42,0,Wake,2023-03-17
13,60,15,45,0,Gaston,2022-12-09
13,40,15,25,0,Guilford,2023-03-01
13,49,15,34,0,Johnston,2023-02-08
13,51,15,36,0,Pitt,2022-12-30
13,44,15,29,0,Pitt,2023-01-31
13,49,15,34,0,Rockingham,2022-12-30
13,36,15,21,0,Rowan,2023-01-02
13,58,15,43,0,Union,2023-01-17
13,46,16,30,0,Gaston,2023-02-13
13,45,16,29,0,Mecklenburg,2023-04-06
13,77,16,61,0,Union,2022-12-23
13,38,17,21,0,Catawba,2022-12-08
13,55,17,38,0,Mecklenburg,2023-04-26
13,70,18,52,0,Johnston,2022-12-19
13,20,18,2,0,New Hanover,2023-04-06
13,50,18,32,0,Pitt,2022-12-15
13,54,18,36,0,Wake,2023-04-24
13,37,19,18,0,Columbus,2022-12-19
13,52,19,33,0,Craven,2022-12-19
13,47,19,28,0,Cumberland,2023-02-04
13,75,19,56,0,Pitt,2022-12-21
13,40,21,19,0,Robeson,2022-12-07
13,39,22,17,0,Catawba,2023-01-23
13,79,23,56,0,Cumberland,2022-11-30
13,84,23,61,0,Guilford,2022-11-14
13,53,23,30,0,Randolph,2023-01-05
13,71,24,47,0,Johnston,2023-01-09
13,38,24,14,0,Robeson,2023-01-09
13,55,24,31,0,Surry,2022-12-19
13,70,28,42,0,New Hanover,2022-12-21
13,56,30,26,0,Catawba,2022-12-21
13,48,30,18,0,Wayne,2022-12-21
13,57,31,26,0,Randolph,2022-12-29
13,39,31,8,0,Robeson,2022-12-23
13,61,34,27,0,Catawba,2023-01-04
14,50,2,48,0,Durham,2023-02-15
14,37,3,34,0,Union,2022-11-22
14,32,4,28,0,Lenoir,2023-01-09
14,31,5,26,0,Alamance,2023-02-10
14,61,5,56,0,Durham,2022-12-08
14,54,7,47,0,Onslow,2023-02-08
14,41,7,34,0,Rowan,2022-12-22
14,69,8,61,0,Durham,2023-02-07
14,55,8,47,0,Forsyth,2023-01-29
14,38,8,30,0,Gaston,2023-01-24
14,51,8,43,0,Onslow,2023-01-03
14,75,8,67,0,Wake,2023-03-03
14,65,9,56,0,Alamance,2023-01-09
14,54,9,45,0,Pitt,2023-01-02
14,63,10,53,0,Alamance,2023-01-17
14,41,10,31,0,Gaston,2022-12-24
14,43,10,33,0,Johnston,2023-01-31
14,36,10,26,0,Rutherford,2022-12-27
14,54,10,44,0,Union,2023-01-26
14,69,11,58,0,Forsyth,2022-12-11
14,52,11,41,0,Guilford,2023-02-04
14,49,11,38,0,Pitt,2023-02-13
14,55,12,43,0,Cleveland,2022-12-30
14,37,12,25,0,Mecklenburg,2023-03-26
14,41,12,29,0,Pitt,2023-01-24
14,52,12,40,0,Union,2022-12-06
14,59,12,47,0,Union,2022-12-15
14,45,13,32,0,Caldwell,2023-01-04
14,51,13,38,0,Gaston,2023-01-05
14,53,13,40,0,Harnett,2022-12-19
14,41,13,28,0,Rowan,2023-01-13
14,42,13,29,0,Surry,2022-12-05
14,47,14,33,0,Cleveland,2022-12-29
14,41,14,27,0,Pitt,2022-12-13
14,40,14,26,0,Pitt,2023-01-26
14,56,14,42,0,Union,2023-01-16
14,35,15,20,0,Buncombe,2023-01-26
14,50,15,35,0,Johnston,2022-12-07
14,53,15,38,0,Pitt,2022-12-20
14,35,15,20,0,Pitt,2022-12-31
14,52,16,36,0,Cumberland,2023-02-10
14,48,16,32,0,Union,2023-01-31
14,77,17,60,0,Brunswick,2022-12-27
14,66,17,49,0,Gaston,2022-12-05
14,35,17,18,0,Lenoir,2023-02-08
14,68,17,51,0,Mecklenburg,2023-04-04
14,55,17,38,0,Rowan,2022-12-20
14,89,17,72,0,Wake,2023-03-01
14,72,19,53,0,Alamance,2022-12-16
14,54,19,35,0,Caldwell,2022-12-21
14,61,19,42,0,Mecklenburg,2023-03-17
14,45,19,26,0,New Hanover,2023-01-12
14,40,19,21,0,Robeson,2023-01-06
14,34,19,15,0,Robeson,2023-01-25
14,28,21,7,0,Lee,2023-02-16
14,80,21,59,0,Mecklenburg,2023-02-12
14,36,22,14,0,Iredell,2023-02-13
14,59,23,36,0,Forsyth,2023-02-27
14,70,23,47,0,Guilford,2023-02-10
14,81,24,57,0,Cumberland,2023-02-08
14,95,24,71,0,Durham,2022-12-13
14,29,24,5,0,Haywood,2022-12-11
14,38,24,14,0,Iredell,2022-12-02
14,54,25,29,0,Iredell,2023-01-06
14,82,27,55,0,Guilford,2022-12-02
14,102,28,74,0,Cumberland,2023-02-01
14,47,30,17,0,Iredell,2023-01-18
14,38,30,8,0,Robeson,2023-01-16
14,90,32,58,0,Cumberland,2023-01-20
14,67,37,30,0,Buncombe,2022-12-23
14,79,38,41,0,Buncombe,2022-12-28
14,70,40,30,0,Henderson,2022-12-26
14,127,43,84,0,Guilford,2022-11-30
14,118,44,74,0,Gaston,2022-12-30
14,74,49,25,0,Catawba,2022-12-30
14,83,53,30,0,Buncombe,2023-01-02
15,47,4,43,0,Onslow,2023-01-30
15,48,9,39,0,Mecklenburg,2023-03-25
15,36,9,27,0,Union,2023-02-07
15,42,10,32,0,Forsyth,2023-02-28
15,65,10,55,0,Guilford,2022-11-15
15,46,10,36,0,Wake,2023-03-26
15,61,11,50,0,Mecklenburg,2023-03-31
15,69,12,57,0,Alamance,2022-12-19
15,51,12,39,0,Rowan,2022-12-27
15,45,13,32,0,Johnston,2023-01-12
15,55,13,42,0,Johnston,2023-01-17
15,34,13,21,0,Pitt,2023-02-20
15,78,13,65,0,Union,2022-12-30
15,58,14,44,0,Cumberland,2023-02-21
15,62,14,48,0,Wake,2023-03-24
15,47,16,31,0,Wake,2023-05-03
15,49,17,32,0,Davidson,2022-12-16
15,46,17,29,0,Gaston,2022-12-17
15,61,18,43,0,Guilford,2023-01-28
15,46,20,26,0,Halifax,2023-01-03
15,50,21,29,0,Buncombe,2023-01-23
15,65,23,42,0,Brunswick,2023-01-03
15,47,24,23,0,Robeson,2023-01-30
15,58,27,31,0,Buncombe,2023-01-31
15,55,28,27,0,New Hanover,2023-01-23
15,70,30,40,0,Johnston,2022-12-14
15,46,31,15,0,Wayne,2023-02-27
15,47,33,14,0,Randolph,2022-12-14
15,77,50,27,0,Randolph,2022-12-22
15,97,57,40,0,Buncombe,2022-12-30
15,99,70,29,0,Harnett,2023-01-04
16,47,3,44,0,Pitt,2023-01-17
16,40,4,36,0,Rowan,2023-01-05
16,44,6,38,0,Alamance,2023-02-13
16,84,7,77,0,Durham,2022-12-12
16,45,9,36,0,Davidson,2023-02-13
16,57,11,46,0,Alamance,2022-12-13
16,49,11,38,0,Davidson,2022-12-26
16,66,11,55,0,Rowan,2023-01-17
16,86,11,75,0,Union,2022-12-14
16,77,11,66,0,Union,2022-12-29
16,60,12,48,0,Forsyth,2023-03-02
16,39,12,27,0,Gaston,2023-02-03
16,67,13,54,0,Durham,2023-01-16
16,41,13,28,0,Johnston,2023-02-06
16,64,13,51,0,Union,2023-01-05
16,48,14,34,0,Caldwell,2022-12-20
16,86,14,72,0,Guilford,2022-11-21
16,71,16,55,0,Cumberland,2023-02-16
16,61,16,45,0,Davidson,2022-12-15
16,44,17,27,0,Buncombe,2023-02-07
16,78,17,61,0,Forsyth,2022-12-01
16,92,17,75,0,Forsyth,2022-12-07
16,72,17,55,0,Guilford,2022-11-08
16,83,19,64,0,Forsyth,2022-11-28
16,78,19,59,0,Gaston,2022-12-15
16,31,20,11,0,Duplin,2022-12-22
16,68,20,48,0,Surry,2022-12-27
16,43,25,18,0,Halifax,2022-12-27
16,52,25,27,0,Harnett,2023-01-02
16,58,25,33,0,Union,2023-02-01
16,88,27,61,0,Johnston,2022-12-28
16,49,28,21,0,Robeson,2022-12-13
16,53,31,22,0,Gaston,2023-02-20
16,105,34,71,0,Cumberland,2023-01-18
16,134,34,100,0,Wake,2022-11-22
16,61,35,26,0,Randolph,2022-12-21
16,72,41,31,0,Iredell,2022-12-13
16,87,51,36,0,Iredell,2022-12-28
17,52,5,47,0,Union,2023-01-13
17,64,6,58,0,Union,2023-01-18
17,80,7,73,0,Durham,2023-02-08
17,38,9,29,0,Davidson,2023-01-13
17,56,10,46,0,Rowan,2022-12-30
17,85,12,73,0,Wake,2023-03-22
17,86,14,72,0,Durham,2023-01-06
17,115,15,100,0,Durham,2022-12-20
17,55,15,40,0,Mecklenburg,2023-03-16
17,34,16,18,0,Halifax,2023-01-04
17,84,16,68,0,Wake,2023-03-02
17,64,17,47,0,Cumberland,2023-01-27
17,91,17,74,0,Mecklenburg,2023-02-19
17,57,18,39,0,Gaston,2022-12-14
17,57,20,37,0,Pitt,2023-01-05
17,135,20,115,0,Wake,2022-11-08
17,82,21,61,0,Guilford,2023-02-21
17,84,21,63,0,Pitt,2023-01-04
17,77,22,55,0,Mecklenburg,2023-03-10
17,61,23,38,0,Alamance,2022-12-26
17,70,23,47,0,Cabarrus,2023-01-02
17,77,23,54,0,Forsyth,2023-02-14
17,83,23,60,0,Johnston,2022-12-27
17,137,24,113,0,Wake,2022-12-11
17,56,25,31,0,Craven,2022-12-28
17,78,26,52,0,Guilford,2023-02-22
17,60,27,33,0,Randolph,2023-01-03
17,50,28,22,0,Catawba,2022-12-13
17,101,34,67,0,Guilford,2023-01-24
17,72,35,37,0,Buncombe,2022-12-12
17,94,35,59,0,Cumberland,2022-12-15
17,80,55,25,0,Catawba,2022-12-19
17,108,59,49,0,Iredell,2023-01-03
18,68,3,65,0,Durham,2023-02-13
18,44,5,39,0,Durham,2023-01-22
18,48,6,42,0,Alamance,2023-01-12
18,54,7,47,0,Alamance,2022-12-06
18,77,11,66,0,Union,2022-12-20
18,65,13,52,0,Union,2023-01-06
18,69,15,54,0,Cabarrus,2022-12-19
18,85,15,70,0,Union,2022-12-19
18,74,17,57,0,Forsyth,2023-02-02
18,75,17,58,0,Pitt,2022-12-29
18,75,19,56,0,Cabarrus,2022-12-21
18,39,19,20,0,Cabarrus,2023-02-13
18,93,19,74,0,Wake,2023-03-27
18,65,21,44,0,Alamance,2023-01-05
18,50,22,28,0,Gaston,2022-12-18
18,72,22,50,0,Johnston,2022-12-13
18,100,23,77,0,Durham,2023-01-30
18,100,23,77,0,Wake,2023-01-29
18,44,24,20,0,Catawba,2023-01-11
18,81,25,56,0,Cumberland,2023-01-31
18,75,26,49,0,Rowan,2023-01-03
18,52,26,26,0,Surry,2022-12-16
18,55,28,27,0,Catawba,2022-12-12
18,106,28,78,0,Cumberland,2023-02-06
18,89,29,60,0,New Hanover,2023-01-03
18,58,31,27,0,Iredell,2023-01-09
18,117,32,85,0,Guilford,2023-02-07
18,96,33,63,0,Cumberland,2023-01-19
18,51,34,17,0,Robeson,2022-12-22
18,149,36,113,0,Wake,2022-12-02
18,100,37,63,0,Cumberland,2022-12-13
18,54,39,15,0,Catawba,2022-12-23
18,118,42,76,0,Cumberland,2022-12-26
18,64,43,21,0,Catawba,2022-12-22
18,69,45,24,0,Randolph,2022-12-27
18,74,46,28,0,Iredell,2022-12-21
19,75,9,66,0,Mecklenburg,2023-03-20
19,48,11,37,0,Cleveland,2023-01-02
19,86,11,75,0,Durham,2022-12-14
19,94,12,82,0,Wake,2023-02-24
19,73,14,59,0,Durham,2022-12-31
19,39,15,24,0,Robeson,2023-01-12
19,111,16,95,0,Wake,2022-11-09
19,121,17,104,0,Wake,2023-02-27
19,53,18,35,0,Johnston,2022-12-08
19,85,18,67,0,Union,2022-12-22
19,54,20,34,0,Cumberland,2023-02-20
19,89,21,68,0,Gaston,2022-12-28
19,115,22,93,0,Forsyth,2022-12-31
19,74,22,52,0,Gaston,2023-01-03
19,121,22,99,0,Wake,2022-11-25
19,59,23,36,0,Union,2022-12-31
19,89,25,64,0,New Hanover,2022-12-27
19,61,26,35,0,Johnston,2023-01-18
19,101,30,71,0,Cumberland,2023-01-24
19,120,30,90,0,Mecklenburg,2023-02-23
19,133,32,101,0,Mecklenburg,2022-11-14
19,53,34,19,0,Robeson,2022-12-08
19,60,35,25,0,Robeson,2022-12-19
19,76,38,38,0,Buncombe,2022-12-19
19,80,47,33,0,Iredell,2023-01-04
20,61,12,49,0,Pitt,2022-12-19
20,71,14,57,0,Davidson,2022-12-19
20,67,14,53,0,Davidson,2022-12-30
20,109,14,95,0,Mecklenburg,2022-11-09
20,75,15,60,0,Pitt,2022-12-28
20,76,17,59,0,Mecklenburg,2023-03-29
20,84,20,64,0,Guilford,2023-02-14
20,73,20,53,0,Union,2022-12-12
20,65,22,43,0,Johnston,2023-01-05
20,155,22,133,0,Mecklenburg,2022-12-11
20,73,23,50,0,Cabarrus,2022-12-20
20,106,24,82,0,Cumberland,2023-01-26
20,92,26,66,0,Cumberland,2023-02-02
20,105,26,79,0,Forsyth,2023-01-11
20,46,29,17,0,Robeson,2023-01-17
20,47,30,17,0,Moore,2023-01-16
20,61,30,31,0,Robeson,2023-01-04
20,78,30,48,0,Union,2022-12-26
20,51,31,20,0,Robeson,2022-12-12
20,48,34,14,0,Robeson,2022-12-30
20,61,40,21,0,Wayne,2022-12-28
20,148,41,107,0,Guilford,2023-01-02
20,68,43,25,0,Robeson,2022-12-14
20,109,45,64,0,Mecklenburg,2023-02-27
20,74,46,28,0,Randolph,2022-12-28
20,81,50,31,0,Wayne,2023-01-03
21,89,5,84,0,Durham,2023-01-11
21,74,6,68,0,Durham,2023-01-19
21,87,12,75,0,Wake,2023-03-29
21,75,13,62,0,Durham,2023-01-31
21,76,14,62,0,Alamance,2022-12-22
21,59,15,44,0,Pitt,2023-01-30
21,78,16,62,0,Forsyth,2023-02-15
21,77,17,60,0,Gaston,2022-12-07
21,68,17,51,0,Union,2022-12-16
21,102,18,84,0,Durham,2022-12-27
21,73,21,52,0,Gaston,2022-12-12
21,146,23,123,0,Wake,2022-11-23
21,140,24,116,0,Mecklenburg,2022-11-22
21,189,33,156,0,Wake,2022-12-09
21,88,34,54,0,Gaston,2022-12-20
21,78,40,38,0,Cumberland,2022-12-31
21,126,49,77,0,Cumberland,2022-12-14
21,99,54,45,0,Iredell,2022-12-27
21,80,55,25,0,Catawba,2023-01-03
22,68,5,63,0,Wake,2023-03-20
22,81,6,75,0,Durham,2023-01-12
22,124,14,110,0,Mecklenburg,2022-11-08
22,106,15,91,0,Durham,2022-12-21
22,90,17,73,0,Wake,2023-03-07
22,80,20,60,0,Durham,2023-01-27
22,62,21,41,0,Rowan,2022-12-28
22,116,22,94,0,Durham,2022-12-28
22,77,22,55,0,Guilford,2023-02-16
22,76,23,53,0,Davidson,2022-12-20
22,30,24,6,0,Robeson,2023-03-27
22,102,25,77,0,Wake,2023-02-22
22,100,27,73,0,Forsyth,2023-01-17
22,168,31,137,0,Wake,2022-12-24
22,118,42,76,0,Guilford,2023-01-26
23,94,10,84,0,Durham,2023-01-24
23,58,11,47,0,Harnett,2022-12-27
23,71,12,59,0,Davidson,2023-01-05
23,105,16,89,0,Gaston,2022-12-29
23,83,16,67,0,Mecklenburg,2023-03-23
23,86,17,69,0,Wake,2023-03-15
23,93,19,74,0,Mecklenburg,2023-02-28
23,138,19,119,0,Wake,2022-11-14
23,81,22,59,0,Alamance,2022-12-27
23,86,23,63,0,Mecklenburg,2023-03-15
23,91,24,67,0,Cumberland,2023-01-12
23,115,24,91,0,Guilford,2023-01-17
23,117,25,92,0,Cumberland,2023-01-30
23,103,26,77,0,Gaston,2022-12-19
23,103,28,75,0,Guilford,2023-02-13
23,96,29,67,0,Forsyth,2023-01-18
23,101,30,71,0,Forsyth,2023-02-06
23,110,31,79,0,Cumberland,2023-01-23
23,75,31,44,0,Johnston,2022-12-12
23,94,36,58,0,Cumberland,2022-12-08
23,63,37,26,0,Robeson,2022-12-21
23,59,38,21,0,Robeson,2022-12-20
23,98,40,58,0,Cabarrus,2022-12-29
23,149,42,107,0,Guilford,2022-12-13
23,160,51,109,0,Guilford,2022-12-16
23,119,65,54,0,Buncombe,2022-12-27
24,79,11,68,0,Onslow,2023-01-04
24,117,12,105,0,Mecklenburg,2022-11-27
24,86,14,72,0,Davidson,2023-01-02
24,114,16,98,0,Wake,2023-02-10
24,74,21,53,0,Forsyth,2023-02-09
24,140,22,118,0,Durham,2023-01-04
24,84,24,60,0,New Hanover,2023-01-04
24,132,26,106,0,Durham,2023-01-02
24,132,26,106,0,Forsyth,2022-12-23
24,115,31,84,0,Mecklenburg,2023-01-29
24,114,32,82,0,Forsyth,2023-01-25
24,97,33,64,0,Cumberland,2022-12-05
24,65,37,28,0,Robeson,2023-01-03
24,77,41,36,0,Robeson,2022-12-27
24,153,50,103,0,Mecklenburg,2023-01-08
24,83,55,28,0,Iredell,2022-12-29
24,103,68,35,0,Catawba,2022-12-28
25,112,16,96,0,Wake,2022-11-27
25,79,19,60,0,Pitt,2023-01-03
25,85,20,65,0,Davidson,2022-12-21
25,129,25,104,0,Mecklenburg,2023-01-14
25,85,30,55,0,Davidson,2022-12-22
25,106,32,74,0,Cumberland,2022-12-12
25,81,33,48,0,Johnston,2023-01-02
25,70,37,33,0,Randolph,2023-01-02
25,155,46,109,0,Cumberland,2023-01-17
25,138,50,88,0,Forsyth,2022-12-26
25,97,59,38,0,Catawba,2022-12-27
25,145,61,84,0,Cumberland,2022-12-21
26,69,8,61,0,Union,2022-12-13
26,95,15,80,0,Alamance,2022-12-28
26,83,15,68,0,Alamance,2023-01-03
26,128,16,112,0,Wake,2022-11-21
26,101,16,85,0,Wake,2023-01-22
26,137,25,112,0,Wake,2023-01-27
26,113,30,83,0,Forsyth,2022-12-13
26,97,34,63,0,Durham,2023-01-23
26,155,37,118,0,Cumberland,2023-01-05
26,137,43,94,0,Wake,2023-02-17
26,149,62,87,0,Cumberland,2022-12-22
26,182,64,118,0,Guilford,2022-12-30
27,96,3,93,0,Durham,2023-01-17
27,112,14,98,0,Forsyth,2022-12-06
27,89,16,73,0,Union,2023-01-04
27,84,22,62,0,Johnston,2022-12-26
27,129,30,99,0,Forsyth,2023-01-30
27,99,32,67,0,Guilford,2022-12-01
28,104,20,84,0,Durham,2023-01-18
28,144,26,118,0,Forsyth,2023-01-09
28,120,31,89,0,Johnston,2023-01-03
28,160,33,127,0,Forsyth,2022-12-20
28,164,35,129,0,Mecklenburg,2022-12-04
28,153,42,111,0,Mecklenburg,2023-02-16
28,143,54,89,0,Guilford,2023-01-31
29,97,18,79,0,Union,2022-12-28
29,121,20,101,0,Wake,2022-11-26
29,96,30,66,0,Forsyth,2022-12-14
29,113,37,76,0,Guilford,2022-12-05
29,156,37,119,0,Wake,2023-02-13
29,157,49,108,0,Cumberland,2022-12-30
30,96,18,78,0,Davidson,2022-12-29
30,137,19,118,0,Mecklenburg,2023-02-17
30,111,25,86,0,Union,2022-12-21
30,140,26,114,0,Wake,2023-02-16
30,107,33,74,0,Davidson,2022-12-27
30,159,35,124,0,Forsyth,2022-12-22
30,163,37,126,0,Mecklenburg,2023-02-14
30,134,37,97,0,Wake,2023-02-21
30,153,49,104,0,Cumberland,2022-12-29
30,191,49,142,0,Wake,2023-01-31
31,123,27,96,0,Guilford,2023-01-12
31,104,32,72,0,Forsyth,2022-12-08
31,136,40,96,0,Forsyth,2022-12-12
32,109,20,89,0,Mecklenburg,2023-02-24
32,220,27,193,0,Wake,2022-12-17
32,164,36,128,0,Wake,2023-02-09
32,69,39,30,0,Robeson,2022-12-29
32,131,44,87,0,Gaston,2022-12-27
32,129,59,70,0,Cumberland,2022-12-20
33,121,23,98,0,Wake,2023-01-21
33,130,24,106,0,Wake,2023-02-14
33,167,34,133,0,Forsyth,2022-12-21
33,140,36,104,0,Mecklenburg,2023-02-20
33,173,45,128,0,Wake,2023-01-26
33,168,46,122,0,Cumberland,2022-12-28
33,198,47,151,0,Wake,2022-12-06
33,153,52,101,0,Wake,2023-01-01
34,141,26,115,0,Wake,2023-02-15
35,174,11,163,0,Wake,2023-01-19
35,210,27,183,0,Wake,2022-11-29
35,211,52,159,0,Wake,2022-12-05
36,167,27,140,0,Wake,2023-01-16
36,132,40,92,0,Guilford,2023-02-06
36,172,40,132,0,Mecklenburg,2023-02-08
36,167,41,126,0,Mecklenburg,2023-02-15
36,155,42,113,0,Mecklenburg,2023-02-10
37,175,41,134,0,Wake,2023-02-06
37,133,53,80,0,Cumberland,2022-12-19
39,233,42,191,0,Mecklenburg,2023-01-19
39,211,61,150,0,Guilford,2022-12-28
39,217,62,155,0,Mecklenburg,2023-01-16
40,154,23,131,0,Wake,2023-02-08
40,176,49,127,0,Guilford,2022-12-23
41,222,33,189,0,Wake,2022-12-07
41,171,35,136,0,Wake,2023-02-07
41,164,41,123,0,Wake,2023-01-25
42,146,30,116,0,Forsyth,2023-01-02
42,176,42,134,0,Wake,2022-12-18
43,215,48,167,0,Mecklenburg,2022-12-17
44,287,55,232,0,Wake,2023-01-05
45,251,41,210,0,Wake,2022-12-13
45,265,44,221,0,Wake,2022-12-16
45,185,59,126,0,Guilford,2022-12-27
47,279,48,231,0,Wake,2022-12-15
48,231,35,196,0,Wake,2023-01-11
49,224,63,161,0,Forsyth,2022-12-28
51,234,44,190,0,Wake,2023-01-10
52,296,54,242,0,Mecklenburg,2022-12-05
53,243,57,186,0,Wake,2022-12-31
53,308,70,238,0,Mecklenburg,2022-12-15
54,275,50,225,0,Wake,2022-12-14
54,286,52,234,0,Mecklenburg,2022-11-28
54,335,68,267,0,Mecklenburg,2023-01-06
57,214,42,172,0,Mecklenburg,2023-02-01
57,334,57,277,0,Mecklenburg,2022-12-12
59,327,53,274,0,Mecklenburg,2022-12-13
62,343,57,286,0,Wake,2022-12-19
62,298,65,233,0,Mecklenburg,2023-01-17
62,349,74,275,0,Wake,2022-12-22
65,363,68,295,0,Mecklenburg,2022-12-19
66,317,71,246,0,Mecklenburg,2022-12-23
68,406,59,347,0,Wake,2023-01-04
70,234,53,181,0,Mecklenburg,2023-01-26
72,359,62,297,0,Mecklenburg,2022-12-14
72,354,72,282,0,Wake,2022-12-30
73,425,91,334,0,Mecklenburg,2022-12-27
74,357,83,274,0,Mecklenburg,2023-01-02
79,385,79,306,0,Wake,2022-12-29
81,425,77,348,0,Wake,2022-12-28
81,414,90,324,0,Mecklenburg,2022-12-28
84,436,73,363,0,Wake,2023-01-03
85,439,84,355,0,Mecklenburg,2022-12-21
,0,0,0,1,Alexander,2023-04-30
,0,0,0,1,Alleghany,2023-02-24
,0,0,0,1,Alleghany,2023-04-04
,0,0,0,1,Anson,2023-02-05
,0,0,0,1,Ashe,2023-01-12
,0,0,0,1,Beaufort,2022-11-20
,0,0,0,1,Chowan,2023-04-01
,0,0,0,1,Clay,2023-03-04
,0,0,0,1,Columbus,2023-04-17
,0,0,0,1,Edgecombe,2022-11-13
,0,0,0,1,Gates,2023-02-04
,0,0,0,1,Greene,2023-03-19
,0,0,0,1,Halifax,2023-03-31
,0,0,0,1,Haywood,2023-02-18
,0,0,0,1,Lenoir,2022-11-18
,0,0,0,1,Madison,2022-11-18
,0,0,0,1,Madison,2023-01-14
,0,0,0,1,Madison,2023-04-09
,0,0,0,1,Mitchell,2023-01-16
,0,0,0,1,Montgomery,2023-04-21
,0,0,0,1,Nash,2023-03-23
,0,0,0,1,Northampton,2023-01-21
,0,0,0,1,Perquimans,2023-01-21
,0,0,0,1,Richmond,2023-03-30
,0,0,0,1,Stokes,2023-04-09
,0,0,0,1,Tyrrell,2023-02-20
,0,0,0,1,Washington,2023-01-15
,0,0,0,1,Washington,2023-03-25
,0,0,0,1,Washington,2023-04-10
0,3,0,3,1,Anson,2022-12-17
0,1,0,1,1,Ashe,2022-12-31
0,1,0,1,1,Ashe,2023-03-19
0,1,0,1,1,Avery,2023-01-15
0,3,0,3,1,Caldwell,2023-03-12
0,1,0,1,1,Carteret,2022-11-27
0,5,0,5,1,Caswell,2023-02-02
0,1,0,1,1,Cherokee,2023-02-05
0,4,0,4,1,Columbus,2022-12-10
0,3,0,3,1,Craven,2023-03-09
0,2,0,2,1,Craven,2023-04-12
0,4,0,4,1,Cumberland,2023-04-02
0,3,0,3,1,Dare,2022-12-12
0,3,0,3,1,Davie,2022-11-23
0,1,0,1,1,Duplin,2023-01-21
0,2,0,2,1,Edgecombe,2023-03-13
0,1,0,1,1,Franklin,2023-03-12
0,1,0,1,1,Halifax,2023-04-15
0,2,0,2,1,Hertford,2023-01-01
0,1,0,1,1,Hoke,2023-04-02
0,2,0,2,1,Lee,2023-02-11
0,2,0,2,1,Macon,2023-01-16
0,1,0,1,1,Martin,2023-03-02
0,1,0,1,1,Montgomery,2022-11-22
0,1,0,1,1,Moore,2023-03-30
0,2,0,2,1,New Hanover,2023-04-01
0,1,0,1,1,Northampton,2023-04-05
0,3,0,3,1,Pasquotank,2022-11-13
0,4,0,4,1,Pender,2023-01-21
0,5,0,5,1,Pender,2023-01-29
0,1,0,1,1,Person,2022-11-19
0,2,0,2,1,Person,2023-03-20
0,3,0,3,1,Pitt,2023-04-02
0,2,0,2,1,Polk,2023-01-12
0,3,0,3,1,Richmond,2023-02-04
0,2,0,2,1,Richmond,2023-03-09
0,1,0,1,1,Rockingham,2023-03-31
0,4,0,4,1,Rutherford,2023-02-15
0,3,0,3,1,Watauga,2023-04-19
0,3,0,3,1,Wilson,2023-01-15
0,3,0,3,1,Yadkin,2022-11-15
0,6,0,6,1,Yadkin,2022-11-27
0,4,0,4,1,Yadkin,2023-01-22
0,1,1,0,1,Alexander,2023-04-08
0,1,1,0,1,Alleghany,2023-01-14
0,6,1,5,1,Ashe,2023-01-07
0,4,1,3,1,Brunswick,2023-02-19
0,5,1,4,1,Brunswick,2023-04-13
0,4,1,3,1,Caldwell,2023-03-11
0,3,1,2,1,Carteret,2022-11-25
0,3,1,2,1,Carteret,2023-01-28
0,2,1,1,1,Caswell,2022-11-14
0,4,1,3,1,Craven,2023-02-04
0,5,1,4,1,Craven,2023-04-11
0,4,1,3,1,Davidson,2023-03-25
0,1,1,0,1,Davie,2023-03-18
0,3,1,2,1,Duplin,2023-02-11
0,6,1,5,1,Gaston,2023-04-15
0,2,1,1,1,Granville,2023-03-13
0,1,1,0,1,Greene,2023-01-04
0,1,1,0,1,Halifax,2022-11-13
0,5,1,4,1,Haywood,2023-02-11
0,5,1,4,1,Henderson,2023-04-11
0,3,1,2,1,Hoke,2022-12-25
0,4,1,3,1,Iredell,2022-11-19
0,2,1,1,1,Lee,2023-03-05
0,4,1,3,1,Lee,2023-03-26
0,1,1,0,1,Lenoir,2022-11-24
0,1,1,0,1,Madison,2022-12-01
0,2,1,1,1,Madison,2023-02-01
0,1,1,0,1,Madison,2023-02-23
0,6,1,5,1,McDowell,2022-11-13
0,1,1,0,1,Moore,2023-04-09
0,3,1,2,1,Moore,2023-04-20
0,6,1,5,1,Nash,2022-11-17
0,2,1,1,1,New Hanover,2023-04-15
0,3,1,2,1,Person,2022-11-20
0,2,1,1,1,Richmond,2023-03-22
0,3,1,2,1,Rockingham,2023-03-19
0,4,1,3,1,Rockingham,2023-04-16
0,2,1,1,1,Rutherford,2023-02-27
0,1,1,0,1,Rutherford,2023-03-09
0,1,1,0,1,Surry,2023-03-26
0,3,2,1,1,Alexander,2023-02-23
0,3,2,1,1,Alleghany,2023-01-02
0,6,2,4,1,Beaufort,2023-02-02
0,8,2,6,1,Caldwell,2022-11-11
0,2,2,0,1,Carteret,2023-02-20
0,2,2,0,1,Catawba,2023-04-08
0,5,2,3,1,Cleveland,2023-03-08
0,7,2,5,1,Franklin,2023-01-15
0,7,2,5,1,Harnett,2023-03-07
0,5,2,3,1,Henderson,2023-03-09
0,4,2,2,1,Iredell,2023-04-09
0,10,2,8,1,New Hanover,2023-02-04
0,5,2,3,1,New Hanover,2023-03-18
0,2,2,0,1,Pender,2023-03-21
0,2,2,0,1,Person,2023-02-25
0,12,2,10,1,Pitt,2022-12-17
0,12,2,10,1,Pitt,2023-01-15
0,3,2,1,1,Polk,2023-01-31
0,5,2,3,1,Randolph,2023-03-25
0,6,2,4,1,Stokes,2023-01-14
0,13,3,10,1,Caldwell,2022-12-24
0,6,3,3,1,Caswell,2022-12-29
0,14,3,11,1,Guilford,2023-03-04
0,8,3,5,1,Onslow,2022-11-14
0,4,3,1,1,Warren,2022-12-31
0,10,3,7,1,Wilkes,2023-02-12
0,5,3,2,1,Wilson,2022-11-25
0,4,3,1,1,Wilson,2023-03-04
0,13,4,9,1,Burke,2022-11-18
0,7,4,3,1,Cabarrus,2023-04-15
0,8,4,4,1,Carteret,2023-01-15
0,11,4,7,1,Johnston,2023-03-28
0,9,4,5,1,New Hanover,2022-11-17
0,11,5,6,1,Moore,2023-01-14
0,13,7,6,1,Buncombe,2022-11-24
0,12,8,4,1,Buncombe,2023-04-09
0,12,8,4,1,Wilkes,2022-12-10
1,3,0,3,1,Anson,2023-02-12
1,2,0,2,1,Bladen,2023-02-11
1,3,0,3,1,Caldwell,2023-03-18
1,1,0,1,1,Carteret,2023-01-14
1,3,0,3,1,Chatham,2023-03-25
1,3,0,3,1,Columbus,2023-04-02
1,1,0,1,1,Craven,2022-11-13
1,10,0,10,1,Craven,2023-01-22
1,1,0,1,1,Hertford,2023-01-31
1,8,0,8,1,Hoke,2022-11-30
1,6,0,6,1,Hoke,2023-02-24
1,2,0,2,1,Hoke,2023-03-10
1,2,0,2,1,Lee,2023-04-01
1,2,0,2,1,Lenoir,2023-01-21
1,1,0,1,1,Madison,2022-12-12
1,1,0,1,1,Northampton,2023-03-04
1,9,0,9,1,Onslow,2023-03-03
1,4,0,4,1,Onslow,2023-04-07
1,2,0,2,1,Person,2022-11-17
1,5,0,5,1,Richmond,2023-03-03
1,1,0,1,1,Rutherford,2023-02-20
1,1,0,1,1,Rutherford,2023-03-30
1,2,0,2,1,Surry,2022-11-27
1,2,0,2,1,Surry,2023-03-19
1,2,0,2,1,Surry,2023-04-14
1,3,0,3,1,Transylvania,2023-01-22
1,2,0,2,1,Vance,2023-03-04
1,2,0,2,1,Washington,2023-01-22
1,2,0,2,1,Yancey,2022-12-21
1,3,0,3,1,Yancey,2023-01-20
1,14,1,13,1,Alamance,2023-02-19
1,7,1,6,1,Alamance,2023-03-04
1,5,1,4,1,Alexander,2022-11-21
1,10,1,9,1,Anson,2023-01-18
1,7,1,6,1,Caldwell,2022-11-20
1,8,1,7,1,Cleveland,2022-11-16
1,5,1,4,1,Cleveland,2023-03-02
1,7,1,6,1,Edgecombe,2023-01-25
1,3,1,2,1,Gaston,2023-04-06
1,2,1,1,1,Halifax,2023-01-28
1,5,1,4,1,Haywood,2023-02-03
1,7,1,6,1,Johnston,2022-11-13
1,4,1,3,1,Johnston,2023-03-05
1,4,1,3,1,Lenoir,2023-01-08
1,4,1,3,1,Lincoln,2023-03-02
1,5,1,4,1,Lincoln,2023-03-23
1,3,1,2,1,Martin,2023-01-19
1,4,1,3,1,McDowell,2023-04-04
1,1,1,0,1,Montgomery,2023-03-18
1,8,1,7,1,Moore,2023-02-10
1,3,1,2,1,Nash,2023-03-05
1,1,1,0,1,Northampton,2023-03-09
1,9,1,8,1,Onslow,2023-02-11
1,3,1,2,1,Pitt,2023-04-26
1,4,1,3,1,Robeson,2023-04-07
1,3,1,2,1,Rockingham,2023-04-15
1,5,1,4,1,Rowan,2023-04-07
1,5,1,4,1,Rutherford,2023-01-19
1,10,1,9,1,Stokes,2023-02-01
1,3,1,2,1,Vance,2023-03-18
1,6,1,5,1,Wayne,2023-04-02
1,8,1,7,1,Wilkes,2023-01-15
1,5,1,4,1,Wilson,2022-11-21
1,6,1,5,1,Yadkin,2022-11-16
1,9,2,7,1,Brunswick,2022-12-25
1,6,2,4,1,Brunswick,2023-02-25
1,7,2,5,1,Cabarrus,2023-04-03
1,7,2,5,1,Carteret,2022-12-10
1,12,2,10,1,Forsyth,2023-04-02
1,5,2,3,1,Granville,2023-02-28
1,8,2,6,1,Lenoir,2022-11-14
1,11,2,9,1,McDowell,2022-11-08
1,8,2,6,1,McDowell,2023-01-23
1,14,2,12,1,Moore,2022-12-07
1,9,2,7,1,Northampton,2023-01-20
1,7,2,5,1,Orange,2023-03-11
1,4,2,2,1,Pamlico,2022-12-08
1,7,2,5,1,Pitt,2023-01-21
1,6,2,4,1,Pitt,2023-03-27
1,7,2,5,1,Randolph,2022-11-19
1,4,2,2,1,Richmond,2023-03-08
1,4,2,2,1,Sampson,2023-03-15
1,8,2,6,1,Surry,2023-01-29
1,21,2,19,1,Wake,2022-11-24
1,6,2,4,1,Wilson,2022-11-10
1,2,2,0,1,Yancey,2022-11-21
1,7,3,4,1,Chatham,2022-11-22
1,5,3,2,1,Davie,2023-02-08
1,5,3,2,1,Haywood,2022-12-16
1,9,3,6,1,Henderson,2023-02-20
1,5,3,2,1,Jackson,2023-04-12
1,11,3,8,1,Macon,2022-12-15
1,3,3,0,1,Montgomery,2023-01-07
1,12,3,9,1,Nash,2022-12-17
1,8,3,5,1,Pender,2023-02-13
1,9,3,6,1,Rockingham,2022-11-14
1,14,3,11,1,Stokes,2023-02-06
1,9,3,6,1,Stokes,2023-02-08
1,6,3,3,1,Wilkes,2023-01-21
1,8,3,5,1,Wilkes,2023-03-13
1,8,4,4,1,Buncombe,2023-03-11
1,9,4,5,1,Buncombe,2023-03-31
1,8,4,4,1,Caldwell,2023-03-15
1,10,4,6,1,Carteret,2022-12-18
1,13,4,9,1,Cleveland,2022-12-03
1,7,4,3,1,Craven,2022-11-22
1,11,4,7,1,Davidson,2022-11-15
1,21,4,17,1,Moore,2023-01-21
1,10,4,6,1,Pasquotank,2022-12-02
1,16,4,12,1,Randolph,2022-12-25
1,4,4,0,1,Stokes,2022-11-27
1,8,5,3,1,Bertie,2022-12-29
1,17,5,12,1,Buncombe,2022-11-20
1,14,5,9,1,Columbus,2023-01-16
1,14,5,9,1,Rockingham,2023-01-08
1,12,5,7,1,Rockingham,2023-02-02
1,11,5,6,1,Rockingham,2023-03-01
1,10,6,4,1,Burke,2023-01-16
1,7,6,1,1,Columbus,2022-11-14
1,15,7,8,1,Buncombe,2022-11-26
1,29,7,22,1,Gaston,2022-12-03
1,13,7,6,1,Jackson,2022-12-30
1,14,8,6,1,Henderson,2022-11-25
1,26,8,18,1,New Hanover,2023-01-07
1,37,10,27,1,Henderson,2022-12-20
1,22,11,11,1,Haywood,2023-01-11
1,29,12,17,1,Henderson,2023-01-08
2,6,0,6,1,Alexander,2022-12-08
2,7,0,7,1,Beaufort,2022-12-17
2,4,0,4,1,Beaufort,2023-02-05
2,8,0,8,1,Caldwell,2023-02-26
2,6,0,6,1,Dare,2023-02-03
2,7,0,7,1,Duplin,2023-01-28
2,8,0,8,1,Edgecombe,2023-02-19
2,12,0,12,1,Halifax,2023-01-13
2,2,0,2,1,Madison,2023-01-17
2,3,0,3,1,Martin,2022-12-31
2,9,0,9,1,Onslow,2023-03-17
2,4,0,4,1,Pender,2023-02-14
2,7,0,7,1,Richmond,2022-12-18
2,13,0,13,1,Stanly,2023-01-15
2,6,0,6,1,Surry,2023-03-29
2,14,0,14,1,Union,2023-04-12
2,5,0,5,1,Washington,2023-02-07
2,7,1,6,1,Alexander,2022-12-06
2,4,1,3,1,Bladen,2022-12-14
2,7,1,6,1,Dare,2023-02-10
2,10,1,9,1,Davidson,2022-12-04
2,23,1,22,1,Edgecombe,2023-01-06
2,4,1,3,1,Gaston,2023-04-22
2,4,1,3,1,Henderson,2023-02-28
2,7,1,6,1,Lee,2023-02-10
2,4,1,3,1,Montgomery,2023-02-14
2,12,1,11,1,Pender,2023-01-03
2,3,1,2,1,Polk,2023-01-23
2,6,1,5,1,Rowan,2023-03-10
2,7,1,6,1,Rutherford,2022-11-25
2,4,1,3,1,Surry,2022-11-24
2,17,2,15,1,Beaufort,2022-12-20
2,12,2,10,1,Brunswick,2022-11-08
2,5,2,3,1,Caldwell,2023-03-21
2,12,2,10,1,Chatham,2022-12-11
2,5,2,3,1,Cleveland,2022-11-20
2,19,2,17,1,Cleveland,2023-01-01
2,8,2,6,1,Cleveland,2023-01-07
2,7,2,5,1,Columbus,2023-01-23
2,5,2,3,1,Columbus,2023-02-11
2,2,2,0,1,Duplin,2022-11-08
2,6,2,4,1,Haywood,2023-01-15
2,21,2,19,1,Johnston,2022-11-25
2,3,2,1,1,Lenoir,2023-04-03
2,7,2,5,1,Montgomery,2023-01-01
2,4,2,2,1,Montgomery,2023-01-08
2,5,2,3,1,Northampton,2023-02-03
2,14,2,12,1,Orange,2022-12-25
2,9,2,7,1,Person,2022-12-22
2,8,2,6,1,Pitt,2023-03-05
2,12,2,10,1,Rowan,2022-12-25
2,18,2,16,1,Rowan,2023-01-07
2,9,2,7,1,Rowan,2023-03-06
2,11,2,9,1,Rutherford,2022-12-12
2,5,2,3,1,Sampson,2023-03-22
2,2,2,0,1,Stokes,2023-01-15
2,3,2,1,1,Wilkes,2023-03-15
2,23,3,20,1,Cabarrus,2022-12-10
2,6,3,3,1,Cabarrus,2023-03-18
2,5,3,2,1,Catawba,2023-04-30
2,12,3,9,1,Chatham,2022-12-26
2,6,3,3,1,Craven,2023-02-12
2,12,3,9,1,Craven,2023-02-15
2,12,3,9,1,Franklin,2023-02-22
2,8,3,5,1,Gaston,2023-03-12
2,9,3,6,1,Granville,2022-12-11
2,6,3,3,1,Halifax,2023-02-12
2,13,3,10,1,Haywood,2023-01-07
2,17,3,14,1,Hoke,2022-11-28
2,10,3,7,1,Hoke,2023-01-31
2,10,3,7,1,Lincoln,2023-02-22
2,13,3,10,1,Moore,2022-11-08
2,12,3,9,1,Moore,2022-11-21
2,13,3,10,1,Pitt,2022-11-17
2,18,3,15,1,Rockingham,2023-01-30
2,7,3,4,1,Union,2023-04-08
2,6,3,3,1,Wilson,2023-03-26
2,9,4,5,1,Craven,2022-11-25
2,13,4,9,1,Craven,2022-12-02
2,8,4,4,1,Harnett,2022-12-11
2,7,4,3,1,Harnett,2023-03-16
2,13,4,9,1,Lincoln,2023-02-01
2,5,4,1,1,Moore,2022-11-26
2,12,4,8,1,Moore,2022-12-25
2,17,4,13,1,New Hanover,2023-02-27
2,7,4,3,1,New Hanover,2023-05-01
2,6,4,2,1,Robeson,2023-04-15
2,10,4,6,1,Rowan,2023-03-22
2,7,4,3,1,Rutherford,2022-11-14
2,7,4,3,1,Sampson,2022-12-01
2,6,4,2,1,Scotland,2023-02-28
2,6,4,2,1,Stokes,2023-01-29
2,9,4,5,1,Wilkes,2023-02-01
2,10,4,6,1,Wilson,2023-01-08
2,8,4,4,1,Wilson,2023-03-06
2,16,5,11,1,Buncombe,2022-12-04
2,11,5,6,1,Haywood,2022-12-30
2,9,5,4,1,New Hanover,2023-02-26
2,14,5,9,1,Pitt,2023-03-08
2,9,5,4,1,Randolph,2023-02-26
2,9,5,4,1,Rockingham,2023-02-19
2,29,5,24,1,Rowan,2023-02-03
2,22,6,16,1,Brunswick,2022-12-17
2,13,6,7,1,Gaston,2023-03-23
2,12,6,6,1,Gaston,2023-03-26
2,40,6,34,1,Mecklenburg,2022-11-24
2,13,6,7,1,Robeson,2022-12-04
2,27,7,20,1,Buncombe,2022-11-23
2,16,7,9,1,New Hanover,2023-02-12
2,7,7,0,1,Sampson,2023-01-21
2,20,8,12,1,Buncombe,2023-03-08
2,20,8,12,1,Davidson,2023-03-01
2,19,8,11,1,Nash,2023-02-15
2,15,8,7,1,Randolph,2023-02-23
2,22,10,12,1,Henderson,2023-02-08
2,21,10,11,1,Randolph,2023-01-30
2,18,11,7,1,Buncombe,2023-03-01
2,16,11,5,1,Randolph,2022-11-14
2,26,12,14,1,Cabarrus,2023-01-22
2,17,12,5,1,Wilkes,2023-01-10
2,38,19,19,1,Wayne,2023-01-13
3,5,0,5,1,Cleveland,2023-03-13
3,15,0,15,1,Davidson,2022-11-22
3,17,0,17,1,Durham,2023-03-05
3,14,0,14,1,Forsyth,2022-11-24
3,11,0,11,1,Forsyth,2023-04-23
3,12,0,12,1,Montgomery,2022-11-16
3,6,0,6,1,Richmond,2023-01-29
3,14,0,14,1,Stanly,2022-12-31
3,4,0,4,1,Stanly,2023-04-12
3,9,0,9,1,Union,2023-04-30
3,8,0,8,1,Yadkin,2023-02-15
3,11,1,10,1,Alamance,2023-02-18
3,7,1,6,1,Davidson,2022-11-12
3,7,1,6,1,Franklin,2023-02-13
3,12,1,11,1,Harnett,2022-11-26
3,13,1,12,1,Harnett,2023-01-08
3,4,1,3,1,Hoke,2023-02-26
3,10,1,9,1,Rockingham,2023-03-10
3,11,1,10,1,Rowan,2022-11-27
3,9,1,8,1,Rowan,2023-03-01
3,4,1,3,1,Surry,2023-03-15
3,5,1,4,1,Vance,2023-01-27
3,5,1,4,1,Washington,2023-01-05
3,15,2,13,1,Alamance,2022-11-08
3,8,2,6,1,Anson,2022-12-20
3,15,2,13,1,Bladen,2023-01-02
3,15,2,13,1,Brunswick,2022-12-11
3,12,2,10,1,Cabarrus,2022-11-13
3,3,2,1,1,Caldwell,2023-03-24
3,19,2,17,1,Craven,2023-01-10
3,17,2,15,1,Davidson,2022-11-17
3,12,2,10,1,Guilford,2023-04-01
3,12,2,10,1,Harnett,2022-11-21
3,5,2,3,1,Haywood,2023-01-08
3,11,2,9,1,Nash,2022-12-08
3,4,2,2,1,Rutherford,2022-11-15
3,7,2,5,1,Stokes,2023-01-11
3,7,2,5,1,Surry,2023-02-05
3,7,2,5,1,Vance,2023-04-04
3,5,3,2,1,Bladen,2022-11-08
3,15,3,12,1,Caldwell,2022-11-30
3,14,3,11,1,Caldwell,2023-01-28
3,12,3,9,1,Davidson,2023-03-13
3,13,3,10,1,Edgecombe,2023-01-30
3,8,3,5,1,New Hanover,2023-04-20
3,12,3,9,1,Rowan,2022-11-18
3,16,3,13,1,Surry,2023-01-31
3,20,3,17,1,Vance,2023-01-05
3,18,4,14,1,Caldwell,2023-02-07
3,19,4,15,1,Cleveland,2023-01-10
3,9,4,5,1,Columbus,2023-02-15
3,11,4,7,1,Halifax,2023-02-15
3,6,4,2,1,Montgomery,2023-01-09
3,39,4,35,1,Orange,2022-12-15
3,18,4,14,1,Pender,2023-01-24
3,10,4,6,1,Washington,2022-12-30
3,12,4,8,1,Wilson,2023-02-27
3,30,5,25,1,Brunswick,2022-12-06
3,7,5,2,1,Buncombe,2023-03-05
3,11,5,6,1,Buncombe,2023-03-15
3,7,5,2,1,Buncombe,2023-04-30
3,15,5,10,1,Catawba,2023-03-07
3,8,5,3,1,Catawba,2023-03-29
3,14,5,9,1,Craven,2023-01-18
3,7,5,2,1,Davie,2022-11-22
3,22,5,17,1,Onslow,2022-12-09
3,14,5,9,1,Onslow,2023-01-28
3,9,5,4,1,Robeson,2022-11-17
3,15,5,10,1,Rockingham,2023-01-22
3,8,5,3,1,Wilkes,2022-11-14
3,8,5,3,1,Wilkes,2023-01-08
3,15,6,9,1,Brunswick,2023-03-17
3,10,6,4,1,Buncombe,2023-02-26
3,37,6,31,1,Burke,2022-12-28
3,12,6,6,1,Cleveland,2022-12-10
3,19,6,13,1,Craven,2023-01-24
3,12,6,6,1,Forsyth,2023-04-15
3,25,6,19,1,Guilford,2023-03-08
3,23,6,17,1,Guilford,2023-03-20
3,9,6,3,1,Haywood,2023-02-06
3,15,6,9,1,Pitt,2023-02-25
3,12,7,5,1,Burke,2023-01-08
3,30,7,23,1,Henderson,2022-11-09
3,21,7,14,1,Randolph,2023-01-08
3,11,7,4,1,Randolph,2023-03-13
3,18,7,11,1,Rockingham,2022-12-13
3,14,7,7,1,Wilkes,2022-11-28
3,23,8,15,1,Buncombe,2022-11-10
3,26,8,18,1,Durham,2023-03-30
3,20,8,12,1,Harnett,2022-12-25
3,16,8,8,1,Henderson,2023-02-13
3,14,9,5,1,Haywood,2023-01-25
3,14,9,5,1,Iredell,2023-03-06
3,20,9,11,1,New Hanover,2022-12-05
3,19,9,10,1,Randolph,2023-01-13
3,21,9,12,1,Robeson,2023-01-20
3,11,9,2,1,Sampson,2023-01-16
3,14,9,5,1,Wayne,2023-03-10
3,24,10,14,1,Chatham,2023-01-02
3,21,11,10,1,Granville,2023-01-12
3,17,11,6,1,Lenoir,2023-02-12
3,34,13,21,1,Iredell,2023-02-10
3,32,14,18,1,Craven,2022-12-26
3,36,17,19,1,Buncombe,2022-11-15
3,28,18,10,1,Carteret,2023-01-04
3,25,18,7,1,Scotland,2023-01-03
4,27,0,27,1,Edgecombe,2022-12-27
4,4,0,4,1,Halifax,2023-01-14
4,21,1,20,1,Edgecombe,2023-01-05
4,18,1,17,1,Franklin,2022-12-19
4,14,1,13,1,Harnett,2022-11-17
4,12,1,11,1,Lenoir,2023-01-11
4,10,1,9,1,Moore,2023-01-20
4,17,1,16,1,Orange,2022-12-24
4,19,1,18,1,Rowan,2023-02-17
4,7,1,6,1,Yadkin,2023-02-10
4,13,2,11,1,Burke,2022-12-17
4,7,2,5,1,Guilford,2023-04-02
4,15,2,13,1,Harnett,2023-01-14
4,13,2,11,1,Harnett,2023-02-17
4,19,2,17,1,Johnston,2022-11-16
4,8,2,6,1,Lenoir,2023-02-28
4,10,2,8,1,Onslow,2022-12-11
4,18,2,16,1,Onslow,2023-03-27
4,10,2,8,1,Pitt,2023-01-22
4,14,2,12,1,Surry,2022-11-08
4,8,3,5,1,Brunswick,2023-02-03
4,14,3,11,1,Cleveland,2023-02-10
4,6,3,3,1,Columbus,2022-11-10
4,23,3,20,1,Columbus,2022-12-29
4,23,3,20,1,Gaston,2023-02-10
4,8,3,5,1,Jackson,2023-01-04
4,27,3,24,1,Johnston,2022-11-08
4,9,3,6,1,Montgomery,2022-12-23
4,9,3,6,1,Nash,2023-03-07
4,12,3,9,1,Rowan,2023-03-03
4,15,3,12,1,Surry,2022-12-11
4,17,4,13,1,Brunswick,2023-01-15
4,15,4,11,1,Chatham,2023-01-23
4,14,4,10,1,Chatham,2023-02-09
4,7,4,3,1,Harnett,2022-11-20
4,10,4,6,1,Richmond,2023-02-09
4,20,4,16,1,Rowan,2022-12-02
4,6,4,2,1,Scotland,2023-03-05
4,9,4,5,1,Stokes,2023-02-03
4,10,5,5,1,Beaufort,2022-12-14
4,19,5,14,1,Craven,2022-12-16
4,11,5,6,1,Forsyth,2023-04-22
4,18,5,13,1,Guilford,2023-04-03
4,17,5,12,1,Lee,2023-01-02
4,7,5,2,1,Macon,2023-01-04
4,13,5,8,1,McDowell,2022-12-21
4,15,5,10,1,Nash,2023-01-01
4,12,5,7,1,Nash,2023-01-24
4,10,5,5,1,Nash,2023-03-10
4,14,5,9,1,Richmond,2022-12-17
4,15,5,10,1,Union,2022-11-19
4,20,6,14,1,Davidson,2022-11-27
4,16,6,10,1,Forsyth,2023-03-19
4,22,6,16,1,Gaston,2023-01-21
4,21,6,15,1,Harnett,2023-02-01
4,22,6,16,1,Iredell,2023-02-05
4,28,6,22,1,Johnston,2022-11-27
4,15,6,9,1,New Hanover,2023-03-13
4,22,6,16,1,Surry,2022-12-31
4,19,6,13,1,Vance,2023-01-17
4,13,7,6,1,Buncombe,2023-01-28
4,13,7,6,1,Catawba,2023-02-22
4,11,7,4,1,Davie,2023-02-20
4,12,7,5,1,Jones,2023-01-03
4,18,7,11,1,Pitt,2023-01-07
4,20,7,13,1,Pitt,2023-03-01
4,55,7,48,1,Wake,2022-11-13
4,12,7,5,1,Wilson,2022-12-17
4,17,8,9,1,Buncombe,2023-02-19
4,24,8,16,1,Guilford,2023-03-19
4,14,8,6,1,Iredell,2023-03-16
4,24,8,16,1,Moore,2022-12-18
4,14,8,6,1,Robeson,2023-03-21
4,18,9,9,1,Catawba,2022-11-22
4,18,9,9,1,Wilson,2023-01-18
4,20,10,10,1,Buncombe,2023-02-04
4,15,10,5,1,Buncombe,2023-03-30
4,24,11,13,1,Union,2022-11-26
4,32,12,20,1,Caldwell,2022-12-09
4,22,12,10,1,New Hanover,2022-12-02
4,24,15,9,1,Iredell,2023-01-08
4,38,18,20,1,Iredell,2023-01-31
4,24,18,6,1,Randolph,2023-01-18
4,35,19,16,1,Wilson,2022-12-20
5,10,1,9,1,Columbus,2023-01-11
5,13,2,11,1,Alamance,2023-01-22
5,34,2,32,1,Onslow,2023-01-11
5,26,2,24,1,Stanly,2022-12-30
5,27,3,24,1,Alamance,2023-01-21
5,24,3,21,1,Cleveland,2022-12-31
5,17,3,14,1,Cleveland,2023-01-12
5,11,3,8,1,Durham,2023-02-26
5,26,4,22,1,Alamance,2023-01-07
5,40,4,36,1,Cabarrus,2022-11-30
5,10,4,6,1,Davidson,2023-04-10
5,21,4,17,1,Haywood,2022-11-17
5,19,4,15,1,Johnston,2023-01-28
5,16,4,12,1,Lincoln,2022-12-07
5,14,4,10,1,Lincoln,2023-01-13
5,17,4,13,1,New Hanover,2023-02-21
5,13,4,9,1,Surry,2023-02-02
5,28,5,23,1,Davidson,2023-02-16
5,39,5,34,1,Forsyth,2023-01-15
5,19,5,14,1,Johnston,2023-03-22
5,15,5,10,1,Lincoln,2023-01-21
5,15,5,10,1,Rockingham,2023-01-01
5,19,5,14,1,Rowan,2022-11-22
5,15,5,10,1,Rutherford,2022-12-23
5,43,5,38,1,Wake,2023-03-31
5,18,6,12,1,Alamance,2023-03-02
5,17,6,11,1,Catawba,2023-02-12
5,20,6,14,1,Duplin,2022-12-30
5,42,6,36,1,Durham,2022-12-24
5,30,6,24,1,Guilford,2023-03-15
5,25,6,19,1,Lee,2022-12-20
5,25,6,19,1,Mecklenburg,2023-04-01
5,20,6,14,1,Mecklenburg,2023-05-06
5,17,6,11,1,Pitt,2023-01-08
5,21,6,15,1,Robeson,2023-01-31
5,15,6,9,1,Union,2023-03-09
5,36,7,29,1,Brunswick,2022-12-31
5,10,7,3,1,Catawba,2023-01-28
5,15,7,8,1,Catawba,2023-03-03
5,50,7,43,1,Guilford,2022-11-26
5,18,7,11,1,Nash,2023-01-16
5,25,7,18,1,Pitt,2023-02-17
5,18,7,11,1,Randolph,2022-11-08
5,26,8,18,1,Buncombe,2023-02-15
5,13,8,5,1,Halifax,2023-02-03
5,18,8,10,1,Henderson,2023-01-23
5,21,8,13,1,Robeson,2023-01-07
5,21,8,13,1,Stokes,2023-01-09
5,17,8,9,1,Wilson,2023-02-17
5,16,9,7,1,Halifax,2023-02-09
5,33,9,24,1,Henderson,2023-01-11
5,19,10,9,1,Catawba,2023-01-16
5,25,10,15,1,Craven,2022-12-31
5,23,10,13,1,Nash,2023-01-25
5,29,10,19,1,New Hanover,2022-11-29
5,17,10,7,1,New Hanover,2023-03-29
5,23,11,12,1,Catawba,2022-11-21
5,21,11,10,1,Henderson,2023-01-27
5,26,11,15,1,Henderson,2023-02-07
5,33,11,22,1,Moore,2022-12-21
5,12,11,1,1,Polk,2022-12-27
5,28,11,17,1,Rowan,2022-11-21
5,20,11,9,1,Surry,2023-02-21
5,20,12,8,1,Buncombe,2023-01-21
5,19,12,7,1,Iredell,2023-01-29
5,30,13,17,1,New Hanover,2023-01-17
5,19,13,6,1,Sampson,2023-01-05
5,26,14,12,1,Wayne,2023-01-16
5,28,16,12,1,Iredell,2023-02-01
5,27,16,11,1,Wilkes,2023-01-06
5,30,20,10,1,Wayne,2023-01-25
6,25,2,23,1,Alamance,2022-11-09
6,26,2,24,1,Alamance,2022-11-18
6,16,2,14,1,Davidson,2023-01-22
6,37,2,35,1,Franklin,2023-01-04
6,23,2,21,1,Stanly,2023-01-10
6,27,3,24,1,Burke,2022-12-02
6,30,3,27,1,Forsyth,2022-11-16
6,30,3,27,1,Forsyth,2023-02-18
6,44,3,41,1,Onslow,2022-12-27
6,38,3,35,1,Orange,2022-12-14
6,27,4,23,1,Moore,2023-01-06
6,18,4,14,1,Surry,2023-01-11
6,12,4,8,1,Yadkin,2022-12-13
6,45,5,40,1,Cabarrus,2022-12-02
6,20,5,15,1,Halifax,2023-01-24
6,26,5,21,1,Harnett,2023-01-13
6,17,5,12,1,Henderson,2022-12-01
6,11,5,6,1,New Hanover,2023-03-30
6,35,5,30,1,Rowan,2022-12-21
6,17,5,12,1,Rowan,2022-12-24
6,20,5,15,1,Rowan,2023-03-15
6,21,6,15,1,Alamance,2022-12-03
6,38,7,31,1,Burke,2022-12-21
6,30,7,23,1,Caldwell,2022-12-05
6,30,7,23,1,Caldwell,2023-01-18
6,22,7,15,1,Caldwell,2023-01-31
6,28,7,21,1,Forsyth,2023-02-25
6,18,7,11,1,Haywood,2022-11-14
6,22,7,15,1,Henderson,2023-01-24
6,29,7,22,1,Johnston,2023-02-01
6,35,7,28,1,Mecklenburg,2023-04-13
6,15,7,8,1,Robeson,2023-01-28
6,14,7,7,1,Sampson,2023-01-25
6,12,7,5,1,Wayne,2023-02-22
6,30,8,22,1,Cumberland,2022-12-25
6,45,8,37,1,Durham,2023-01-01
6,27,8,19,1,Iredell,2022-12-16
6,39,8,31,1,Mecklenburg,2023-03-19
6,21,8,13,1,Rockingham,2023-01-02
6,19,9,10,1,Craven,2022-11-29
6,19,9,10,1,Nash,2022-12-06
6,31,10,21,1,Cumberland,2023-03-01
6,23,10,13,1,Randolph,2023-02-06
6,29,10,19,1,Rockingham,2022-12-19
6,46,11,35,1,Cabarrus,2022-12-08
6,33,11,22,1,Guilford,2023-03-07
6,54,12,42,1,Guilford,2022-11-10
6,21,12,9,1,Wayne,2022-11-08
6,21,13,8,1,Craven,2023-02-07
6,23,13,10,1,Randolph,2023-01-16
6,32,16,16,1,Robeson,2023-01-26
6,41,17,24,1,New Hanover,2023-01-16
6,20,17,3,1,Wilson,2023-02-15
6,38,23,15,1,Catawba,2023-02-08
6,69,26,43,1,Cumberland,2023-01-08
7,19,0,19,1,Union,2023-03-07
7,29,1,28,1,Caldwell,2023-01-23
7,12,1,11,1,Edgecombe,2023-01-18
7,69,2,67,1,Durham,2022-11-28
7,41,2,39,1,Union,2023-01-01
7,19,3,16,1,Alamance,2023-01-08
7,17,3,14,1,Davidson,2022-11-08
7,15,3,12,1,Lenoir,2022-12-13
7,16,3,13,1,Surry,2023-02-03
7,31,4,27,1,Cleveland,2023-01-04
7,13,4,9,1,Robeson,2023-02-27
7,28,5,23,1,Alamance,2023-01-15
7,26,5,21,1,Caldwell,2023-01-05
7,25,5,20,1,Mecklenburg,2023-04-20
7,23,6,17,1,Gaston,2023-02-22
7,29,6,23,1,Union,2023-02-28
7,24,7,17,1,Forsyth,2023-03-16
7,42,7,35,1,Guilford,2022-12-25
7,42,7,35,1,Orange,2022-12-28
7,30,8,22,1,Bladen,2023-01-03
7,31,8,23,1,Cleveland,2022-12-07
7,35,8,27,1,Granville,2022-12-30
7,45,9,36,1,Alamance,2023-02-09
7,31,9,22,1,Davidson,2023-01-19
7,32,9,23,1,Forsyth,2023-03-29
7,37,9,28,1,Guilford,2023-02-19
7,61,9,52,1,Mecklenburg,2022-11-20
7,32,10,22,1,Burke,2022-12-30
7,22,10,12,1,Nash,2022-12-16
7,36,10,26,1,Union,2023-01-15
7,34,12,22,1,Forsyth,2023-03-21
7,29,12,17,1,Surry,2022-12-17
7,34,13,21,1,Cabarrus,2023-01-15
7,44,13,31,1,Rowan,2023-01-16
7,31,14,17,1,Guilford,2023-03-13
7,20,14,6,1,Montgomery,2022-12-26
7,19,15,4,1,Alexander,2023-01-16
7,28,15,13,1,Catawba,2023-02-28
7,39,16,23,1,Buncombe,2023-02-06
7,32,16,16,1,Granville,2023-01-05
7,38,18,20,1,Wayne,2022-12-23
7,46,19,27,1,Iredell,2022-12-17
7,56,19,37,1,Pitt,2023-01-06
7,41,24,17,1,Buncombe,2023-01-08
7,38,25,13,1,Wilkes,2023-01-04
7,49,30,19,1,Catawba,2022-12-16
8,19,1,18,1,Durham,2023-03-17
8,20,4,16,1,Brunswick,2023-02-21
8,23,4,19,1,Cabarrus,2022-12-25
8,21,4,17,1,Edgecombe,2022-12-30
8,22,5,17,1,Cabarrus,2022-11-14
8,63,5,58,1,Onslow,2023-01-09
8,32,5,27,1,Rowan,2023-01-20
8,31,7,24,1,Alamance,2023-02-02
8,42,7,35,1,Cabarrus,2022-12-06
8,52,7,45,1,Rowan,2023-01-31
8,22,7,15,1,Stokes,2023-01-05
8,31,7,24,1,Union,2022-11-27
8,43,8,35,1,Durham,2023-02-05
8,75,8,67,1,Forsyth,2022-11-21
8,40,8,32,1,Rowan,2023-01-24
8,16,8,8,1,Wilson,2023-02-08
8,43,9,34,1,Alamance,2022-12-01
8,24,9,15,1,Edgecombe,2023-01-04
8,65,9,56,1,Forsyth,2023-01-01
8,24,10,14,1,Randolph,2023-02-20
8,23,10,13,1,Surry,2022-12-24
8,37,10,27,1,Union,2023-02-20
8,43,11,32,1,Cumberland,2023-02-05
8,31,11,20,1,Davidson,2023-02-08
8,20,11,9,1,Iredell,2023-02-22
8,46,12,34,1,Cabarrus,2022-12-01
8,47,14,33,1,Alamance,2022-11-29
8,30,15,15,1,Randolph,2022-12-02
8,51,16,35,1,Cabarrus,2023-01-31
8,26,16,10,1,Robeson,2022-12-17
8,27,16,11,1,Wayne,2023-02-02
8,39,19,20,1,Iredell,2022-12-31
8,47,25,22,1,Buncombe,2022-11-28
8,37,26,11,1,Catawba,2023-01-31
8,51,26,25,1,Henderson,2023-01-02
8,46,28,18,1,Iredell,2023-02-08
9,35,1,34,1,Davidson,2022-11-29
9,33,4,29,1,Durham,2023-01-15
9,63,4,59,1,Mecklenburg,2022-11-13
9,43,4,39,1,Orange,2022-12-13
9,19,6,13,1,Catawba,2023-02-17
9,31,6,25,1,Davidson,2023-01-31
9,21,6,15,1,Forsyth,2023-04-26
9,27,7,20,1,Caldwell,2023-01-24
9,37,7,30,1,Davidson,2022-12-06
9,51,7,44,1,Forsyth,2022-12-25
9,35,8,27,1,Alamance,2023-02-01
9,34,8,26,1,Burke,2022-12-14
9,31,8,23,1,Caldwell,2023-01-11
9,46,8,38,1,Forsyth,2022-11-09
9,44,8,36,1,Forsyth,2022-11-10
9,31,8,23,1,Gaston,2023-01-25
9,25,8,17,1,Guilford,2023-03-31
9,40,9,31,1,Alamance,2022-12-05
9,31,9,22,1,Brunswick,2023-01-18
9,36,9,27,1,Gaston,2023-02-09
9,17,9,8,1,Robeson,2023-01-22
9,28,9,19,1,Union,2023-02-22
9,20,10,10,1,Forsyth,2023-04-30
9,31,10,21,1,Guilford,2023-03-30
9,25,10,15,1,Yadkin,2023-01-04
9,25,11,14,1,Catawba,2023-01-01
9,40,12,28,1,Burke,2022-12-27
9,47,12,35,1,Forsyth,2022-11-17
9,36,12,24,1,Wake,2023-04-02
9,44,13,31,1,Davidson,2023-01-17
9,44,13,31,1,Guilford,2022-11-11
9,55,14,41,1,Alamance,2023-01-02
9,54,14,40,1,Davidson,2023-01-10
9,21,14,7,1,Wilson,2023-01-25
9,27,15,12,1,Buncombe,2022-11-27
9,61,15,46,1,Forsyth,2023-01-14
9,40,16,24,1,Stokes,2022-12-22
9,31,19,12,1,Carteret,2023-01-02
9,40,19,21,1,Robeson,2023-01-23
9,56,20,36,1,Cumberland,2022-12-24
9,49,21,28,1,Buncombe,2023-01-30
9,57,26,31,1,Iredell,2022-12-06
10,23,3,20,1,Stokes,2022-12-05
10,34,5,29,1,Davidson,2022-12-24
10,37,6,31,1,Alamance,2023-01-23
10,24,6,18,1,Harnett,2023-02-09
10,39,7,32,1,Davidson,2022-12-31
10,47,8,39,1,Davidson,2022-11-28
10,50,8,42,1,Union,2022-11-29
10,18,9,9,1,Randolph,2022-11-22
10,49,10,39,1,Onslow,2022-12-12
10,38,11,27,1,Gaston,2023-01-11
10,53,11,42,1,Johnston,2022-12-20
10,36,11,25,1,Nash,2023-01-05
10,57,12,45,1,Cabarrus,2022-12-13
10,47,13,34,1,Guilford,2023-03-02
10,61,13,48,1,Pitt,2022-12-27
10,75,13,62,1,Wake,2022-12-25
10,44,14,30,1,Surry,2022-12-30
10,59,15,44,1,Guilford,2022-11-09
10,47,16,31,1,Forsyth,2023-03-27
10,59,16,43,1,Rowan,2023-01-04
10,38,17,21,1,Cleveland,2022-12-26
10,64,18,46,1,Alamance,2022-12-30
10,37,18,19,1,Catawba,2022-12-09
10,43,18,25,1,Iredell,2022-12-23
10,52,20,32,1,Guilford,2023-02-27
10,30,20,10,1,Iredell,2022-11-22
10,43,20,23,1,Surry,2022-12-21
10,48,21,27,1,Craven,2022-12-27
10,40,23,17,1,Iredell,2023-01-11
10,36,23,13,1,Iredell,2023-02-15
10,33,23,10,1,Randolph,2023-01-12
10,54,24,30,1,Catawba,2023-01-05
10,62,25,37,1,Buncombe,2023-01-06
10,43,25,18,1,Randolph,2022-12-19
10,75,26,49,1,Guilford,2022-12-10
10,50,27,23,1,Randolph,2022-12-06
11,54,2,52,1,Durham,2023-02-10
11,53,4,49,1,Durham,2023-02-21
11,45,6,39,1,Union,2023-01-20
11,27,7,20,1,Duplin,2022-12-28
11,22,7,15,1,Rutherford,2023-01-16
11,38,8,30,1,Rowan,2023-01-06
11,52,9,43,1,Cumberland,2022-12-02
11,44,9,35,1,Durham,2023-02-28
11,36,9,27,1,Nash,2022-12-30
11,51,11,40,1,Johnston,2023-01-23
11,40,12,28,1,Gaston,2023-01-13
11,23,14,9,1,Iredell,2023-02-23
11,59,15,44,1,Davidson,2023-01-04
11,43,15,28,1,Guilford,2023-03-06
11,44,16,28,1,Rowan,2023-01-23
11,40,17,23,1,Pitt,2023-01-13
11,59,17,42,1,Wake,2023-03-10
11,51,18,33,1,Buncombe,2023-01-18
11,22,18,4,1,Wilkes,2022-12-01
11,28,20,8,1,Catawba,2023-02-03
11,69,20,49,1,Guilford,2023-01-08
11,46,21,25,1,Buncombe,2022-11-22
11,46,22,24,1,Randolph,2023-01-04
11,39,25,14,1,Sampson,2023-01-09
11,62,30,32,1,Buncombe,2022-12-05
11,61,30,31,1,New Hanover,2022-12-20
11,53,38,15,1,Wayne,2023-01-18
12,25,3,22,1,Alamance,2022-11-23
12,42,7,35,1,Alamance,2022-11-30
12,43,7,36,1,Cabarrus,2023-01-30
12,94,8,86,1,Wake,2022-11-17
12,56,9,47,1,Union,2023-01-11
12,50,10,40,1,Cabarrus,2023-01-19
12,46,10,36,1,Gaston,2023-01-10
12,42,10,32,1,Wake,2023-04-14
12,37,11,26,1,Gaston,2022-11-28
12,38,12,26,1,Nash,2023-01-04
12,62,14,48,1,Wake,2023-03-16
12,26,15,11,1,Guilford,2023-04-24
12,23,15,8,1,Sampson,2023-01-23
12,24,15,9,1,Wilkes,2022-12-16
12,61,16,45,1,Alamance,2023-01-13
12,57,18,39,1,Mecklenburg,2023-03-30
12,24,18,6,1,Wilson,2023-01-11
12,54,19,35,1,Surry,2022-12-28
12,82,24,58,1,Guilford,2022-12-11
12,53,27,26,1,Buncombe,2022-12-22
12,50,27,23,1,Buncombe,2023-02-13
12,67,30,37,1,Catawba,2022-12-26
12,115,33,82,1,Cumberland,2023-01-06
12,71,40,31,1,Buncombe,2022-12-21
13,34,3,31,1,Gaston,2023-01-23
13,35,7,28,1,Pitt,2023-02-27
13,42,8,34,1,Alamance,2023-01-24
13,47,8,39,1,Forsyth,2023-01-28
13,36,9,27,1,Davidson,2022-12-09
13,43,9,34,1,Forsyth,2023-02-04
13,56,9,47,1,Forsyth,2023-02-21
13,43,9,34,1,Mecklenburg,2023-04-25
13,83,10,73,1,Alamance,2022-12-21
13,81,10,71,1,Mecklenburg,2022-11-12
13,61,12,49,1,Union,2022-11-30
13,31,13,18,1,Robeson,2022-12-26
13,24,13,11,1,Robeson,2023-02-15
13,62,15,47,1,Forsyth,2022-11-14
13,65,15,50,1,Mecklenburg,2023-03-02
13,80,17,63,1,Durham,2023-01-26
13,54,17,37,1,Gaston,2022-12-31
13,83,24,59,1,Forsyth,2022-12-24
13,78,25,53,1,Mecklenburg,2023-03-24
13,44,25,19,1,Randolph,2022-12-23
13,47,28,19,1,Wayne,2022-12-16
14,51,5,46,1,Cleveland,2023-01-03
14,64,7,57,1,Onslow,2022-12-29
14,58,13,45,1,Cabarrus,2023-01-18
14,49,14,35,1,Pitt,2023-01-11
14,52,15,37,1,Cabarrus,2023-01-25
14,68,15,53,1,Gaston,2022-12-13
14,57,15,42,1,Rowan,2023-01-09
14,68,17,51,1,Forsyth,2022-12-17
14,67,18,49,1,Mecklenburg,2023-03-08
14,51,19,32,1,Gaston,2023-01-30
14,74,25,49,1,New Hanover,2023-01-02
14,40,26,14,1,Robeson,2023-02-06
14,51,28,23,1,Iredell,2022-12-07
14,60,29,31,1,Wayne,2023-01-04
14,66,30,36,1,Cabarrus,2023-01-05
14,58,33,25,1,Iredell,2022-12-30
14,88,37,51,1,Buncombe,2022-12-29
15,46,3,43,1,Union,2023-01-12
15,69,11,58,1,Wake,2023-02-19
15,107,12,95,1,Durham,2022-12-23
15,66,13,53,1,Mecklenburg,2023-03-14
15,59,17,42,1,Forsyth,2023-01-21
15,99,19,80,1,Cumberland,2022-12-06
15,70,22,48,1,Guilford,2023-02-17
15,81,23,58,1,Mecklenburg,2023-02-18
15,48,23,25,1,Surry,2022-12-20
15,91,29,62,1,Guilford,2023-01-13
16,65,10,55,1,Durham,2023-01-20
16,48,11,37,1,Gaston,2022-11-29
16,63,15,48,1,Cumberland,2023-02-14
16,50,16,34,1,Davidson,2023-01-11
16,93,16,77,1,Mecklenburg,2023-02-05
16,61,16,45,1,Mecklenburg,2023-03-27
16,64,26,38,1,Iredell,2022-12-22
16,62,26,36,1,Rowan,2022-12-19
16,120,36,84,1,Guilford,2022-12-09
17,59,13,46,1,Davidson,2022-12-14
17,48,17,31,1,Caldwell,2022-12-19
17,40,17,23,1,Rowan,2022-12-15
17,67,20,47,1,Wake,2023-02-18
17,58,21,37,1,Forsyth,2023-02-20
17,100,25,75,1,Johnston,2023-01-04
17,57,29,28,1,Rowan,2022-12-26
17,73,48,25,1,Iredell,2022-12-26
18,61,18,43,1,Johnston,2023-01-10
18,104,19,85,1,Cabarrus,2022-12-30
18,68,19,49,1,Mecklenburg,2023-03-03
18,86,21,65,1,Guilford,2023-02-09
18,43,24,19,1,Catawba,2023-02-06
18,99,28,71,1,Forsyth,2022-12-05
18,62,29,33,1,Wayne,2022-12-19
18,69,43,26,1,Robeson,2022-12-28
19,106,14,92,1,Mecklenburg,2022-11-11
19,95,15,80,1,Forsyth,2022-12-09
19,119,16,103,1,Wake,2023-01-08
19,74,19,55,1,Gaston,2022-12-08
19,91,19,72,1,Union,2023-01-03
19,94,20,74,1,Alamance,2023-01-04
19,90,24,66,1,Cabarrus,2022-12-27
19,120,24,96,1,Wake,2022-12-04
19,92,27,65,1,Gaston,2022-12-22
19,110,28,82,1,Guilford,2023-01-11
19,93,29,64,1,Guilford,2023-02-08
19,82,38,44,1,Buncombe,2022-12-20
19,73,38,35,1,Iredell,2022-12-19
19,92,42,50,1,Buncombe,2023-01-04
19,104,45,59,1,Cumberland,2022-12-23
20,121,16,105,1,Mecklenburg,2022-11-26
20,110,16,94,1,Wake,2023-01-28
20,108,22,86,1,Guilford,2022-11-29
20,101,25,76,1,Durham,2022-12-26
20,82,26,56,1,New Hanover,2022-12-28
20,118,27,91,1,Mecklenburg,2023-01-15
20,94,27,67,1,Mecklenburg,2023-03-01
20,119,28,91,1,Mecklenburg,2022-12-25
20,98,34,64,1,Forsyth,2023-01-26
20,67,38,29,1,Catawba,2022-12-20
21,75,13,62,1,Alamance,2022-12-12
21,63,19,44,1,Mecklenburg,2023-03-13
21,103,23,80,1,Forsyth,2023-02-07
21,98,25,73,1,Forsyth,2023-02-03
21,89,26,63,1,Cabarrus,2023-01-03
21,80,30,50,1,Mecklenburg,2023-03-28
21,40,30,10,1,Robeson,2022-11-29
22,87,16,71,1,Wake,2023-03-13
22,106,22,84,1,Forsyth,2022-12-16
22,73,27,46,1,Buncombe,2023-01-05
23,106,11,95,1,Durham,2022-12-22
23,122,15,107,1,Mecklenburg,2022-11-17
23,91,20,71,1,Wake,2023-02-05
23,91,22,69,1,Forsyth,2023-01-20
23,123,22,101,1,Mecklenburg,2023-01-28
24,143,21,122,1,Durham,2022-12-29
24,151,21,130,1,Mecklenburg,2022-11-23
24,139,27,112,1,Cumberland,2023-01-09
24,97,31,66,1,Johnston,2022-12-30
24,126,40,86,1,Forsyth,2023-01-24
24,137,48,89,1,Cumberland,2023-01-02
25,101,31,70,1,Forsyth,2023-01-31
25,70,41,29,1,Iredell,2023-01-05
25,104,44,60,1,Cabarrus,2022-12-28
26,127,14,113,1,Durham,2022-12-30
26,91,16,75,1,Wake,2023-02-23
26,143,25,118,1,Durham,2022-12-19
26,178,36,142,1,Forsyth,2022-12-19
27,134,12,122,1,Mecklenburg,2022-11-15
27,118,32,86,1,Guilford,2022-12-31
28,142,32,110,1,Mecklenburg,2023-01-21
28,101,33,68,1,Forsyth,2023-02-01
28,126,33,93,1,Guilford,2022-12-08
28,150,46,104,1,Cumberland,2023-01-04
29,127,18,109,1,Wake,2023-02-20
29,113,19,94,1,Union,2022-12-27
29,146,37,109,1,Mecklenburg,2023-02-03
29,194,40,154,1,Mecklenburg,2022-11-21
29,161,40,121,1,Mecklenburg,2022-12-10
30,142,23,119,1,Mecklenburg,2022-11-25
30,111,27,84,1,Johnston,2022-12-29
31,141,35,106,1,Guilford,2022-11-28
31,173,37,136,1,Wake,2022-12-01
32,158,14,144,1,Durham,2023-01-03
32,208,41,167,1,Mecklenburg,2022-12-31
32,136,43,93,1,Guilford,2022-12-06
32,215,44,171,1,Mecklenburg,2022-12-01
32,209,46,163,1,Mecklenburg,2022-12-18
33,118,33,85,1,Guilford,2023-01-23
33,169,34,135,1,Forsyth,2023-01-04
33,189,54,135,1,Guilford,2023-01-03
34,190,62,128,1,Cumberland,2023-01-03
35,110,32,78,1,Gaston,2022-12-21
36,129,18,111,1,Durham,2023-01-05
36,184,32,152,1,Wake,2023-01-12
36,207,43,164,1,Mecklenburg,2023-02-07
36,186,57,129,1,Guilford,2022-12-14
37,160,25,135,1,Wake,2023-01-20
37,153,29,124,1,Wake,2022-12-10
37,133,34,99,1,Forsyth,2023-01-23
38,205,62,143,1,Guilford,2022-12-20
38,183,63,120,1,Cumberland,2022-12-27
39,204,29,175,1,Wake,2022-11-30
40,182,38,144,1,Guilford,2023-01-05
40,192,45,147,1,Mecklenburg,2023-01-27
40,205,46,159,1,Wake,2023-01-18
41,236,32,204,1,Wake,2022-11-28
41,201,57,144,1,Forsyth,2022-12-27
42,208,41,167,1,Mecklenburg,2023-01-13
42,248,70,178,1,Mecklenburg,2023-01-12
43,292,44,248,1,Wake,2023-01-06
44,196,31,165,1,Wake,2023-01-23
45,215,54,161,1,Guilford,2023-01-04
47,191,42,149,1,Forsyth,2022-12-29
47,196,50,146,1,Forsyth,2022-12-30
48,181,51,130,1,Mecklenburg,2023-02-02
48,281,56,225,1,Wake,2022-12-12
49,190,28,162,1,Wake,2023-01-17
50,305,78,227,1,Wake,2022-12-26
51,221,50,171,1,Mecklenburg,2023-01-30
53,307,43,264,1,Mecklenburg,2022-12-06
53,212,53,159,1,Mecklenburg,2023-01-24
58,367,82,285,1,Wake,2022-12-27
60,283,59,224,1,Mecklenburg,2022-12-07
62,275,70,205,1,Mecklenburg,2023-01-18
63,334,66,268,1,Mecklenburg,2023-01-05
71,385,81,304,1,Mecklenburg,2022-12-22
73,378,53,325,1,Wake,2022-12-20
79,371,91,280,1,Wake,2023-01-02
80,311,70,241,1,Mecklenburg,2023-01-09
87,407,91,316,1,Mecklenburg,2023-01-04
88,431,92,339,1,Mecklenburg,2022-12-29
0,1,0,1,2,Rowan,2023-03-25
0,11,3,8,2,Buncombe,2023-04-26
2,6,3,3,2,Carteret,2023-01-16
2,8,3,5,2,Nash,2023-02-05
2,12,3,9,2,Union,2023-03-02
2,5,4,1,2,Robeson,2022-11-14
2,16,6,10,2,Brunswick,2023-02-09
2,9,6,3,2,Sampson,2022-12-24
2,9,7,2,2,Iredell,2023-03-12
2,26,9,17,2,Guilford,2022-11-20
3,6,1,5,2,Surry,2023-02-04
3,16,2,14,2,Burke,2023-01-19
3,11,2,9,2,Cleveland,2023-01-11
3,8,2,6,2,Columbus,2023-01-12
3,22,2,20,2,Onslow,2023-01-07
3,8,3,5,2,Surry,2023-01-22
3,18,4,14,2,Nash,2023-01-08
3,19,8,11,2,Guilford,2023-04-08
3,19,14,5,2,Haywood,2022-12-28
3,39,18,21,2,Columbus,2023-01-03
4,7,0,7,2,Hertford,2023-01-02
4,9,2,7,2,Vance,2023-01-18
4,27,3,24,2,Durham,2023-03-15
4,17,5,12,2,New Hanover,2023-02-16
4,13,7,6,2,Buncombe,2023-02-12
4,12,8,4,2,Buncombe,2023-04-17
4,19,8,11,2,Johnston,2022-11-09
5,13,2,11,2,Gaston,2022-11-11
5,28,3,25,2,Cabarrus,2022-12-04
5,22,3,19,2,Durham,2023-04-04
5,27,3,24,2,Union,2023-02-16
5,32,4,28,2,Brunswick,2023-01-13
5,25,4,21,2,Guilford,2023-03-05
5,16,5,11,2,Iredell,2022-11-11
5,34,5,29,2,Wake,2023-03-25
5,18,6,12,2,Craven,2023-01-25
5,38,9,29,2,Alamance,2023-02-07
5,28,9,19,2,Buncombe,2023-02-22
5,54,9,45,2,Guilford,2023-01-14
5,28,9,19,2,Surry,2023-01-02
5,18,12,6,2,Robeson,2023-01-08
5,33,17,16,2,Iredell,2023-01-17
6,25,10,15,2,New Hanover,2023-01-26
7,27,6,21,2,Caldwell,2023-02-08
7,28,8,20,2,Guilford,2023-03-09
7,25,8,17,2,Nash,2023-01-31
7,21,11,10,2,Wilkes,2023-01-03
7,59,14,45,2,Cabarrus,2022-12-23
7,39,20,19,2,Henderson,2023-01-09
7,58,30,28,2,Catawba,2022-12-29
7,70,43,27,2,Iredell,2022-12-12
8,24,6,18,2,Caldwell,2023-01-26
8,31,7,24,2,Gaston,2022-11-08
8,39,8,31,2,Durham,2023-02-20
8,44,15,29,2,Buncombe,2023-01-12
8,60,24,36,2,Buncombe,2023-01-11
8,46,26,20,2,Iredell,2022-12-14
9,47,6,41,2,Davidson,2023-02-03
9,17,6,11,2,Lee,2023-01-05
9,39,10,29,2,Gaston,2023-01-07
9,24,12,12,2,Buncombe,2023-01-15
9,39,13,26,2,Buncombe,2022-12-31
9,77,23,54,2,Mecklenburg,2023-03-06
10,27,9,18,2,Rowan,2023-01-22
10,46,15,31,2,Nash,2022-12-29
10,46,23,23,2,Buncombe,2023-01-19
11,29,7,22,2,Moore,2023-01-24
11,42,9,33,2,Forsyth,2023-02-10
11,52,20,32,2,Gaston,2023-02-06
11,62,40,22,2,Iredell,2023-01-02
12,72,6,66,2,Mecklenburg,2022-11-19
12,40,12,28,2,Mecklenburg,2023-03-11
12,80,13,67,2,Alamance,2022-12-29
12,82,19,63,2,Guilford,2023-01-19
12,87,26,61,2,Cumberland,2023-01-25
13,49,15,34,2,Guilford,2022-11-18
13,56,15,41,2,Guilford,2023-02-23
13,59,32,27,2,Catawba,2023-01-02
14,59,11,48,2,Gaston,2022-12-06
14,96,19,77,2,Wake,2023-01-15
14,66,20,46,2,Mecklenburg,2023-03-09
14,91,22,69,2,Cumberland,2022-11-29
14,74,26,48,2,Alamance,2023-01-10
14,47,30,17,2,Robeson,2023-01-02
14,112,31,81,2,Forsyth,2022-12-15
15,53,15,38,2,Wake,2023-03-23
16,38,10,28,2,Alamance,2023-01-25
16,52,12,40,2,Durham,2023-01-08
16,79,13,66,2,Gaston,2023-01-04
16,74,15,59,2,Durham,2023-01-25
16,62,21,41,2,Forsyth,2023-02-22
17,65,10,55,2,Forsyth,2023-02-08
17,42,11,31,2,Davidson,2023-01-16
17,70,13,57,2,Davidson,2023-01-03
17,77,24,53,2,Guilford,2023-02-15
18,88,15,73,2,Davidson,2022-12-28
18,94,20,74,2,Guilford,2023-01-27
18,51,20,31,2,Guilford,2023-02-05
18,110,34,76,2,Guilford,2023-01-20
18,93,50,43,2,Buncombe,2023-01-03
19,102,12,90,2,Mecklenburg,2022-11-18
19,85,19,66,2,Guilford,2023-02-03
19,76,21,55,2,Mecklenburg,2023-03-22
19,86,28,58,2,Mecklenburg,2023-02-04
19,75,30,45,2,Gaston,2022-12-26
20,72,12,60,2,Forsyth,2023-02-16
20,93,27,66,2,Gaston,2023-01-02
20,108,31,77,2,Forsyth,2023-01-12
21,83,20,63,2,Mecklenburg,2023-03-07
21,118,33,85,2,Guilford,2022-12-17
22,85,24,61,2,Cabarrus,2023-01-04
23,92,23,69,2,Forsyth,2023-01-13
24,93,21,72,2,Guilford,2023-01-07
25,184,40,144,2,Mecklenburg,2022-12-02
26,152,21,131,2,Mecklenburg,2023-01-01
26,109,31,78,2,Forsyth,2023-01-16
26,133,31,102,2,Guilford,2023-01-18
26,180,50,130,2,Guilford,2022-12-12
27,87,32,55,2,Gaston,2022-12-23
27,125,37,88,2,Guilford,2023-01-09
27,107,69,38,2,Buncombe,2022-12-26
28,85,11,74,2,Wake,2023-02-11
31,183,35,148,2,Mecklenburg,2023-01-07
34,194,71,123,2,Guilford,2022-12-22
43,204,43,161,2,Forsyth,2023-01-03
43,232,47,185,2,Mecklenburg,2022-11-30
44,237,47,190,2,Mecklenburg,2023-01-23
45,213,48,165,2,Mecklenburg,2023-01-20
48,194,38,156,2,Wake,2023-02-01
49,208,47,161,2,Mecklenburg,2023-01-31
49,289,83,206,2,Wake,2022-12-23
55,285,58,227,2,Mecklenburg,2022-12-08
57,214,54,160,2,Mecklenburg,2023-01-25
58,296,34,262,2,Mecklenburg,2022-12-09
59,262,78,184,2,Guilford,2022-12-19
59,271,87,184,2,Guilford,2022-12-21
71,380,87,293,2,Mecklenburg,2023-01-03
77,351,81,270,2,Mecklenburg,2022-12-26
87,401,92,309,2,Mecklenburg,2022-12-30
1,17,1,16,3,Surry,2023-01-01
4,37,10,27,3,Guilford,2023-02-18
5,18,5,13,3,Rockingham,2023-01-23
8,46,17,29,3,Henderson,2023-01-04
9,61,17,44,3,Wake,2023-03-09
10,29,10,19,3,Cabarrus,2023-01-21
10,46,10,36,3,Forsyth,2023-02-12
14,59,12,47,3,Guilford,2023-02-28
17,82,15,67,3,Mecklenburg,2022-11-16
20,151,16,135,3,Wake,2023-01-07
21,102,22,80,3,Alamance,2022-12-20
21,101,41,60,3,Guilford,2022-12-18
23,147,42,105,3,Guilford,2022-12-15
24,135,25,110,3,Wake,2023-02-03
26,110,44,66,3,Guilford,2023-02-02
27,112,22,90,3,Guilford,2023-01-25
27,156,24,132,3,Mecklenburg,2022-12-24
27,142,31,111,3,Guilford,2023-02-01
27,126,32,94,3,Mecklenburg,2023-01-22
29,144,32,112,3,Guilford,2023-01-06
29,145,34,111,3,Forsyth,2023-01-05
33,139,28,111,3,Wake,2023-01-13
36,164,46,118,3,Guilford,2022-12-26
38,190,37,153,3,Wake,2023-01-24
39,225,61,164,3,Guilford,2022-12-29
66,344,52,292,3,Wake,2022-12-21
84,402,80,322,3,Mecklenburg,2022-12-20
16,65,11,54,4,Guilford,2023-01-22
16,99,24,75,4,Guilford,2023-01-16
