Total Cases by Date of Specimen collection,Total Antigen Cases by Date of Specimen Collection,Total Molecular Cases by Date of Specimen Collection,Death by Date of Death,County,Date
7,1,6,0,Edgecombe,2021-12-08
88,32,56,1,Iredell,2021-12-08
77,16,61,0,Davidson,2021-12-08
112,24,88,0,Union,2021-12-08
293,57,236,0,Mecklenburg,2021-12-08
13,0,13,0,Dare,2021-12-08
41,2,39,0,Franklin,2021-12-08
28,4,24,0,Cleveland,2021-12-08
92,28,64,1,Gaston,2021-12-08
66,4,62,0,Pitt,2021-12-08
63,3,60,0,Alamance,2021-12-08
151,24,127,0,Guilford,2021-12-08
14,5,9,1,Carteret,2021-12-08
16,6,10,0,Madison,2021-12-08
69,22,47,0,Catawba,2021-12-08
9,0,9,0,Jackson,2021-12-08
1,0,1,0,Hyde,2021-12-08
34,9,25,0,Rockingham,2021-12-08
11,2,9,0,Richmond,2021-12-08
5,3,2,0,Greene,2021-12-08
40,17,23,0,New Hanover,2021-12-08
34,1,33,0,Davidson,2021-12-11
24,8,16,4,Catawba,2021-12-11
25,6,19,0,Rockingham,2021-12-11
20,5,15,0,Surry,2021-12-11
35,3,32,1,Alamance,2021-12-11
28,16,12,1,Henderson,2021-12-11
19,2,17,0,Cleveland,2021-12-11
66,15,51,2,Gaston,2021-12-11
116,8,108,0,Guilford,2021-12-11
10,0,10,1,Jackson,2021-12-11
25,13,12,0,New Hanover,2021-12-11
174,30,144,1,Guilford,2021-12-14
39,8,31,1,Rockingham,2021-12-14
77,3,74,0,Davidson,2021-12-14
17,2,15,0,Jackson,2021-12-14
57,21,36,1,New Hanover,2021-12-14
18,3,15,0,Hoke,2021-12-14
19,4,15,0,McDowell,2021-12-14
67,25,42,0,Catawba,2021-12-14
108,34,74,1,Gaston,2021-12-14
57,6,51,2,Cleveland,2021-12-14
34,11,23,1,Surry,2021-12-14
3,1,2,0,Martin,2021-12-14
6,2,4,0,Anson,2021-12-15
81,5,76,0,Alamance,2021-12-15
42,20,22,1,Surry,2021-12-15
484,70,414,2,Mecklenburg,2021-12-15
11,5,6,0,Jackson,2021-12-15
84,9,75,1,Davidson,2021-12-15
16,0,16,0,Dare,2021-12-14
44,10,34,0,Brunswick,2021-12-15
28,15,13,0,Watauga,2021-12-15
81,6,75,1,Alamance,2021-12-14
42,6,36,0,Cleveland,2021-12-15
10,3,7,0,Scotland,2021-12-15
25,5,20,1,Wilkes,2021-12-14
11,4,7,0,Alexander,2021-12-14
9,1,8,0,Perquimans,2021-12-14
32,3,29,0,Moore,2021-12-15
13,1,12,0,Lenoir,2021-12-15
15,1,14,0,Dare,2021-12-15
13,5,8,0,McDowell,2021-12-15
26,0,26,0,Franklin,2021-12-15
860,72,788,4,Guilford,2022-01-15
337,58,279,1,New Hanover,2022-01-15
1535,244,1291,0,Mecklenburg,2022-01-15
26,9,17,0,Rutherford,2021-12-15
140,30,110,0,Lincoln,2022-01-15
253,44,209,0,Pitt,2022-01-15
383,112,271,2,Union,2022-01-15
43,1,42,0,Alexander,2022-01-15
15,9,6,0,Alexander,2021-12-15
228,23,205,0,Davidson,2022-01-15
79,11,68,0,Richmond,2022-01-15
86,26,60,0,Scotland,2022-01-15
316,61,255,6,Gaston,2022-01-15
83,18,65,0,Beaufort,2022-01-15
54,2,52,1,Montgomery,2022-01-15
116,53,63,0,Wilkes,2022-01-15
220,65,155,2,Iredell,2022-01-15
126,45,81,0,Surry,2022-01-15
177,8,169,1,Hoke,2022-01-15
307,12,295,1,Alamance,2022-01-15
8,1,7,0,Edgecombe,2021-12-18
14,4,10,0,Burke,2021-12-18
51,14,37,0,Carteret,2022-01-15
461,32,429,0,Wake,2021-12-18
34,3,31,0,Nash,2021-12-18
37,4,33,2,Alamance,2021-12-18
465,48,417,1,Mecklenburg,2021-12-18
22,5,17,0,Pitt,2021-12-18
18,3,15,0,Wayne,2021-12-18
8,5,3,0,Swain,2022-01-15
12,4,8,0,Wilson,2021-12-18
37,9,28,0,Martin,2022-01-15
19,1,18,0,Bertie,2022-01-15
60,0,60,0,Edgecombe,2022-01-15
31,2,29,0,Anson,2022-01-15
7,1,6,0,Halifax,2021-12-18
23,1,22,0,Lincoln,2021-12-18
11,0,11,0,Vance,2021-12-18
21,3,18,0,Jackson,2022-01-15
1,1,0,0,Graham,2021-12-18
17,10,7,1,Alexander,2021-12-08
18,1,17,0,Dare,2021-12-11
9,7,2,0,Alexander,2021-12-11
14,1,13,0,Beaufort,2021-12-14
16,14,2,0,Yancey,2021-12-14
7,1,6,0,Swain,2021-12-15
8,0,8,0,Montgomery,2021-12-14
3,0,3,0,Clay,2021-12-15
14,1,13,0,Beaufort,2021-12-15
8,4,4,0,Mitchell,2021-12-14
17,0,17,0,Franklin,2021-12-18
25,8,17,0,Transylvania,2022-01-15
108,17,91,0,Wayne,2022-01-16
240,19,221,1,Onslow,2022-01-16
36,11,25,2,Wilson,2022-01-16
9,3,6,0,McDowell,2021-12-18
17,3,14,0,Wilkes,2021-12-18
44,23,21,0,Iredell,2022-01-16
27,8,19,1,Granville,2022-01-16
9,1,8,0,Davie,2022-01-16
25,11,14,0,Stanly,2022-01-16
11,6,5,0,Haywood,2022-01-16
13,8,5,2,Rutherford,2022-01-16
42,8,34,0,Bladen,2022-01-16
22,2,20,0,Caswell,2022-01-15
26,11,15,3,Moore,2022-01-16
12,7,5,0,Greene,2022-01-16
46,13,33,1,Cabarrus,2022-01-16
9,3,6,0,Montgomery,2021-12-08
16,7,9,0,Transylvania,2021-12-08
5,2,3,0,Gates,2022-01-16
4,0,4,0,Perquimans,2021-12-11
11,5,6,0,Scotland,2021-12-08
9,1,8,0,Beaufort,2021-12-08
17,2,15,0,Pender,2021-12-15
3,0,3,0,Greene,2021-12-11
4,1,3,0,Gates,2021-12-14
8,2,6,0,Beaufort,2021-12-18
11,3,8,0,Watauga,2021-12-18
7,3,4,0,Mitchell,2021-12-15
1701,335,1366,2,Guilford,2022-01-06
5671,261,5410,3,Wake,2022-01-06
1176,119,1057,2,Forsyth,2022-01-06
481,24,457,0,Orange,2022-01-06
206,39,167,0,Scotland,2022-01-06
814,58,756,1,Pitt,2022-01-06
353,67,286,1,Cleveland,2022-01-06
656,85,571,4,Gaston,2022-01-06
94,7,87,0,Martin,2022-01-06
231,44,187,0,Lincoln,2022-01-06
96,16,80,0,Yadkin,2022-01-06
125,25,100,1,Vance,2022-01-06
317,40,277,0,Brunswick,2022-01-06
619,169,450,2,Buncombe,2022-01-06
53,4,49,0,Chowan,2022-01-06
141,24,117,0,Lenoir,2022-01-06
48,2,46,0,Washington,2022-01-06
38,2,36,0,Caswell,2021-12-28
3944,232,3712,3,Wake,2021-12-28
3375,381,2994,5,Mecklenburg,2021-12-28
64,6,58,0,Bertie,2022-01-06
185,52,133,1,Wilson,2021-12-28
440,85,355,1,Buncombe,2021-12-28
168,45,123,0,Granville,2021-12-28
244,20,224,0,Nash,2021-12-28
81,18,63,0,Rutherford,2021-12-28
165,28,137,0,Cleveland,2021-12-28
63,10,53,0,Anson,2022-01-06
97,47,50,0,Wilkes,2021-12-28
33,8,25,0,Perquimans,2022-01-06
436,22,414,0,Pitt,2021-12-28
187,33,154,0,Moore,2021-12-28
666,87,579,0,Cumberland,2021-12-28
656,112,544,0,New Hanover,2022-01-06
43,15,28,0,Swain,2022-01-06
217,54,163,1,Harnett,2021-12-28
127,55,72,0,Carteret,2022-01-06
109,13,96,0,Scotland,2021-12-28
20,7,13,0,Camden,2022-01-06
132,11,121,1,Beaufort,2022-01-06
41,18,23,1,Transylvania,2022-01-06
146,36,110,0,Vance,2021-12-28
42,5,37,1,Martin,2021-12-28
104,10,94,0,Pender,2021-12-28
33,12,21,0,Transylvania,2021-12-28
121,34,87,1,Surry,2021-12-28
47,29,18,0,Alexander,2021-12-28
69,21,48,0,Carteret,2021-12-28
509,88,421,1,Rowan,2022-01-19
656,153,503,4,Cabarrus,2022-01-19
114,15,99,0,Montgomery,2022-01-19
550,223,327,0,Wayne,2022-01-19
631,239,392,1,Iredell,2022-01-19
185,27,158,0,Davie,2022-01-19
610,164,446,1,Buncombe,2022-01-19
76,16,60,1,Macon,2022-01-06
131,45,86,0,Craven,2021-12-28
883,114,769,1,Onslow,2022-01-19
185,21,164,0,Chatham,2022-01-19
273,63,210,0,Wilson,2022-01-19
45,4,41,0,Bertie,2022-01-19
55,5,50,0,Jackson,2021-12-28
83,8,75,0,Caswell,2022-01-19
20,6,14,1,Alleghany,2021-12-28
190,18,172,0,Granville,2022-01-19
44,21,23,0,Yancey,2022-01-06
39,16,23,0,Jones,2022-01-19
291,53,238,1,Stanly,2022-01-19
36,12,24,0,Pasquotank,2021-12-28
322,132,190,1,Duplin,2022-01-12
23,9,14,0,Swain,2022-01-12
283,79,204,1,Lincoln,2022-01-12
638,193,445,1,Iredell,2022-01-12
321,78,243,2,Surry,2022-01-12
717,76,641,3,Alamance,2022-01-12
643,86,557,2,Davidson,2022-01-12
231,48,183,1,Richmond,2022-01-12
409,27,382,0,Nash,2022-01-12
1011,171,840,0,Johnston,2022-01-12
561,60,501,3,Rowan,2022-01-12
64,9,55,0,Avery,2022-01-19
417,47,370,0,Moore,2022-01-12
228,23,205,0,Beaufort,2022-01-12
92,25,67,0,Macon,2022-01-12
22,3,19,0,Gates,2022-01-19
97,41,56,1,Greene,2022-01-19
61,7,54,0,Washington,2022-01-12
150,17,133,1,Yadkin,2022-01-12
295,40,255,0,Hoke,2022-01-12
56,26,30,0,Polk,2022-01-12
86,4,82,0,Chowan,2022-01-12
137,36,101,0,McDowell,2022-01-12
200,68,132,0,Haywood,2022-01-19
230,75,155,1,Wilkes,2022-01-12
154,25,129,1,Stokes,2022-01-12
130,42,88,0,Alexander,2022-01-12
214,27,187,0,Pender,2022-01-12
70,14,56,0,Cherokee,2022-01-12
317,105,212,0,Craven,2022-01-12
73,27,46,0,Yancey,2022-01-12
673,131,542,3,Union,2022-01-20
1341,167,1174,7,Guilford,2022-01-20
714,141,573,2,Gaston,2022-01-20
148,52,96,2,McDowell,2022-01-20
148,38,110,2,Richmond,2022-01-20
247,46,201,0,Hoke,2022-01-20
284,40,244,4,Rockingham,2022-01-20
652,169,483,1,New Hanover,2022-01-20
27,3,24,0,Clay,2022-01-20
116,38,78,0,Scotland,2022-01-20
254,58,196,0,Lenoir,2022-01-20
314,9,305,0,Franklin,2022-01-20
193,33,160,0,Beaufort,2022-01-20
253,69,184,2,Lincoln,2022-01-20
605,228,377,2,Catawba,2022-01-20
543,73,470,1,Davidson,2022-01-20
279,87,192,0,Craven,2022-01-20
154,42,112,1,Yadkin,2022-01-20
137,32,105,6,Stokes,2022-01-20
23,6,17,0,Gates,2022-01-20
118,14,104,1,Vance,2022-01-20
664,28,636,4,Forsyth,2022-01-08
120,42,78,1,Burke,2022-01-08
111,15,96,0,Granville,2022-01-08
205,88,117,0,Robeson,2022-01-08
162,29,133,2,Rowan,2022-01-08
218,63,155,3,Iredell,2022-01-08
59,8,51,0,Warren,2022-01-19
15,11,4,0,Graham,2022-01-06
86,4,82,0,Martin,2022-01-12
34,6,28,1,Perquimans,2022-01-12
76,10,66,0,Martin,2022-01-20
60,6,54,0,Halifax,2022-01-08
41,16,25,0,Gates,2022-01-12
115,11,104,0,Rockingham,2022-01-08
105,25,80,3,Macon,2022-01-20
25,1,24,0,Currituck,2022-01-08
29,7,22,0,Perquimans,2022-01-20
42,6,36,0,Montgomery,2022-01-08
79,12,67,0,Chatham,2022-01-08
89,27,62,2,Henderson,2022-01-08
14,7,7,0,Camden,2022-01-19
64,36,28,0,Swain,2022-01-20
32,7,25,0,Washington,2022-01-20
23,1,22,0,Hyde,2022-01-12
14,1,13,0,Caswell,2022-01-08
26,0,26,0,Northampton,2022-01-08
38,6,32,0,Bertie,2022-01-20
62,17,45,1,Stanly,2022-01-08
13,1,12,0,Greene,2022-01-08
50,17,33,1,Iredell,2022-02-16
770,217,553,3,New Hanover,2022-01-24
167,60,107,1,McDowell,2022-01-24
69,4,65,2,Alamance,2022-02-16
415,14,401,1,Orange,2022-01-24
673,52,621,0,Pitt,2022-01-24
629,218,411,5,Buncombe,2022-01-24
138,7,131,0,Vance,2022-01-24
228,97,131,1,Sampson,2022-01-24
195,77,118,2,Rutherford,2022-01-24
49,10,39,0,Davidson,2022-02-16
115,35,80,2,Scotland,2022-01-24
37,9,28,1,Lincoln,2022-02-16
32,18,14,1,Wayne,2021-12-08
62,3,59,1,Durham,2021-12-08
17,3,14,0,Lee,2021-12-08
31,17,14,0,Duplin,2021-12-08
26,6,20,0,Davie,2021-12-08
58,25,33,0,Henderson,2021-12-08
19,8,11,0,Granville,2021-12-08
21,2,19,0,Orange,2021-12-08
70,7,63,2,Rowan,2021-12-08
45,20,25,0,Randolph,2021-12-08
75,30,45,1,Buncombe,2021-12-08
25,11,14,0,Wilson,2021-12-08
37,2,35,1,Stanly,2021-12-08
28,9,19,0,Haywood,2021-12-08
46,7,39,0,Onslow,2021-12-08
11,1,10,0,Ashe,2021-12-11
3,0,3,0,Pasquotank,2021-12-11
23,7,16,1,Burke,2021-12-11
29,4,25,0,Harnett,2021-12-11
16,1,15,0,Davie,2021-12-11
7,5,2,0,Transylvania,2021-12-11
14,5,9,0,Craven,2021-12-11
5,3,2,0,Alleghany,2021-12-11
28,13,15,1,Randolph,2021-12-11
14,5,9,1,Yadkin,2021-12-11
12,0,12,0,Orange,2021-12-11
5,0,5,0,Camden,2021-12-11
16,4,12,0,Rutherford,2021-12-11
6,0,6,0,Edgecombe,2021-12-11
2,1,1,1,Swain,2021-12-11
77,27,50,2,Randolph,2021-12-14
16,0,16,0,Edgecombe,2021-12-14
20,9,11,0,Wayne,2021-12-14
14,6,8,0,Alleghany,2021-12-14
459,92,367,2,Mecklenburg,2021-12-14
32,10,22,0,Vance,2021-12-14
43,3,40,0,Orange,2021-12-14
20,0,20,2,Lee,2021-12-14
22,8,14,0,Haywood,2021-12-14
30,6,24,0,Davie,2021-12-14
18,7,11,0,Pasquotank,2021-12-14
67,5,62,1,Pitt,2021-12-14
21,2,19,0,Granville,2021-12-14
69,12,57,0,Onslow,2021-12-14
112,56,56,1,Buncombe,2021-12-14
21,9,12,0,Craven,2021-12-14
79,10,69,0,Durham,2021-12-15
168,30,138,0,Cumberland,2021-12-15
38,10,28,0,Robeson,2021-12-15
27,3,24,1,Lee,2021-12-15
50,15,35,2,Harnett,2021-12-15
55,12,43,0,Harnett,2021-12-14
10,2,8,1,Rutherford,2021-12-14
61,32,29,0,Randolph,2021-12-15
28,14,14,0,Sampson,2021-12-14
58,10,48,0,Onslow,2021-12-15
26,14,12,0,Yancey,2021-12-15
62,27,35,1,Henderson,2021-12-15
4,1,3,0,Greene,2021-12-15
13,6,7,0,Pasquotank,2021-12-15
12,4,8,0,Swain,2021-12-14
30,7,23,0,Wilson,2021-12-14
15,6,9,0,Avery,2021-12-15
13,9,4,0,Sampson,2021-12-15
9,6,3,0,Columbus,2021-12-15
29,4,25,0,Chatham,2021-12-15
105,54,51,0,Duplin,2022-01-15
14,4,10,0,Ashe,2021-12-15
28,10,18,0,Person,2021-12-15
35,7,28,0,Davie,2022-01-15
238,52,186,2,Randolph,2022-01-15
669,21,648,2,Durham,2022-01-15
12,3,9,0,Hertford,2022-01-15
304,65,239,5,Cabarrus,2022-01-15
61,5,56,1,Haywood,2022-01-15
269,90,179,0,Wayne,2022-01-15
57,3,54,0,Halifax,2022-01-15
17,1,16,0,Washington,2022-01-15
325,117,208,1,Robeson,2022-01-15
130,42,88,2,Craven,2022-01-15
119,38,81,0,Stanly,2022-01-15
311,9,302,2,Onslow,2022-01-15
147,24,123,0,Guilford,2021-12-18
93,21,72,0,Johnston,2021-12-18
195,5,190,0,Orange,2022-01-15
87,7,80,0,Durham,2021-12-18
22,7,15,1,Robeson,2021-12-18
59,7,52,3,Cabarrus,2021-12-18
11,6,5,0,Person,2021-12-18
20,7,13,0,Avery,2021-12-18
74,8,66,0,Person,2022-01-15
40,19,21,0,Randolph,2021-12-18
11,4,7,0,Currituck,2021-12-18
29,4,25,0,Onslow,2021-12-18
18,6,12,0,Davie,2021-12-18
1,0,1,0,Pamlico,2021-12-18
12,5,7,1,Rutherford,2021-12-08
6,3,3,0,Bladen,2021-12-08
24,10,14,0,Craven,2021-12-08
8,6,2,0,Avery,2021-12-08
8,2,6,0,Richmond,2021-12-11
9,0,9,0,Granville,2021-12-11
7,1,6,0,Wilson,2021-12-11
35,6,29,0,Buncombe,2021-12-11
9,2,7,0,Sampson,2021-12-11
10,6,4,1,Person,2021-12-11
10,3,7,0,Wayne,2021-12-11
31,2,29,0,Onslow,2021-12-11
31,9,22,0,Caldwell,2021-12-14
3,0,3,0,Pamlico,2021-12-14
43,13,30,0,Transylvania,2021-12-14
6,3,3,0,Madison,2021-12-14
9,4,5,1,Haywood,2021-12-18
10,2,8,0,Warren,2021-12-15
1,0,1,0,Tyrrell,2021-12-15
47,14,33,0,Bladen,2022-01-15
7,2,5,0,Jones,2022-01-15
26,3,23,2,Wilkes,2022-01-16
42,1,41,0,Beaufort,2022-01-16
114,7,107,1,Durham,2022-01-16
132,19,113,0,Pitt,2022-01-16
259,36,223,0,New Hanover,2022-01-16
13,1,12,0,Chatham,2022-01-16
8,1,7,0,Richmond,2021-12-18
9,3,6,0,Camden,2022-01-15
3,3,0,0,Alleghany,2022-01-15
12,0,12,1,Macon,2022-01-16
16,5,11,1,Scotland,2022-01-16
87,17,70,0,Union,2022-01-16
10,0,10,0,Cherokee,2022-01-16
29,4,25,2,Davidson,2022-01-16
9,0,9,0,Bertie,2022-01-16
53,9,44,0,Carteret,2022-01-16
8,2,6,0,Swain,2022-01-16
18,6,12,1,Rockingham,2022-01-16
58,10,48,3,Gaston,2022-01-16
41,6,35,1,Franklin,2022-01-16
55,21,34,0,Catawba,2022-01-16
29,6,23,0,Richmond,2022-01-16
90,13,77,1,Davidson,2021-12-07
69,5,64,0,Alamance,2021-12-07
326,28,298,0,Wake,2021-12-07
63,23,40,1,Catawba,2021-12-07
48,9,39,0,Brunswick,2021-12-07
34,1,33,0,Moore,2021-12-07
96,27,69,2,Johnston,2021-12-07
51,11,40,0,New Hanover,2021-12-07
15,12,3,0,Yancey,2021-12-07
2,0,2,0,Clay,2021-12-07
26,3,23,0,Hoke,2021-12-07
16,3,13,0,Pender,2021-12-07
25,2,23,0,Franklin,2021-12-07
53,25,28,0,Surry,2021-12-07
11,2,9,1,Jackson,2021-12-07
20,5,15,0,Chatham,2021-12-07
6,0,6,0,Mitchell,2021-12-07
7,2,5,0,Anson,2021-12-07
19,6,13,0,Craven,2021-12-10
64,1,63,0,Pitt,2021-12-10
20,2,18,0,Orange,2021-12-10
81,14,67,0,Union,2021-12-10
89,17,72,2,Gaston,2021-12-10
66,27,39,1,Buncombe,2021-12-10
6,3,3,0,Transylvania,2021-12-10
25,4,21,0,Cleveland,2021-12-10
446,45,401,0,Wake,2021-12-13
12,3,9,0,Hoke,2021-12-10
40,8,32,0,Lincoln,2021-12-10
16,7,9,0,Wilson,2021-12-10
3,0,3,0,Chowan,2021-12-10
40,2,38,1,Moore,2021-12-13
58,9,49,1,Brunswick,2021-12-13
26,7,19,1,Beaufort,2021-12-13
19,8,11,0,Yancey,2021-12-10
17,7,10,1,Scotland,2021-12-13
123,56,67,1,Buncombe,2021-12-13
53,7,46,0,Caldwell,2021-12-13
32,6,26,0,McDowell,2021-12-13
16,1,15,0,Rutherford,2021-12-13
35,17,18,0,Duplin,2021-12-13
19,2,17,0,Hoke,2021-12-13
28,5,23,0,Vance,2021-12-13
33,0,33,0,Dare,2021-12-13
41,22,19,0,Wilkes,2021-12-13
22,5,17,0,Alexander,2021-12-13
105,17,88,0,Davidson,2021-12-13
34,5,29,0,Franklin,2021-12-13
35,7,28,0,Granville,2021-12-13
36,1,35,0,Orange,2021-12-13
22,5,17,0,Madison,2021-12-13
24,17,7,0,Sampson,2021-12-16
17,6,11,0,Rutherford,2021-12-16
30,4,26,0,Stanly,2021-12-16
10,4,6,0,Duplin,2021-12-16
28,10,18,0,Craven,2021-12-16
110,43,67,0,Buncombe,2021-12-16
15,7,8,1,Ashe,2021-12-16
40,10,30,0,Rockingham,2021-12-17
19,1,18,0,Edgecombe,2021-12-17
21,7,14,0,Granville,2021-12-16
103,5,98,0,Union,2021-12-17
2,0,2,0,Hertford,2021-12-16
32,6,26,0,Moore,2021-12-16
62,17,45,1,Catawba,2021-12-17
30,11,19,0,Yadkin,2021-12-17
36,2,34,0,Pitt,2021-12-17
94,6,88,0,Durham,2021-12-17
17,4,13,1,Beaufort,2021-12-17
6,1,5,0,Camden,2021-12-16
16,3,13,0,Scotland,2021-12-17
3,2,1,0,Perquimans,2021-12-17
4,1,3,0,Washington,2021-12-17
9,4,5,0,Graham,2021-12-17
22,5,17,0,Cleveland,2021-12-17
28,5,23,0,Harnett,2021-12-19
23,5,18,0,Lee,2021-12-17
4,0,4,0,Bertie,2021-12-17
41,1,40,0,Pitt,2021-12-19
20,5,15,0,Watauga,2021-12-19
15,3,12,0,Davie,2021-12-19
16,3,13,0,Granville,2021-12-19
28,2,26,0,Moore,2021-12-19
60,22,38,1,Buncombe,2021-12-19
42,23,19,0,Henderson,2021-12-19
10,4,6,0,Cherokee,2021-12-07
17,1,16,0,Beaufort,2021-12-07
30,4,26,0,Cleveland,2021-12-07
20,5,15,0,Richmond,2021-12-07
5,4,1,0,Rutherford,2021-12-07
27,17,10,0,Alexander,2021-12-07
9,4,5,0,Swain,2021-12-07
18,1,17,0,Beaufort,2021-12-10
12,5,7,0,Lenoir,2021-12-10
9,0,9,0,Chowan,2021-12-13
8,4,4,0,Jackson,2021-12-13
10,1,9,0,Cherokee,2021-12-13
11,3,8,0,Currituck,2021-12-16
21,10,11,0,Columbus,2021-12-16
14,10,4,0,Avery,2021-12-16
81,7,74,1,Davidson,2021-12-17
8,2,6,0,Macon,2021-12-17
21,4,17,0,Wilson,2021-12-17
6,1,5,0,Duplin,2021-12-19
12,5,7,0,Wayne,2021-12-19
5,3,2,0,Camden,2021-12-19
8,7,1,0,Mitchell,2021-12-16
12,0,12,0,Pender,2021-12-17
38,7,31,0,Pender,2021-12-21
1039,103,936,1,Wake,2021-12-21
18,5,13,1,Craven,2021-12-19
16,4,12,0,Burke,2021-12-19
39,19,20,1,Wilkes,2021-12-21
195,19,176,0,Durham,2021-12-21
27,10,17,0,Person,2021-12-21
101,5,96,0,Pitt,2021-12-21
28,0,28,0,Edgecombe,2021-12-21
63,11,52,0,Brunswick,2021-12-21
17,5,12,0,Anson,2021-12-21
32,7,25,0,McDowell,2021-12-21
16,0,16,0,Madison,2021-12-21
59,4,55,0,Nash,2021-12-21
14,4,10,0,Pasquotank,2021-12-21
35,4,31,0,Lenoir,2021-12-21
64,17,47,0,Lincoln,2021-12-21
29,19,10,0,Transylvania,2021-12-21
19,9,10,0,Alexander,2021-12-21
63,11,52,1,Harnett,2021-12-21
9,0,9,0,Cherokee,2021-12-21
412,66,346,1,Rowan,2022-01-05
170,35,135,0,Chatham,2022-01-05
806,156,650,1,Onslow,2022-01-05
20,15,5,1,Sampson,2021-12-21
46,15,31,0,Watauga,2021-12-21
64,8,56,0,Cleveland,2021-12-21
57,22,35,1,Surry,2021-12-21
449,154,295,2,Robeson,2022-01-05
647,130,517,2,Cabarrus,2022-01-05
526,182,344,0,Iredell,2022-01-05
88,7,81,0,Caswell,2022-01-05
304,112,192,1,Randolph,2022-01-05
26,7,19,0,Carteret,2021-12-21
130,36,94,3,Haywood,2022-01-05
78,14,64,0,Montgomery,2022-01-05
175,14,161,0,Granville,2022-01-05
161,85,76,0,Columbus,2022-01-05
112,33,79,1,Stokes,2022-01-05
4,0,4,0,Warren,2021-12-19
12,6,6,0,Transylvania,2021-12-19
14,10,4,0,Martin,2022-01-16
7,0,7,0,Hyde,2022-01-16
18,0,18,0,Avery,2022-01-15
7,0,7,0,Person,2022-01-16
49,19,30,1,Duplin,2022-01-16
17,2,15,0,Edgecombe,2022-01-16
5,2,3,0,Halifax,2021-12-08
10,3,7,0,Perquimans,2022-01-16
3,0,3,0,Pamlico,2021-12-08
4,1,3,0,Carteret,2021-12-11
4,1,3,0,Camden,2021-12-14
2,0,2,0,Columbus,2021-12-18
10,6,4,0,Gates,2022-01-15
2,0,2,0,Caswell,2021-12-18
16,1,15,0,Stokes,2021-12-18
14,2,12,1,Cleveland,2022-01-16
10,4,6,0,Washington,2022-01-16
113,11,102,1,Davie,2022-01-06
515,189,326,0,Robeson,2022-01-06
1323,96,1227,0,Durham,2022-01-06
38,11,27,0,Mitchell,2022-01-06
121,16,105,0,Bladen,2022-01-06
669,75,594,2,Alamance,2022-01-06
636,175,461,3,Cabarrus,2022-01-06
777,100,677,0,Johnston,2022-01-06
150,15,135,0,Granville,2022-01-06
98,15,83,0,Hertford,2022-01-06
87,6,81,0,Greene,2022-01-06
266,63,203,1,Randolph,2022-01-06
77,14,63,0,Warren,2022-01-06
271,30,241,1,Rowan,2021-12-28
172,22,150,0,Halifax,2021-12-28
77,16,61,0,Northampton,2022-01-06
265,80,185,2,Randolph,2021-12-28
478,41,437,0,Alamance,2021-12-28
303,55,248,0,Halifax,2022-01-06
269,117,152,0,Sampson,2022-01-06
802,72,730,1,Forsyth,2021-12-28
205,48,157,1,Caldwell,2022-01-06
255,59,196,1,Robeson,2021-12-28
907,55,852,0,Durham,2021-12-28
532,86,446,0,Johnston,2021-12-28
427,137,290,1,Iredell,2021-12-28
294,46,248,1,Moore,2022-01-06
132,19,113,0,Stanly,2021-12-28
68,1,67,0,Dare,2021-12-28
256,100,156,0,Duplin,2022-01-06
131,22,109,0,Lee,2021-12-28
338,22,316,0,Onslow,2021-12-28
58,8,50,0,Stokes,2021-12-28
137,18,119,2,Henderson,2021-12-28
216,12,204,0,Franklin,2021-12-28
77,4,73,0,Columbus,2021-12-28
47,3,44,0,Madison,2022-01-06
121,25,96,0,Chatham,2021-12-28
23,5,18,0,Mitchell,2021-12-28
212,80,132,0,Carteret,2022-01-19
888,201,687,0,New Hanover,2022-01-19
350,146,204,3,Duplin,2022-01-19
110,6,104,0,Martin,2022-01-19
56,17,39,1,Ashe,2022-01-06
426,121,305,0,Craven,2022-01-19
212,40,172,1,Beaufort,2022-01-19
724,274,450,2,Catawba,2022-01-19
245,64,181,1,Surry,2022-01-19
576,60,516,0,Davidson,2022-01-19
143,23,120,0,Rockingham,2021-12-28
181,29,152,1,Richmond,2022-01-19
824,193,631,0,Union,2022-01-19
84,6,78,0,Madison,2022-01-19
843,89,754,0,Pitt,2022-01-19
1014,52,962,1,Durham,2022-01-19
68,9,59,0,Washington,2022-01-19
118,19,99,1,Person,2022-01-06
171,64,107,0,McDowell,2022-01-19
23,10,13,0,Jones,2022-01-06
422,21,401,1,Franklin,2022-01-19
32,4,28,0,Currituck,2021-12-28
252,67,185,0,Wilkes,2022-01-19
133,37,96,1,Scotland,2022-01-19
482,77,405,3,Brunswick,2022-01-19
48,10,38,0,Ashe,2021-12-28
56,15,41,0,Cherokee,2022-01-06
473,107,366,1,Randolph,2022-01-12
912,58,854,2,Pitt,2022-01-12
4082,527,3555,1,Mecklenburg,2022-01-12
233,26,207,1,Halifax,2022-01-12
717,269,448,0,Robeson,2022-01-12
878,135,743,0,Onslow,2022-01-12
552,150,402,1,Harnett,2022-01-12
170,26,144,0,Person,2022-01-12
393,124,269,0,Burke,2022-01-12
64,14,50,1,Northampton,2022-01-12
295,96,199,0,Henderson,2022-01-12
399,132,267,0,Sampson,2022-01-12
281,42,239,0,Pender,2022-01-19
156,32,124,0,Bladen,2022-01-12
136,52,84,0,Jackson,2022-01-19
121,33,88,0,Cherokee,2022-01-19
171,48,123,0,Watauga,2022-01-12
150,6,144,0,Edgecombe,2022-01-19
349,89,260,1,Caldwell,2022-01-12
188,14,174,1,Person,2022-01-19
23,1,22,0,Pamlico,2022-01-12
99,44,55,0,Bertie,2022-01-12
185,10,175,2,Edgecombe,2022-01-12
54,25,29,0,Swain,2022-01-19
160,14,146,0,Vance,2022-01-12
81,7,74,0,Warren,2022-01-12
152,62,90,0,Haywood,2022-01-12
2792,405,2387,5,Mecklenburg,2022-01-20
8,2,6,0,Tyrrell,2022-01-06
56,5,51,0,Warren,2021-12-28
698,214,484,3,Buncombe,2022-01-20
147,20,127,1,Halifax,2022-01-20
536,41,495,0,Alamance,2022-01-20
758,116,642,0,Johnston,2022-01-20
161,35,126,0,Davie,2022-01-20
611,131,480,2,Cabarrus,2022-01-20
36,5,31,0,Avery,2022-01-20
458,211,247,0,Wayne,2022-01-20
30,2,28,0,Montgomery,2021-12-28
22,1,21,0,Pamlico,2022-01-06
133,15,118,0,Montgomery,2022-01-12
406,13,393,0,Orange,2022-01-20
1188,195,993,0,Cumberland,2022-01-20
256,51,205,0,Stanly,2022-01-20
888,36,852,2,Durham,2022-01-20
272,50,222,0,Wilson,2022-01-20
309,52,257,2,Moore,2022-01-20
255,117,138,1,Duplin,2022-01-20
252,89,163,0,Burke,2022-01-20
264,118,146,3,Henderson,2022-01-20
160,12,148,0,Granville,2022-01-20
15,5,10,0,Gates,2021-12-28
712,41,671,0,Durham,2022-01-08
3211,115,3096,4,Wake,2022-01-08
265,62,203,1,New Hanover,2022-01-08
387,84,303,1,Union,2022-01-08
289,47,242,3,Buncombe,2022-01-08
62,7,55,0,Wilson,2022-01-08
286,87,199,1,Cabarrus,2022-01-08
48,27,21,0,Polk,2022-01-20
272,42,230,0,Pitt,2022-01-08
54,0,54,0,Edgecombe,2022-01-08
14,1,13,0,Tyrrell,2022-01-20
24,5,19,0,Perquimans,2022-01-19
211,17,194,1,Orange,2022-01-08
16,2,14,0,Bladen,2021-12-21
34,10,24,0,Mitchell,2022-01-05
43,7,36,0,Avery,2022-01-05
18,4,14,0,Gates,2022-01-05
50,22,28,0,Robeson,2021-12-07
69,22,47,0,Randolph,2021-12-07
43,9,34,0,Harnett,2021-12-07
136,18,118,0,Cumberland,2021-12-07
17,5,12,1,Haywood,2021-12-07
10,5,5,0,Columbus,2021-12-07
10,2,8,0,Greene,2021-12-07
8,2,6,0,Bladen,2021-12-07
7,2,5,0,Alleghany,2021-12-07
29,12,17,0,Burke,2021-12-07
41,5,36,0,Onslow,2021-12-07
61,4,57,0,Rowan,2021-12-10
55,8,47,2,Robeson,2021-12-10
51,21,30,0,Randolph,2021-12-10
16,2,14,1,Caldwell,2021-12-10
49,12,37,0,Henderson,2021-12-10
14,1,13,0,Lee,2021-12-10
73,7,66,0,Davidson,2021-12-10
37,4,33,0,Onslow,2021-12-10
23,13,10,0,Ashe,2021-12-10
19,13,6,0,Wayne,2021-12-10
34,15,19,0,Yadkin,2021-12-13
26,7,19,0,Chatham,2021-12-13
5,2,3,0,Tyrrell,2021-12-13
40,7,33,0,Stanly,2021-12-13
43,11,32,2,Rockingham,2021-12-13
133,41,92,0,Johnston,2021-12-13
4,0,4,0,Northampton,2021-12-13
20,6,14,0,Burke,2021-12-10
23,8,15,1,Stanly,2021-12-10
179,25,154,0,Cumberland,2021-12-13
139,41,98,1,Gaston,2021-12-13
48,8,40,0,Harnett,2021-12-13
192,31,161,0,Guilford,2021-12-13
40,18,22,0,Yancey,2021-12-13
31,17,14,1,Sampson,2021-12-13
28,8,20,0,Haywood,2021-12-13
67,29,38,0,Randolph,2021-12-13
67,15,52,0,Onslow,2021-12-13
18,3,15,0,Halifax,2021-12-13
55,22,33,0,Robeson,2021-12-13
15,1,14,0,Greene,2021-12-13
25,12,13,0,Columbus,2021-12-13
30,4,26,0,Chatham,2021-12-16
67,12,55,0,Brunswick,2021-12-16
25,11,14,0,Yadkin,2021-12-16
106,42,64,0,Iredell,2021-12-16
55,19,36,0,Surry,2021-12-16
67,5,62,1,Davidson,2021-12-16
38,3,35,0,Nash,2021-12-16
28,1,27,0,Lee,2021-12-16
112,24,88,2,Gaston,2021-12-16
41,7,34,0,Cleveland,2021-12-16
15,4,11,1,Pender,2021-12-16
74,24,50,1,New Hanover,2021-12-16
11,4,7,0,Madison,2021-12-16
71,31,40,0,Catawba,2021-12-16
104,24,80,3,Iredell,2021-12-17
10,8,2,0,Avery,2021-12-17
75,8,67,1,Alamance,2021-12-16
8,3,5,0,Duplin,2021-12-17
13,2,11,0,Lenoir,2021-12-16
11,0,11,0,Beaufort,2021-12-16
16,4,12,1,Halifax,2021-12-17
51,19,32,0,Henderson,2021-12-17
10,1,9,0,Hoke,2021-12-16
22,6,16,1,Haywood,2021-12-17
18,5,13,0,Granville,2021-12-17
4,1,3,0,Jones,2021-12-17
26,0,26,0,Greene,2021-12-16
52,8,44,0,Harnett,2021-12-16
37,3,34,1,Stanly,2021-12-17
28,18,10,1,Wayne,2021-12-17
131,10,121,1,Guilford,2021-12-19
97,14,83,3,Forsyth,2021-12-19
68,19,49,1,Gaston,2021-12-19
45,18,27,0,Randolph,2021-12-19
25,7,18,0,Rowan,2021-12-19
33,1,32,0,Alamance,2021-12-19
27,1,26,1,Rockingham,2021-12-19
20,5,15,0,Stokes,2021-12-19
19,6,13,1,Robeson,2021-12-19
40,2,38,0,Caldwell,2021-12-07
20,8,12,1,Watauga,2021-12-07
35,20,15,0,Sampson,2021-12-07
8,0,8,0,Halifax,2021-12-10
20,4,16,0,Chatham,2021-12-10
28,9,19,0,Davie,2021-12-10
17,3,14,0,Granville,2021-12-10
11,6,5,1,Sampson,2021-12-10
7,2,5,0,Greene,2021-12-10
20,1,19,0,Lee,2021-12-13
13,1,12,0,Carteret,2021-12-16
6,2,4,0,Scotland,2021-12-16
27,19,8,2,Wilkes,2021-12-16
30,12,18,0,Davie,2021-12-17
8,0,8,0,Dare,2021-12-19
9,4,5,0,Chatham,2021-12-19
17,4,13,0,Carteret,2021-12-19
14,2,12,0,Onslow,2021-12-19
21,6,15,1,Jackson,2021-12-16
7,1,6,0,Northampton,2021-12-17
17,9,8,0,Greene,2021-12-17
8,2,6,0,Bladen,2021-12-17
2,0,2,0,Caswell,2021-12-17
10,1,9,0,Lee,2021-12-19
15,7,8,2,Yadkin,2021-12-19
10,3,7,0,Haywood,2021-12-19
154,63,91,1,Iredell,2021-12-21
42,8,34,0,Chatham,2021-12-21
119,4,115,1,Alamance,2021-12-21
261,30,231,2,Forsyth,2021-12-21
88,10,78,1,Rowan,2021-12-21
72,4,68,1,Onslow,2021-12-21
85,23,62,0,Randolph,2021-12-21
6,2,4,0,Mitchell,2021-12-21
64,23,41,1,Robeson,2021-12-21
19,7,12,0,Currituck,2021-12-21
19,7,12,0,Columbus,2021-12-21
28,4,24,1,Lee,2021-12-21
20,0,20,0,Dare,2021-12-21
6270,228,6042,2,Wake,2022-01-05
394,20,374,0,Franklin,2022-01-05
529,201,328,2,Catawba,2022-01-05
52,21,31,0,Greene,2022-01-05
462,37,425,0,Nash,2022-01-05
749,86,663,3,Gaston,2022-01-05
85,15,70,0,Anson,2022-01-05
1382,80,1302,1,Durham,2022-01-05
160,51,109,0,Wilkes,2022-01-05
649,37,612,1,Pitt,2022-01-05
35,16,19,0,Polk,2022-01-05
480,69,411,3,Davidson,2022-01-05
1267,119,1148,2,Cumberland,2022-01-05
108,25,83,0,Pasquotank,2022-01-05
78,8,70,0,Martin,2022-01-05
181,25,156,1,Vance,2022-01-05
402,88,314,0,Brunswick,2022-01-05
39,20,19,0,Swain,2022-01-05
204,56,148,0,Scotland,2022-01-05
15,0,15,0,Pender,2021-12-19
112,14,98,0,Pender,2022-01-05
553,147,406,1,New Hanover,2022-01-05
263,8,255,1,Edgecombe,2022-01-05
229,54,175,0,Craven,2022-01-05
22,4,18,0,Washington,2022-01-08
13,0,13,0,Perquimans,2022-01-08
179,8,171,0,Franklin,2022-01-08
225,61,164,5,Catawba,2022-01-08
69,7,62,0,Richmond,2022-01-08
71,13,58,0,Montgomery,2022-01-20
154,3,151,0,Hoke,2022-01-08
51,17,34,0,Yancey,2022-01-20
30,11,19,0,Carteret,2022-01-08
68,12,56,0,Pender,2022-01-08
84,12,72,1,Caswell,2022-01-20
125,59,66,0,Duplin,2022-01-08
77,24,53,0,Craven,2022-01-08
70,13,57,2,Yadkin,2022-01-08
39,12,27,0,Hertford,2022-01-20
64,7,57,0,Currituck,2022-01-12
35,0,35,1,Davie,2022-01-08
63,19,44,0,Scotland,2022-01-08
64,8,56,1,Person,2022-01-08
17,2,15,0,Macon,2022-01-08
19,11,8,0,Ashe,2022-01-08
47,17,30,1,Burke,2022-02-16
28,10,18,1,Robeson,2022-02-16
25,9,16,0,Watauga,2022-02-16
299,43,256,3,Mecklenburg,2022-02-16
539,56,483,1,Davidson,2022-01-24
11,2,9,0,Davie,2022-02-16
11,1,10,0,Bladen,2022-02-16
504,53,451,1,Alamance,2022-01-24
256,103,153,0,Henderson,2022-01-24
1195,172,1023,7,Guilford,2022-01-24
145,23,122,0,Person,2022-01-24
594,219,375,0,Catawba,2022-01-24
507,154,353,0,Iredell,2022-01-24
172,34,138,2,Halifax,2022-01-24
291,65,226,0,Rockingham,2022-01-24
774,37,737,1,Durham,2022-01-24
252,48,204,1,Stanly,2022-01-24
150,54,96,4,Haywood,2022-01-24
6,0,6,0,Pamlico,2022-02-16
27,8,19,1,Haywood,2022-02-16
166,43,123,0,Stokes,2022-01-24
49,12,37,3,Northampton,2022-01-24
59,6,53,3,Onslow,2022-02-16
28,13,15,2,Sampson,2022-02-16
125,29,96,0,Greene,2022-01-24
84,0,84,0,Dare,2022-01-24
192,22,170,0,Beaufort,2022-01-24
40,5,35,0,Harnett,2022-02-16
23,8,15,0,Watauga,2022-02-17
27,1,26,0,Pasquotank,2022-02-16
395,49,346,3,Wake,2022-02-17
28,11,17,0,Henderson,2022-02-17
237,41,196,2,Mecklenburg,2022-02-17
33,16,17,0,McDowell,2022-02-17
53,6,47,0,Harnett,2022-02-17
62,5,57,1,Onslow,2022-02-17
5,1,4,0,Pamlico,2022-02-17
41,2,39,0,Pitt,2022-02-17
87,11,76,0,Montgomery,2022-01-24
135,29,106,1,Mecklenburg,2022-02-24
22,5,17,1,Cabarrus,2022-02-24
12,0,12,0,Bladen,2022-02-24
23,6,17,1,Pitt,2022-02-24
4,1,3,0,Warren,2022-02-24
8,4,4,1,Wayne,2022-02-24
157,48,109,1,Caldwell,2022-01-24
52,7,45,1,Mecklenburg,2022-03-10
24,5,19,0,Cumberland,2022-03-10
3,0,3,1,Bladen,2022-03-10
23,3,20,0,Durham,2022-03-10
9,4,5,1,Lee,2022-03-10
53,15,38,0,Mitchell,2022-01-24
29,4,25,1,Mecklenburg,2022-03-19
1,0,1,0,Edgecombe,2022-03-10
23,2,21,1,Forsyth,2022-03-21
1,0,1,0,Jackson,2022-03-21
39,9,30,0,Guilford,2022-03-21
2,0,2,0,Rockingham,2022-03-22
5,4,1,0,Craven,2022-03-28
44,9,35,1,Durham,2022-03-29
22,2,20,0,Cumberland,2022-03-22
38,11,27,1,Guilford,2022-03-22
5,2,3,0,Granville,2022-04-08
25,6,19,0,Cumberland,2022-04-08
8,2,6,0,Rowan,2022-04-08
34,8,26,0,Buncombe,2022-04-08
19,4,15,0,Johnston,2022-03-28
7,1,6,0,Rockingham,2022-03-28
1,1,0,0,Person,2022-03-29
89,28,61,0,Guilford,2022-04-11
5,0,5,0,Polk,2022-03-29
87,5,82,0,Durham,2022-04-11
12,4,8,0,Onslow,2022-04-11
26,12,14,1,Cumberland,2022-04-11
33,7,26,0,Durham,2022-04-03
3,3,0,0,Sampson,2022-04-03
97,3,94,0,Orange,2022-04-13
191,38,153,0,Mecklenburg,2022-04-13
13,1,12,0,Edgecombe,2022-02-16
305,37,268,0,Wake,2022-04-13
7,2,5,0,Moore,2022-04-13
40,11,29,0,Cabarrus,2022-04-13
10,4,6,0,Burke,2022-04-13
18,11,7,0,Watauga,2022-04-13
3,0,3,0,Bertie,2022-02-16
15,1,14,0,Halifax,2022-02-16
57,2,55,0,Orange,2022-04-15
60,3,57,0,Alamance,2021-12-09
54,5,49,0,Alamance,2021-12-10
120,4,116,0,Alamance,2021-12-13
62,8,54,0,Alamance,2021-12-17
144,14,130,0,Alamance,2021-12-22
159,25,134,0,Alamance,2021-12-23
31,6,25,0,Alamance,2021-12-25
446,74,372,0,Alamance,2021-12-27
499,55,444,0,Alamance,2021-12-29
503,68,435,0,Alamance,2021-12-30
104,20,84,0,Alamance,2022-01-01
764,78,686,0,Alamance,2022-01-05
276,44,232,0,Alamance,2022-01-09
205,41,164,0,Alamance,2022-01-17
80,5,75,0,Alamance,2022-01-22
353,55,298,0,Alamance,2022-01-25
85,10,75,0,Alamance,2022-01-30
174,26,148,0,Alamance,2022-02-03
94,11,83,0,Alamance,2022-02-09
107,26,81,0,Alamance,2022-02-14
50,3,47,0,Alamance,2022-02-18
25,4,21,0,Alamance,2022-02-24
16,2,14,0,Alamance,2022-02-25
14,4,10,0,Alamance,2022-02-26
34,6,28,0,Alamance,2022-02-28
29,2,27,0,Alamance,2022-03-01
33,6,27,0,Alamance,2022-03-02
21,1,20,0,Alamance,2022-03-03
19,1,18,0,Alamance,2022-03-04
8,1,7,0,Alamance,2022-03-05
13,1,12,0,Alamance,2022-03-07
8,0,8,0,Alamance,2022-03-10
8,0,8,0,Alamance,2022-03-11
5,1,4,0,Alamance,2022-03-12
8,0,8,0,Alamance,2022-03-15
4,0,4,0,Alamance,2022-03-16
8,0,8,0,Alamance,2022-03-18
1,0,1,0,Alamance,2022-03-19
14,1,13,0,Alamance,2022-03-21
7,0,7,0,Alamance,2022-03-22
8,0,8,0,Alamance,2022-03-23
6,2,4,0,Alamance,2022-03-25
2,0,2,0,Alamance,2022-03-26
7,2,5,0,Alamance,2022-03-27
11,7,4,0,Alamance,2022-03-29
12,1,11,0,Alamance,2022-03-30
7,2,5,0,Alamance,2022-04-03
17,3,14,0,Alamance,2022-04-04
18,3,15,0,Alamance,2022-04-05
26,7,19,0,Alamance,2022-04-07
31,7,24,0,Alamance,2022-04-08
8,2,6,0,Alamance,2022-04-09
10,1,9,0,Alamance,2022-04-10
32,5,27,0,Alamance,2022-04-12
32,11,21,0,Alamance,2022-04-13
26,4,22,0,Alamance,2022-04-14
28,9,19,0,Alamance,2022-04-15
7,1,6,0,Alamance,2022-04-16
9,0,9,0,Alamance,2022-04-17
37,13,24,0,Alamance,2022-04-18
37,9,28,0,Alamance,2022-04-19
27,10,17,0,Alamance,2022-04-20
20,5,15,0,Alamance,2022-04-21
24,3,21,0,Alamance,2022-04-22
21,3,18,0,Alamance,2022-04-24
55,9,46,0,Alamance,2022-04-25
34,3,31,0,Alamance,2022-04-27
32,4,28,0,Alamance,2022-04-28
46,8,38,0,Alamance,2022-04-29
21,1,20,0,Alamance,2022-04-30
24,0,24,0,Alamance,2022-05-01
54,17,37,0,Alamance,2022-05-02
60,10,50,0,Alamance,2022-05-03
63,10,53,0,Alamance,2022-05-04
69,18,51,0,Alamance,2022-05-05
68,15,53,0,Alamance,2022-05-06
30,7,23,0,Alamance,2022-05-07
32,6,26,0,Alamance,2022-05-08
73,19,54,0,Alamance,2022-05-09
76,15,61,0,Alamance,2022-05-10
76,11,65,0,Alamance,2022-05-11
73,14,59,0,Alamance,2022-05-12
86,12,74,0,Alamance,2022-05-13
37,6,31,0,Alamance,2022-05-14
37,9,28,0,Alamance,2022-05-15
103,22,81,0,Alamance,2022-05-16
76,8,68,0,Alamance,2022-05-19
69,12,57,0,Alamance,2022-05-20
38,2,36,0,Alamance,2022-05-21
42,10,32,0,Alamance,2022-05-22
111,9,102,0,Alamance,2022-05-23
82,13,69,0,Alamance,2022-05-24
80,7,73,0,Alamance,2022-05-25
84,7,77,0,Alamance,2022-05-26
69,4,65,0,Alamance,2022-05-27
40,4,36,0,Alamance,2022-05-28
29,3,26,0,Alamance,2022-05-29
37,9,28,0,Alamance,2022-05-30
124,17,107,0,Alamance,2022-05-31
78,10,68,0,Alamance,2022-06-01
61,10,51,0,Alamance,2022-06-02
43,8,35,0,Alamance,2022-06-03
40,10,30,0,Alamance,2022-06-04
18,8,10,0,Alexander,2021-12-09
12,4,8,0,Alexander,2021-12-10
6,4,2,0,Alexander,2021-12-12
18,11,7,0,Alexander,2021-12-16
15,7,8,0,Alexander,2021-12-17
8,6,2,0,Alexander,2021-12-18
8,5,3,0,Alexander,2021-12-19
25,10,15,0,Alexander,2021-12-20
21,13,8,0,Alexander,2021-12-22
31,12,19,0,Alexander,2021-12-23
2,0,2,0,Alexander,2021-12-25
14,11,3,0,Alexander,2021-12-26
62,35,27,0,Alexander,2021-12-27
64,35,29,0,Alexander,2021-12-29
81,39,42,0,Alexander,2021-12-30
37,20,17,0,Alexander,2021-12-31
20,10,10,0,Alexander,2022-01-01
32,4,28,0,Alexander,2022-01-02
98,42,56,0,Alexander,2022-01-03
78,22,56,0,Alexander,2022-01-04
91,31,60,0,Alexander,2022-01-05
96,28,68,0,Alexander,2022-01-06
56,16,40,0,Alexander,2022-01-07
53,11,42,0,Alexander,2022-01-08
40,8,32,0,Alexander,2022-01-09
145,63,82,0,Alexander,2022-01-10
150,44,106,0,Alexander,2022-01-11
121,27,94,0,Alexander,2022-01-13
104,17,87,0,Alexander,2022-01-14
23,13,10,0,Alexander,2022-01-17
146,44,102,0,Alexander,2022-01-19
129,29,100,0,Alexander,2022-01-20
85,19,66,0,Alexander,2022-01-21
53,23,30,0,Alexander,2022-01-22
86,21,65,0,Alexander,2022-01-25
65,18,47,0,Alexander,2022-01-27
62,14,48,0,Alexander,2022-01-28
13,3,10,0,Alexander,2022-01-29
17,2,15,0,Alexander,2022-01-30
72,25,47,0,Alexander,2022-01-31
46,15,31,0,Alexander,2022-02-01
39,7,32,0,Alexander,2022-02-02
42,10,32,0,Alexander,2022-02-04
23,5,18,0,Alexander,2022-02-05
49,16,33,0,Alexander,2022-02-07
31,12,19,0,Alexander,2022-02-08
21,7,14,0,Alexander,2022-02-11
15,3,12,0,Alexander,2022-02-12
9,3,6,0,Alexander,2022-02-13
13,5,8,0,Alexander,2022-02-14
13,3,10,0,Alexander,2022-02-15
13,2,11,0,Alexander,2022-02-17
5,0,5,0,Alexander,2022-02-19
13,1,12,0,Alexander,2022-02-20
2,0,2,0,Alexander,2022-02-22
8,1,7,0,Alexander,2022-02-23
1,0,1,0,Alexander,2022-02-25
8,2,6,0,Alexander,2022-02-28
2,0,2,0,Alexander,2022-03-02
4,1,3,0,Alexander,2022-03-03
1,0,1,0,Alexander,2022-03-04
2,1,1,0,Alexander,2022-03-05
0,0,0,0,Alexander,2022-03-06
1,0,1,0,Alexander,2022-03-08
3,0,3,0,Alexander,2022-03-09
1,0,1,0,Alexander,2022-03-11
3,0,3,0,Alexander,2022-03-12
1,1,0,0,Alexander,2022-03-13
2,2,0,0,Alexander,2022-03-14
2,0,2,0,Alexander,2022-03-15
1,0,1,0,Alexander,2022-03-16
1,0,1,0,Alexander,2022-03-17
2,1,1,0,Alexander,2022-03-18
1,0,1,0,Alexander,2022-03-19
0,0,0,0,Alexander,2022-03-20
2,0,2,0,Alexander,2022-03-21
2,2,0,0,Alexander,2022-03-22
2,0,2,0,Alexander,2022-03-23
2,0,2,0,Alexander,2022-03-24
1,0,1,0,Alexander,2022-03-25
0,0,0,0,Alexander,2022-03-26
0,0,0,0,Alexander,2022-03-27
0,0,0,0,Alexander,2022-03-28
0,0,0,0,Alexander,2022-03-29
0,0,0,0,Alexander,2022-03-30
1,0,1,0,Alexander,2022-03-31
0,0,0,0,Alexander,2022-04-01
0,0,0,0,Alexander,2022-04-02
0,0,0,0,Alexander,2022-04-03
1,1,0,0,Alexander,2022-04-04
2,0,2,0,Alexander,2022-04-05
1,1,0,0,Alexander,2022-04-06
0,0,0,0,Alexander,2022-04-07
2,1,1,0,Alexander,2022-04-08
0,0,0,0,Alexander,2022-04-09
0,0,0,0,Alexander,2022-04-10
1,1,0,0,Alexander,2022-04-11
2,1,1,0,Alexander,2022-04-12
3,2,1,0,Alexander,2022-04-13
1,0,1,0,Alexander,2022-04-14
0,0,0,0,Alexander,2022-04-15
0,0,0,0,Alexander,2022-04-17
1,1,0,0,Alexander,2022-04-18
3,2,1,0,Alexander,2022-04-19
1,0,1,0,Alexander,2022-04-20
1,1,0,0,Alexander,2022-04-21
5,2,3,0,Alexander,2022-04-22
0,0,0,0,Alexander,2022-04-23
1,0,1,0,Alexander,2022-04-24
5,4,1,0,Alexander,2022-04-25
6,1,5,0,Alexander,2022-04-26
8,4,4,0,Alexander,2022-04-27
7,4,3,0,Alexander,2022-04-28
3,2,1,0,Alexander,2022-04-29
2,0,2,0,Alexander,2022-04-30
0,0,0,0,Alexander,2022-05-01
2,1,1,0,Alexander,2022-05-02
6,3,3,0,Alexander,2022-05-03
3,0,3,0,Alexander,2022-05-04
3,0,3,0,Alexander,2022-05-05
2,1,1,0,Alexander,2022-05-06
1,0,1,0,Alexander,2022-05-07
1,1,0,0,Alexander,2022-05-08
9,6,3,0,Alexander,2022-05-09
5,3,2,0,Alexander,2022-05-10
4,1,3,0,Alexander,2022-05-11
3,0,3,0,Alexander,2022-05-12
4,0,4,0,Alexander,2022-05-13
2,1,1,0,Alexander,2022-05-14
2,0,2,0,Alexander,2022-05-15
6,1,5,0,Alexander,2022-05-16
11,5,6,0,Alexander,2022-05-17
11,3,8,0,Alexander,2022-05-19
13,1,12,0,Alexander,2022-05-20
1,1,0,0,Alexander,2022-05-21
2,0,2,0,Alexander,2022-05-22
8,3,5,0,Alexander,2022-05-23
9,0,9,0,Alexander,2022-05-24
9,1,8,0,Alexander,2022-05-25
8,3,5,0,Alexander,2022-05-26
5,0,5,0,Alexander,2022-05-27
2,1,1,0,Alexander,2022-05-28
6,2,4,0,Alexander,2022-05-29
3,2,1,0,Alexander,2022-05-30
9,3,6,0,Alexander,2022-05-31
6,3,3,0,Alexander,2022-06-02
5,1,4,0,Alexander,2022-06-03
1,0,1,0,Alexander,2022-06-04
22,5,17,0,Alleghany,2021-12-08
14,2,12,0,Alleghany,2021-12-09
5,0,5,0,Alleghany,2021-12-10
4,1,3,0,Alleghany,2021-12-12
16,3,13,0,Alleghany,2021-12-13
9,2,7,0,Alleghany,2021-12-15
16,3,13,0,Alleghany,2021-12-17
2,2,0,0,Alleghany,2021-12-18
4,3,1,0,Alleghany,2021-12-19
11,4,7,0,Alleghany,2021-12-20
8,2,6,0,Alleghany,2021-12-21
8,1,7,0,Alleghany,2021-12-22
4,2,2,0,Alleghany,2021-12-23
2,1,1,0,Alleghany,2021-12-24
2,2,0,0,Alleghany,2021-12-25
3,0,3,0,Alleghany,2021-12-26
7,4,3,0,Alleghany,2021-12-27
15,5,10,0,Alleghany,2021-12-30
3,1,2,0,Alleghany,2022-01-01
4,2,2,0,Alleghany,2022-01-02
25,5,20,0,Alleghany,2022-01-05
28,7,21,0,Alleghany,2022-01-06
7,5,2,0,Alleghany,2022-01-07
9,6,3,0,Alleghany,2022-01-08
9,7,2,0,Alleghany,2022-01-09
50,12,38,0,Alleghany,2022-01-10
37,10,27,0,Alleghany,2022-01-11
38,5,33,0,Alleghany,2022-01-12
31,12,19,0,Alleghany,2022-01-14
3,3,0,0,Alleghany,2022-01-16
8,5,3,0,Alleghany,2022-01-17
11,3,8,0,Alleghany,2022-01-18
37,8,29,0,Alleghany,2022-01-19
21,2,19,0,Alleghany,2022-01-20
24,4,20,0,Alleghany,2022-01-21
4,3,1,0,Alleghany,2022-01-22
5,4,1,0,Alleghany,2022-01-23
41,8,33,0,Alleghany,2022-01-24
30,10,20,0,Alleghany,2022-01-25
23,4,19,0,Alleghany,2022-01-26
23,3,20,0,Alleghany,2022-01-27
20,6,14,0,Alleghany,2022-01-28
4,2,2,0,Alleghany,2022-01-29
4,1,3,0,Alleghany,2022-01-30
26,7,19,0,Alleghany,2022-01-31
22,4,18,0,Alleghany,2022-02-02
17,5,12,0,Alleghany,2022-02-03
21,10,11,0,Alleghany,2022-02-04
3,2,1,0,Alleghany,2022-02-05
3,2,1,0,Alleghany,2022-02-06
13,5,8,0,Alleghany,2022-02-07
7,2,5,0,Alleghany,2022-02-08
8,1,7,0,Alleghany,2022-02-09
11,5,6,0,Alleghany,2022-02-10
3,0,3,0,Alleghany,2022-02-11
0,0,0,0,Alleghany,2022-02-12
2,1,1,0,Alleghany,2022-02-13
11,2,9,0,Alleghany,2022-02-14
10,7,3,0,Alleghany,2022-02-15
5,0,5,0,Alleghany,2022-02-16
6,2,4,0,Alleghany,2022-02-17
7,4,3,0,Alleghany,2022-02-18
1,0,1,0,Alleghany,2022-02-19
1,0,1,0,Alleghany,2022-02-20
10,8,2,0,Alleghany,2022-02-21
9,1,8,0,Alleghany,2022-02-22
6,1,5,0,Alleghany,2022-02-23
6,2,4,0,Alleghany,2022-02-24
4,0,4,0,Alleghany,2022-02-25
4,0,4,0,Alleghany,2022-02-26
0,0,0,0,Alleghany,2022-02-27
4,0,4,0,Alleghany,2022-02-28
3,0,3,0,Alleghany,2022-03-01
5,2,3,0,Alleghany,2022-03-02
4,2,2,0,Alleghany,2022-03-03
2,0,2,0,Alleghany,2022-03-04
1,1,0,0,Alleghany,2022-03-05
0,0,0,0,Alleghany,2022-03-06
0,0,0,0,Alleghany,2022-03-07
1,1,0,0,Alleghany,2022-03-08
3,2,1,0,Alleghany,2022-03-09
1,0,1,0,Alleghany,2022-03-10
0,0,0,0,Alleghany,2022-03-11
0,0,0,0,Alleghany,2022-03-12
0,0,0,0,Alleghany,2022-03-13
0,0,0,0,Alleghany,2022-03-14
0,0,0,0,Alleghany,2022-03-15
2,2,0,0,Alleghany,2022-03-16
0,0,0,0,Alleghany,2022-03-17
1,1,0,0,Alleghany,2022-03-19
3,2,1,0,Alleghany,2022-03-20
0,0,0,0,Alleghany,2022-03-21
0,0,0,0,Alleghany,2022-03-22
1,0,1,0,Alleghany,2022-03-23
0,0,0,0,Alleghany,2022-03-24
1,1,0,0,Alleghany,2022-03-25
0,0,0,0,Alleghany,2022-03-26
0,0,0,0,Alleghany,2022-03-27
0,0,0,0,Alleghany,2022-03-28
1,0,1,0,Alleghany,2022-03-29
1,1,0,0,Alleghany,2022-03-30
0,0,0,0,Alleghany,2022-03-31
0,0,0,0,Alleghany,2022-04-01
0,0,0,0,Alleghany,2022-04-02
0,0,0,0,Alleghany,2022-04-03
0,0,0,0,Alleghany,2022-04-04
0,0,0,0,Alleghany,2022-04-05
1,1,0,0,Alleghany,2022-04-06
0,0,0,0,Alleghany,2022-04-07
1,0,1,0,Alleghany,2022-04-08
0,0,0,0,Alleghany,2022-04-09
0,0,0,0,Alleghany,2022-04-10
0,0,0,0,Alleghany,2022-04-11
0,0,0,0,Alleghany,2022-04-12
1,0,1,0,Alleghany,2022-04-13
0,0,0,0,Alleghany,2022-04-14
1,1,0,0,Alleghany,2022-04-15
0,0,0,0,Alleghany,2022-04-16
0,0,0,0,Alleghany,2022-04-17
1,1,0,0,Alleghany,2022-04-18
0,0,0,0,Alleghany,2022-04-19
0,0,0,0,Alleghany,2022-04-20
2,0,2,0,Alleghany,2022-04-21
0,0,0,0,Alleghany,2022-04-22
1,1,0,0,Alleghany,2022-04-23
0,0,0,0,Alleghany,2022-04-24
0,0,0,0,Alleghany,2022-04-25
0,0,0,0,Alleghany,2022-04-26
0,0,0,0,Alleghany,2022-04-27
2,1,1,0,Alleghany,2022-04-28
1,0,1,0,Alleghany,2022-04-29
0,0,0,0,Alleghany,2022-04-30
1,0,1,0,Alleghany,2022-05-01
1,0,1,0,Alleghany,2022-05-02
0,0,0,0,Alleghany,2022-05-03
2,1,1,0,Alleghany,2022-05-04
3,1,2,0,Alleghany,2022-05-05
1,0,1,0,Alleghany,2022-05-06
1,0,1,0,Alleghany,2022-05-07
1,1,0,0,Alleghany,2022-05-08
3,0,3,0,Alleghany,2022-05-09
1,0,1,0,Alleghany,2022-05-10
2,1,1,0,Alleghany,2022-05-11
0,0,0,0,Alleghany,2022-05-12
1,0,1,0,Alleghany,2022-05-13
1,0,1,0,Alleghany,2022-05-14
1,0,1,0,Alleghany,2022-05-15
1,0,1,0,Alleghany,2022-05-16
11,5,6,0,Alleghany,2022-05-17
5,2,3,0,Alleghany,2022-05-18
1,0,1,0,Alleghany,2022-05-19
5,4,1,0,Alleghany,2022-05-20
3,2,1,0,Alleghany,2022-05-21
2,2,0,0,Alleghany,2022-05-22
7,5,2,0,Alleghany,2022-05-23
9,7,2,0,Alleghany,2022-05-24
5,5,0,0,Alleghany,2022-05-25
1,0,1,0,Alleghany,2022-05-26
3,2,1,0,Alleghany,2022-05-27
2,1,1,0,Alleghany,2022-05-28
1,1,0,0,Alleghany,2022-05-29
3,2,1,0,Alleghany,2022-05-30
6,3,3,0,Alleghany,2022-06-01
6,3,3,0,Alleghany,2022-06-02
3,3,0,0,Alleghany,2022-06-03
0,0,0,0,Alleghany,2022-06-04
6,0,6,0,Anson,2021-12-08
6,0,6,0,Anson,2021-12-09
1,0,1,0,Anson,2021-12-11
4,1,3,0,Anson,2021-12-12
4,2,2,0,Anson,2021-12-13
7,1,6,0,Anson,2021-12-16
3,0,3,0,Anson,2021-12-17
6,0,6,0,Anson,2021-12-18
4,0,4,0,Anson,2021-12-19
13,2,11,0,Anson,2021-12-20
14,2,12,0,Anson,2021-12-22
4,2,2,0,Anson,2021-12-24
5,0,5,0,Anson,2021-12-25
10,1,9,0,Anson,2021-12-26
50,15,35,0,Anson,2021-12-27
65,2,63,0,Anson,2021-12-28
44,5,39,0,Anson,2021-12-29
53,8,45,0,Anson,2021-12-30
33,7,26,0,Anson,2021-12-31
22,3,19,0,Anson,2022-01-01
85,18,67,0,Anson,2022-01-03
107,12,95,0,Anson,2022-01-04
85,9,76,0,Anson,2022-01-07
26,2,24,0,Anson,2022-01-08
114,19,95,0,Anson,2022-01-10
105,9,96,0,Anson,2022-01-11
88,11,77,0,Anson,2022-01-12
94,16,78,0,Anson,2022-01-13
75,11,64,0,Anson,2022-01-14
8,0,8,0,Anson,2022-01-16
45,6,39,0,Anson,2022-01-17
110,29,81,0,Anson,2022-01-18
36,12,24,0,Anson,2022-01-21
17,4,13,0,Anson,2022-01-22
14,2,12,0,Anson,2022-01-23
82,21,61,0,Anson,2022-01-24
57,13,44,0,Anson,2022-01-25
55,16,39,0,Anson,2022-01-26
49,10,39,0,Anson,2022-01-27
38,7,31,0,Anson,2022-01-28
12,3,9,0,Anson,2022-01-29
44,10,34,0,Anson,2022-01-31
24,6,18,0,Anson,2022-02-01
21,3,18,0,Anson,2022-02-02
16,3,13,0,Anson,2022-02-04
12,1,11,0,Anson,2022-02-05
20,4,16,0,Anson,2022-02-07
10,1,9,0,Anson,2022-02-11
3,1,2,0,Anson,2022-02-12
19,7,12,0,Anson,2022-02-14
7,0,7,0,Anson,2022-02-15
3,0,3,0,Anson,2022-02-17
3,0,3,0,Anson,2022-02-18
6,5,1,0,Anson,2022-02-19
6,2,4,0,Anson,2022-02-21
1,1,0,0,Anson,2022-02-22
3,2,1,0,Anson,2022-02-24
3,0,3,0,Anson,2022-02-25
2,0,2,0,Anson,2022-02-26
1,0,1,0,Anson,2022-02-27
5,1,4,0,Anson,2022-02-28
1,0,1,0,Anson,2022-03-01
0,0,0,0,Anson,2022-03-02
1,0,1,0,Anson,2022-03-03
1,0,1,0,Anson,2022-03-04
1,0,1,0,Anson,2022-03-06
3,2,1,0,Anson,2022-03-07
0,0,0,0,Anson,2022-03-08
0,0,0,0,Anson,2022-03-09
1,0,1,0,Anson,2022-03-10
0,0,0,0,Anson,2022-03-11
1,0,1,0,Anson,2022-03-12
1,0,1,0,Anson,2022-03-13
1,0,1,0,Anson,2022-03-14
1,0,1,0,Anson,2022-03-15
1,0,1,0,Anson,2022-03-16
0,0,0,0,Anson,2022-03-17
1,0,1,0,Anson,2022-03-18
0,0,0,0,Anson,2022-03-19
2,0,2,0,Anson,2022-03-20
2,0,2,0,Anson,2022-03-22
0,0,0,0,Anson,2022-03-23
0,0,0,0,Anson,2022-03-24
0,0,0,0,Anson,2022-03-25
0,0,0,0,Anson,2022-03-26
0,0,0,0,Anson,2022-03-27
0,0,0,0,Anson,2022-03-28
0,0,0,0,Anson,2022-03-29
0,0,0,0,Anson,2022-03-30
0,0,0,0,Anson,2022-03-31
0,0,0,0,Anson,2022-04-01
0,0,0,0,Anson,2022-04-02
0,0,0,0,Anson,2022-04-03
0,0,0,0,Anson,2022-04-04
0,0,0,0,Anson,2022-04-05
1,0,1,0,Anson,2022-04-06
0,0,0,0,Anson,2022-04-07
0,0,0,0,Anson,2022-04-08
0,0,0,0,Anson,2022-04-09
0,0,0,0,Anson,2022-04-10
0,0,0,0,Anson,2022-04-11
0,0,0,0,Anson,2022-04-12
0,0,0,0,Anson,2022-04-13
2,1,1,0,Anson,2022-04-14
0,0,0,0,Anson,2022-04-15
0,0,0,0,Anson,2022-04-16
0,0,0,0,Anson,2022-04-17
0,0,0,0,Anson,2022-04-18
0,0,0,0,Anson,2022-04-19
2,0,2,0,Anson,2022-04-20
0,0,0,0,Anson,2022-04-21
0,0,0,0,Anson,2022-04-22
0,0,0,0,Anson,2022-04-23
0,0,0,0,Anson,2022-04-24
0,0,0,0,Anson,2022-04-25
0,0,0,0,Anson,2022-04-26
0,0,0,0,Anson,2022-04-27
1,0,1,0,Anson,2022-04-28
1,1,0,0,Anson,2022-04-29
1,1,0,0,Anson,2022-04-30
0,0,0,0,Anson,2022-05-01
2,0,2,0,Anson,2022-05-02
4,0,4,0,Anson,2022-05-03
1,1,0,0,Anson,2022-05-04
1,0,1,0,Anson,2022-05-05
3,1,2,0,Anson,2022-05-06
3,0,3,0,Anson,2022-05-07
4,1,3,0,Anson,2022-05-08
7,1,6,0,Anson,2022-05-09
2,0,2,0,Anson,2022-05-10
4,1,3,0,Anson,2022-05-11
9,1,8,0,Anson,2022-05-12
5,1,4,0,Anson,2022-05-13
3,0,3,0,Anson,2022-05-14
4,2,2,0,Anson,2022-05-15
6,2,4,0,Anson,2022-05-16
3,1,2,0,Anson,2022-05-17
7,0,7,0,Anson,2022-05-18
5,0,5,0,Anson,2022-05-19
5,0,5,0,Anson,2022-05-20
3,1,2,0,Anson,2022-05-21
3,0,3,0,Anson,2022-05-22
8,0,8,0,Anson,2022-05-23
7,1,6,0,Anson,2022-05-24
5,0,5,0,Anson,2022-05-25
9,3,6,0,Anson,2022-05-26
6,0,6,0,Anson,2022-05-27
4,1,3,0,Anson,2022-05-28
5,1,4,0,Anson,2022-05-29
2,0,2,0,Anson,2022-05-30
8,0,8,0,Anson,2022-05-31
5,0,5,0,Anson,2022-06-01
9,0,9,0,Anson,2022-06-02
4,0,4,0,Anson,2022-06-03
0,0,0,0,Anson,2022-06-04
15,7,8,0,Ashe,2021-12-07
26,9,17,0,Ashe,2021-12-08
19,5,14,0,Ashe,2021-12-09
3,1,2,0,Ashe,2021-12-12
18,4,14,0,Ashe,2021-12-14
15,7,8,0,Ashe,2021-12-17
8,2,6,0,Ashe,2021-12-18
4,0,4,0,Ashe,2021-12-19
24,9,15,0,Ashe,2021-12-20
16,7,9,0,Ashe,2021-12-21
14,3,11,0,Ashe,2021-12-22
6,0,6,0,Ashe,2021-12-23
9,3,6,0,Ashe,2021-12-24
3,1,2,0,Ashe,2021-12-25
12,7,5,0,Ashe,2021-12-26
19,9,10,0,Ashe,2021-12-27
48,10,38,0,Ashe,2021-12-29
37,12,25,0,Ashe,2021-12-30
19,12,7,0,Ashe,2021-12-31
22,16,6,0,Ashe,2022-01-02
28,9,19,0,Ashe,2022-01-03
71,15,56,0,Ashe,2022-01-04
55,11,44,0,Ashe,2022-01-05
29,10,19,0,Ashe,2022-01-07
10,5,5,0,Ashe,2022-01-09
95,27,68,0,Ashe,2022-01-10
70,30,40,0,Ashe,2022-01-13
20,10,10,0,Ashe,2022-01-15
8,5,3,0,Ashe,2022-01-16
17,11,6,0,Ashe,2022-01-17
53,20,33,0,Ashe,2022-01-18
16,10,6,0,Ashe,2022-01-23
96,30,66,0,Ashe,2022-01-24
44,7,37,0,Ashe,2022-01-26
39,18,21,0,Ashe,2022-01-27
33,10,23,0,Ashe,2022-01-28
5,2,3,0,Ashe,2022-01-29
13,9,4,0,Ashe,2022-01-30
45,19,26,0,Ashe,2022-02-02
53,29,24,0,Ashe,2022-02-03
43,24,19,0,Ashe,2022-02-04
13,9,4,0,Ashe,2022-02-05
45,27,18,0,Ashe,2022-02-07
43,23,20,0,Ashe,2022-02-08
31,13,18,0,Ashe,2022-02-09
22,9,13,0,Ashe,2022-02-10
17,14,3,0,Ashe,2022-02-12
2,1,1,0,Ashe,2022-02-13
25,12,13,0,Ashe,2022-02-14
29,17,12,0,Ashe,2022-02-15
14,8,6,0,Ashe,2022-02-17
19,7,12,0,Ashe,2022-02-18
7,6,1,0,Ashe,2022-02-19
5,5,0,0,Ashe,2022-02-20
15,9,6,0,Ashe,2022-02-22
15,9,6,0,Ashe,2022-02-23
26,16,10,0,Ashe,2022-02-25
4,3,1,0,Ashe,2022-02-27
13,5,8,0,Ashe,2022-02-28
10,3,7,0,Ashe,2022-03-01
2,2,0,0,Ashe,2022-03-02
4,3,1,0,Ashe,2022-03-03
0,0,0,0,Ashe,2022-03-05
1,0,1,0,Ashe,2022-03-06
5,3,2,0,Ashe,2022-03-07
4,3,1,0,Ashe,2022-03-08
4,1,3,0,Ashe,2022-03-09
2,0,2,0,Ashe,2022-03-11
1,1,0,0,Ashe,2022-03-12
0,0,0,0,Ashe,2022-03-13
6,1,5,0,Ashe,2022-03-14
0,0,0,0,Ashe,2022-03-15
0,0,0,0,Ashe,2022-03-16
0,0,0,0,Ashe,2022-03-17
1,0,1,0,Ashe,2022-03-18
1,0,1,0,Ashe,2022-03-19
0,0,0,0,Ashe,2022-03-20
1,1,0,0,Ashe,2022-03-21
0,0,0,0,Ashe,2022-03-22
0,0,0,0,Ashe,2022-03-23
0,0,0,0,Ashe,2022-03-24
0,0,0,0,Ashe,2022-03-25
0,0,0,0,Ashe,2022-03-26
0,0,0,0,Ashe,2022-03-27
2,0,2,0,Ashe,2022-03-28
0,0,0,0,Ashe,2022-03-29
1,1,0,0,Ashe,2022-03-30
0,0,0,0,Ashe,2022-03-31
2,0,2,0,Ashe,2022-04-01
0,0,0,0,Ashe,2022-04-02
0,0,0,0,Ashe,2022-04-03
1,0,1,0,Ashe,2022-04-04
3,2,1,0,Ashe,2022-04-05
2,2,0,0,Ashe,2022-04-06
0,0,0,0,Ashe,2022-04-07
2,0,2,0,Ashe,2022-04-08
0,0,0,0,Ashe,2022-04-09
1,1,0,0,Ashe,2022-04-10
1,1,0,0,Ashe,2022-04-11
2,0,2,0,Ashe,2022-04-12
0,0,0,0,Ashe,2022-04-13
2,2,0,0,Ashe,2022-04-14
0,0,0,0,Ashe,2022-04-15
0,0,0,0,Ashe,2022-04-16
0,0,0,0,Ashe,2022-04-17
3,1,2,0,Ashe,2022-04-18
0,0,0,0,Ashe,2022-04-19
5,0,5,0,Ashe,2022-04-20
3,1,2,0,Ashe,2022-04-21
4,4,0,0,Ashe,2022-04-24
8,4,4,0,Ashe,2022-04-26
3,2,1,0,Ashe,2022-04-27
6,6,0,0,Ashe,2022-04-28
1,1,0,0,Ashe,2022-04-29
0,0,0,0,Ashe,2022-04-30
4,2,2,0,Ashe,2022-05-02
7,3,4,0,Ashe,2022-05-03
8,5,3,0,Ashe,2022-05-04
3,2,1,0,Ashe,2022-05-05
9,6,3,0,Ashe,2022-05-06
5,4,1,0,Ashe,2022-05-07
4,3,1,0,Ashe,2022-05-08
4,4,0,0,Ashe,2022-05-09
5,3,2,0,Ashe,2022-05-10
6,6,0,0,Ashe,2022-05-11
6,1,5,0,Ashe,2022-05-12
6,3,3,0,Ashe,2022-05-13
7,7,0,0,Ashe,2022-05-14
2,1,1,0,Ashe,2022-05-15
4,1,3,0,Ashe,2022-05-17
6,4,2,0,Ashe,2022-05-18
3,3,0,0,Ashe,2022-05-19
4,3,1,0,Ashe,2022-05-20
6,4,2,0,Ashe,2022-05-21
4,3,1,0,Ashe,2022-05-22
10,7,3,0,Ashe,2022-05-23
7,5,2,0,Ashe,2022-05-24
7,1,6,0,Ashe,2022-05-25
9,4,5,0,Ashe,2022-05-26
6,3,3,0,Ashe,2022-05-27
4,2,2,0,Ashe,2022-05-28
2,1,1,0,Ashe,2022-05-29
0,0,0,0,Ashe,2022-05-30
9,5,4,0,Ashe,2022-05-31
8,1,7,0,Ashe,2022-06-01
3,0,3,0,Ashe,2022-06-02
1,0,1,0,Ashe,2022-06-03
6,3,3,0,Ashe,2022-06-04
8,6,2,0,Avery,2021-12-07
13,5,8,0,Avery,2021-12-09
11,5,6,0,Avery,2021-12-10
1,0,1,0,Avery,2021-12-11
3,1,2,0,Avery,2021-12-12
10,4,6,0,Avery,2021-12-13
6,4,2,0,Avery,2021-12-14
8,5,3,0,Avery,2021-12-19
29,12,17,0,Avery,2021-12-20
18,6,12,0,Avery,2021-12-21
12,12,0,0,Avery,2021-12-22
17,6,11,0,Avery,2021-12-23
6,3,3,0,Avery,2021-12-24
0,0,0,0,Avery,2021-12-25
7,3,4,0,Avery,2021-12-26
36,20,16,0,Avery,2021-12-27
42,22,20,0,Avery,2021-12-28
26,13,13,0,Avery,2021-12-29
25,7,18,0,Avery,2021-12-30
10,5,5,0,Avery,2021-12-31
5,1,4,0,Avery,2022-01-01
8,0,8,0,Avery,2022-01-02
14,1,13,0,Avery,2022-01-03
39,3,36,0,Avery,2022-01-04
28,4,24,0,Avery,2022-01-06
18,4,14,0,Avery,2022-01-07
16,3,13,0,Avery,2022-01-08
11,5,6,0,Avery,2022-01-09
73,13,60,0,Avery,2022-01-10
34,3,31,0,Avery,2022-01-11
44,5,39,0,Avery,2022-01-12
37,5,32,0,Avery,2022-01-13
46,1,45,0,Avery,2022-01-14
0,0,0,0,Avery,2022-01-16
5,1,4,0,Avery,2022-01-17
23,5,18,0,Avery,2022-01-18
29,5,24,0,Avery,2022-01-21
12,1,11,0,Avery,2022-01-22
16,5,11,0,Avery,2022-01-23
59,17,42,0,Avery,2022-01-24
21,4,17,0,Avery,2022-01-25
28,4,24,0,Avery,2022-01-26
35,3,32,0,Avery,2022-01-27
17,0,17,0,Avery,2022-01-28
4,1,3,0,Avery,2022-01-29
3,0,3,0,Avery,2022-01-30
44,14,30,0,Avery,2022-01-31
24,6,18,0,Avery,2022-02-01
16,3,13,0,Avery,2022-02-02
22,3,19,0,Avery,2022-02-03
14,1,13,0,Avery,2022-02-04
14,2,12,0,Avery,2022-02-05
30,7,23,0,Avery,2022-02-07
18,4,14,0,Avery,2022-02-08
17,2,15,0,Avery,2022-02-09
15,5,10,0,Avery,2022-02-10
8,2,6,0,Avery,2022-02-11
12,5,7,0,Avery,2022-02-12
9,4,5,0,Avery,2022-02-13
25,10,15,0,Avery,2022-02-14
22,14,8,0,Avery,2022-02-15
17,7,10,0,Avery,2022-02-16
13,8,5,0,Avery,2022-02-17
17,5,12,0,Avery,2022-02-18
7,2,5,0,Avery,2022-02-19
16,2,14,0,Avery,2022-02-21
12,6,6,0,Avery,2022-02-22
18,6,12,0,Avery,2022-02-23
5,2,3,0,Avery,2022-02-24
5,2,3,0,Avery,2022-02-25
0,0,0,0,Avery,2022-02-26
2,1,1,0,Avery,2022-02-27
7,4,3,0,Avery,2022-02-28
5,1,4,0,Avery,2022-03-01
2,0,2,0,Avery,2022-03-02
6,0,6,0,Avery,2022-03-03
0,0,0,0,Avery,2022-03-05
5,4,1,0,Avery,2022-03-07
3,2,1,0,Avery,2022-03-08
2,2,0,0,Avery,2022-03-09
7,2,5,0,Avery,2022-03-10
1,0,1,0,Avery,2022-03-11
1,0,1,0,Avery,2022-03-12
1,0,1,0,Avery,2022-03-13
1,1,0,0,Avery,2022-03-14
3,3,0,0,Avery,2022-03-15
1,1,0,0,Avery,2022-03-16
10,9,1,0,Avery,2022-03-17
1,1,0,0,Avery,2022-03-18
6,4,2,0,Avery,2022-03-19
0,0,0,0,Avery,2022-03-20
2,1,1,0,Avery,2022-03-21
2,1,1,0,Avery,2022-03-23
0,0,0,0,Avery,2022-03-24
1,0,1,0,Avery,2022-03-25
1,0,1,0,Avery,2022-03-26
1,0,1,0,Avery,2022-03-27
0,0,0,0,Avery,2022-03-28
0,0,0,0,Avery,2022-03-29
2,1,1,0,Avery,2022-03-30
4,2,2,0,Avery,2022-03-31
3,2,1,0,Avery,2022-04-01
0,0,0,0,Avery,2022-04-02
0,0,0,0,Avery,2022-04-03
0,0,0,0,Avery,2022-04-04
0,0,0,0,Avery,2022-04-05
0,0,0,0,Avery,2022-04-06
0,0,0,0,Avery,2022-04-07
0,0,0,0,Avery,2022-04-08
1,0,1,0,Avery,2022-04-09
1,1,0,0,Avery,2022-04-10
1,1,0,0,Avery,2022-04-11
4,4,0,0,Avery,2022-04-12
2,0,2,0,Avery,2022-04-13
0,0,0,0,Avery,2022-04-14
1,1,0,0,Avery,2022-04-15
1,0,1,0,Avery,2022-04-16
2,0,2,0,Avery,2022-04-17
2,0,2,0,Avery,2022-04-18
4,1,3,0,Avery,2022-04-19
1,0,1,0,Avery,2022-04-20
5,2,3,0,Avery,2022-04-21
2,1,1,0,Avery,2022-04-22
1,0,1,0,Avery,2022-04-23
3,1,2,0,Avery,2022-04-24
2,2,0,0,Avery,2022-04-25
1,0,1,0,Avery,2022-04-27
1,1,0,0,Avery,2022-04-28
2,1,1,0,Avery,2022-04-30
0,0,0,0,Avery,2022-05-01
2,0,2,0,Avery,2022-05-02
3,1,2,0,Avery,2022-05-03
2,0,2,0,Avery,2022-05-04
2,1,1,0,Avery,2022-05-05
3,2,1,0,Avery,2022-05-06
2,0,2,0,Avery,2022-05-07
1,1,0,0,Avery,2022-05-08
2,1,1,0,Avery,2022-05-09
3,1,2,0,Avery,2022-05-10
0,0,0,0,Avery,2022-05-11
1,0,1,0,Avery,2022-05-12
5,1,4,0,Avery,2022-05-13
4,2,2,0,Avery,2022-05-14
0,0,0,0,Avery,2022-05-15
3,0,3,0,Avery,2022-05-16
13,4,9,0,Avery,2022-05-17
5,1,4,0,Avery,2022-05-18
1,0,1,0,Avery,2022-05-19
6,3,3,0,Avery,2022-05-20
0,0,0,0,Avery,2022-05-21
1,0,1,0,Avery,2022-05-22
8,7,1,0,Avery,2022-05-23
7,2,5,0,Avery,2022-05-24
3,2,1,0,Avery,2022-05-25
1,1,0,0,Avery,2022-05-26
1,0,1,0,Avery,2022-05-27
3,1,2,0,Avery,2022-05-28
1,1,0,0,Avery,2022-05-29
4,1,3,0,Avery,2022-05-30
9,6,3,0,Avery,2022-05-31
1,0,1,0,Avery,2022-06-01
4,1,3,0,Avery,2022-06-02
4,1,3,0,Avery,2022-06-03
2,0,2,0,Avery,2022-06-04
7,2,5,0,Beaufort,2021-12-11
4,0,4,0,Beaufort,2021-12-12
5,0,5,0,Beaufort,2021-12-19
20,2,18,0,Beaufort,2021-12-20
19,3,16,0,Beaufort,2021-12-21
18,0,18,0,Beaufort,2021-12-23
3,0,3,0,Beaufort,2021-12-24
2,0,2,0,Beaufort,2021-12-25
16,0,16,0,Beaufort,2021-12-26
57,12,45,0,Beaufort,2021-12-27
50,6,44,0,Beaufort,2021-12-28
71,14,57,0,Beaufort,2021-12-29
66,6,60,0,Beaufort,2021-12-30
46,1,45,0,Beaufort,2021-12-31
17,1,16,0,Beaufort,2022-01-01
37,0,37,0,Beaufort,2022-01-02
142,18,124,0,Beaufort,2022-01-03
113,20,93,0,Beaufort,2022-01-04
142,25,117,0,Beaufort,2022-01-07
64,20,44,0,Beaufort,2022-01-08
281,37,244,0,Beaufort,2022-01-10
233,32,201,0,Beaufort,2022-01-11
205,31,174,0,Beaufort,2022-01-13
8,0,8,0,Beaufort,2022-01-22
31,0,31,0,Beaufort,2022-01-23
122,24,98,0,Beaufort,2022-01-26
20,3,17,0,Beaufort,2022-01-29
100,14,86,0,Beaufort,2022-01-31
56,8,48,0,Beaufort,2022-02-01
60,9,51,0,Beaufort,2022-02-02
43,4,39,0,Beaufort,2022-02-03
20,2,18,0,Beaufort,2022-02-05
52,14,38,0,Beaufort,2022-02-07
46,11,35,0,Beaufort,2022-02-09
25,10,15,0,Beaufort,2022-02-11
7,1,6,0,Beaufort,2022-02-12
48,6,42,0,Beaufort,2022-02-14
28,4,24,0,Beaufort,2022-02-15
18,5,13,0,Beaufort,2022-02-16
8,1,7,0,Beaufort,2022-02-19
37,5,32,0,Beaufort,2022-02-21
20,3,17,0,Beaufort,2022-02-22
10,1,9,0,Beaufort,2022-02-24
7,0,7,0,Beaufort,2022-02-28
5,1,4,0,Beaufort,2022-03-02
3,1,2,0,Beaufort,2022-03-03
2,0,2,0,Beaufort,2022-03-05
1,0,1,0,Beaufort,2022-03-06
2,0,2,0,Beaufort,2022-03-09
2,0,2,0,Beaufort,2022-03-10
0,0,0,0,Beaufort,2022-03-11
2,1,1,0,Beaufort,2022-03-12
0,0,0,0,Beaufort,2022-03-13
3,1,2,0,Beaufort,2022-03-14
1,0,1,0,Beaufort,2022-03-15
2,0,2,0,Beaufort,2022-03-16
0,0,0,0,Beaufort,2022-03-17
0,0,0,0,Beaufort,2022-03-18
1,0,1,0,Beaufort,2022-03-19
1,0,1,0,Beaufort,2022-03-20
2,0,2,0,Beaufort,2022-03-21
1,0,1,0,Beaufort,2022-03-22
1,0,1,0,Beaufort,2022-03-23
0,0,0,0,Beaufort,2022-03-24
1,0,1,0,Beaufort,2022-03-25
0,0,0,0,Beaufort,2022-03-26
0,0,0,0,Beaufort,2022-03-27
1,0,1,0,Beaufort,2022-03-28
0,0,0,0,Beaufort,2022-03-29
1,1,0,0,Beaufort,2022-03-30
0,0,0,0,Beaufort,2022-04-01
0,0,0,0,Beaufort,2022-04-02
0,0,0,0,Beaufort,2022-04-03
1,0,1,0,Beaufort,2022-04-04
0,0,0,0,Beaufort,2022-04-05
2,0,2,0,Beaufort,2022-04-06
1,0,1,0,Beaufort,2022-04-07
1,1,0,0,Beaufort,2022-04-08
1,1,0,0,Beaufort,2022-04-09
0,0,0,0,Beaufort,2022-04-10
4,0,4,0,Beaufort,2022-04-12
1,0,1,0,Beaufort,2022-04-13
3,0,3,0,Beaufort,2022-04-14
1,0,1,0,Beaufort,2022-04-15
0,0,0,0,Beaufort,2022-04-16
0,0,0,0,Beaufort,2022-04-17
6,0,6,0,Beaufort,2022-04-18
3,2,1,0,Beaufort,2022-04-19
0,0,0,0,Beaufort,2022-04-20
5,0,5,0,Beaufort,2022-04-21
5,0,5,0,Beaufort,2022-04-22
5,1,4,0,Beaufort,2022-04-23
2,0,2,0,Beaufort,2022-04-24
8,3,5,0,Beaufort,2022-04-25
5,1,4,0,Beaufort,2022-04-26
7,2,5,0,Beaufort,2022-04-27
6,1,5,0,Beaufort,2022-04-28
2,0,2,0,Beaufort,2022-04-29
2,2,0,0,Beaufort,2022-04-30
1,0,1,0,Beaufort,2022-05-01
9,1,8,0,Beaufort,2022-05-02
7,0,7,0,Beaufort,2022-05-03
8,1,7,0,Beaufort,2022-05-04
3,0,3,0,Beaufort,2022-05-05
8,3,5,0,Beaufort,2022-05-06
3,1,2,0,Beaufort,2022-05-07
0,0,0,0,Beaufort,2022-05-08
13,4,9,0,Beaufort,2022-05-09
5,1,4,0,Beaufort,2022-05-10
13,3,10,0,Beaufort,2022-05-11
8,2,6,0,Beaufort,2022-05-12
8,1,7,0,Beaufort,2022-05-13
10,4,6,0,Beaufort,2022-05-14
2,0,2,0,Beaufort,2022-05-15
14,1,13,0,Beaufort,2022-05-16
12,3,9,0,Beaufort,2022-05-17
15,5,10,0,Beaufort,2022-05-18
13,4,9,0,Beaufort,2022-05-19
10,2,8,0,Beaufort,2022-05-20
7,2,5,0,Beaufort,2022-05-21
6,0,6,0,Beaufort,2022-05-22
19,3,16,0,Beaufort,2022-05-23
15,3,12,0,Beaufort,2022-05-24
9,2,7,0,Beaufort,2022-05-25
22,3,19,0,Beaufort,2022-05-26
7,0,7,0,Beaufort,2022-05-27
4,1,3,0,Beaufort,2022-05-28
10,2,8,0,Beaufort,2022-05-29
4,0,4,0,Beaufort,2022-05-30
33,4,29,0,Beaufort,2022-05-31
19,5,14,0,Beaufort,2022-06-01
13,2,11,0,Beaufort,2022-06-02
8,1,7,0,Beaufort,2022-06-03
2,0,2,0,Beaufort,2022-06-04
3,0,3,0,Bertie,2021-12-07
1,0,1,0,Bertie,2021-12-08
3,0,3,0,Bertie,2021-12-10
1,0,1,0,Bertie,2021-12-11
2,0,2,0,Bertie,2021-12-12
4,0,4,0,Bertie,2021-12-13
3,0,3,0,Bertie,2021-12-14
5,1,4,0,Bertie,2021-12-15
7,0,7,0,Bertie,2021-12-16
1,0,1,0,Bertie,2021-12-18
0,0,0,0,Bertie,2021-12-19
10,2,8,0,Bertie,2021-12-20
14,1,13,0,Bertie,2021-12-21
7,0,7,0,Bertie,2021-12-22
5,1,4,0,Bertie,2021-12-23
5,0,5,0,Bertie,2021-12-24
2,0,2,0,Bertie,2021-12-25
6,0,6,0,Bertie,2021-12-26
27,1,26,0,Bertie,2021-12-27
38,5,33,0,Bertie,2021-12-28
56,10,46,0,Bertie,2021-12-29
39,3,36,0,Bertie,2021-12-30
52,0,52,0,Bertie,2021-12-31
18,0,18,0,Bertie,2022-01-01
15,0,15,0,Bertie,2022-01-02
78,3,75,0,Bertie,2022-01-03
81,12,69,0,Bertie,2022-01-04
55,3,52,0,Bertie,2022-01-05
20,2,18,0,Bertie,2022-01-08
9,0,9,0,Bertie,2022-01-09
84,11,73,0,Bertie,2022-01-11
119,48,71,0,Bertie,2022-01-13
35,7,28,0,Bertie,2022-01-17
82,5,77,0,Bertie,2022-01-18
5,0,5,0,Bertie,2022-01-22
45,0,45,0,Bertie,2022-01-24
30,1,29,0,Bertie,2022-01-25
26,3,23,0,Bertie,2022-01-27
6,0,6,0,Bertie,2022-01-30
18,2,16,0,Bertie,2022-02-01
11,3,8,0,Bertie,2022-02-02
10,0,10,0,Bertie,2022-02-03
10,0,10,0,Bertie,2022-02-04
2,0,2,0,Bertie,2022-02-05
11,0,11,0,Bertie,2022-02-07
4,0,4,0,Bertie,2022-02-08
10,1,9,0,Bertie,2022-02-09
12,2,10,0,Bertie,2022-02-10
3,1,2,0,Bertie,2022-02-11
2,0,2,0,Bertie,2022-02-12
2,1,1,0,Bertie,2022-02-13
4,1,3,0,Bertie,2022-02-14
0,0,0,0,Bertie,2022-02-15
2,1,1,0,Bertie,2022-02-17
1,0,1,0,Bertie,2022-02-18
0,0,0,0,Bertie,2022-02-19
1,0,1,0,Bertie,2022-02-20
1,1,0,0,Bertie,2022-02-21
1,0,1,0,Bertie,2022-02-22
0,0,0,0,Bertie,2022-02-23
0,0,0,0,Bertie,2022-02-24
6,0,6,0,Bertie,2022-02-25
0,0,0,0,Bertie,2022-02-26
0,0,0,0,Bertie,2022-02-27
2,0,2,0,Bertie,2022-02-28
0,0,0,0,Bertie,2022-03-01
2,1,1,0,Bertie,2022-03-02
1,0,1,0,Bertie,2022-03-03
2,0,2,0,Bertie,2022-03-04
1,0,1,0,Bertie,2022-03-05
1,0,1,0,Bertie,2022-03-07
0,0,0,0,Bertie,2022-03-08
0,0,0,0,Bertie,2022-03-09
1,0,1,0,Bertie,2022-03-10
0,0,0,0,Bertie,2022-03-12
0,0,0,0,Bertie,2022-03-13
0,0,0,0,Bertie,2022-03-14
1,0,1,0,Bertie,2022-03-15
0,0,0,0,Bertie,2022-03-16
0,0,0,0,Bertie,2022-03-17
0,0,0,0,Bertie,2022-03-18
0,0,0,0,Bertie,2022-03-19
0,0,0,0,Bertie,2022-03-20
0,0,0,0,Bertie,2022-03-21
0,0,0,0,Bertie,2022-03-22
0,0,0,0,Bertie,2022-03-23
2,0,2,0,Bertie,2022-03-24
0,0,0,0,Bertie,2022-03-25
0,0,0,0,Bertie,2022-03-26
1,0,1,0,Bertie,2022-03-27
2,0,2,0,Bertie,2022-03-28
0,0,0,0,Bertie,2022-03-29
0,0,0,0,Bertie,2022-03-30
0,0,0,0,Bertie,2022-03-31
0,0,0,0,Bertie,2022-04-01
0,0,0,0,Bertie,2022-04-02
0,0,0,0,Bertie,2022-04-03
0,0,0,0,Bertie,2022-04-04
0,0,0,0,Bertie,2022-04-05
0,0,0,0,Bertie,2022-04-06
0,0,0,0,Bertie,2022-04-07
2,0,2,0,Bertie,2022-04-08
0,0,0,0,Bertie,2022-04-09
1,0,1,0,Bertie,2022-04-10
1,1,0,0,Bertie,2022-04-11
1,1,0,0,Bertie,2022-04-12
1,0,1,0,Bertie,2022-04-13
1,0,1,0,Bertie,2022-04-14
0,0,0,0,Bertie,2022-04-15
0,0,0,0,Bertie,2022-04-16
0,0,0,0,Bertie,2022-04-17
3,0,3,0,Bertie,2022-04-18
0,0,0,0,Bertie,2022-04-19
0,0,0,0,Bertie,2022-04-20
1,0,1,0,Bertie,2022-04-21
0,0,0,0,Bertie,2022-04-22
0,0,0,0,Bertie,2022-04-23
0,0,0,0,Bertie,2022-04-24
2,0,2,0,Bertie,2022-04-25
5,0,5,0,Bertie,2022-04-26
3,0,3,0,Bertie,2022-04-27
3,0,3,0,Bertie,2022-04-28
3,0,3,0,Bertie,2022-04-29
2,0,2,0,Bertie,2022-04-30
2,0,2,0,Bertie,2022-05-01
1,0,1,0,Bertie,2022-05-02
3,0,3,0,Bertie,2022-05-03
3,1,2,0,Bertie,2022-05-04
2,0,2,0,Bertie,2022-05-05
1,0,1,0,Bertie,2022-05-06
0,0,0,0,Bertie,2022-05-07
1,0,1,0,Bertie,2022-05-08
0,0,0,0,Bertie,2022-05-09
3,0,3,0,Bertie,2022-05-10
3,0,3,0,Bertie,2022-05-11
5,0,5,0,Bertie,2022-05-12
7,4,3,0,Bertie,2022-05-13
1,0,1,0,Bertie,2022-05-14
5,0,5,0,Bertie,2022-05-15
3,0,3,0,Bertie,2022-05-16
5,0,5,0,Bertie,2022-05-17
3,2,1,0,Bertie,2022-05-18
2,0,2,0,Bertie,2022-05-19
0,0,0,0,Bertie,2022-05-20
4,0,4,0,Bertie,2022-05-21
4,1,3,0,Bertie,2022-05-22
4,0,4,0,Bertie,2022-05-23
6,0,6,0,Bertie,2022-05-24
4,2,2,0,Bertie,2022-05-25
9,2,7,0,Bertie,2022-05-26
5,1,4,0,Bertie,2022-05-27
2,0,2,0,Bertie,2022-05-28
12,11,1,0,Bertie,2022-05-29
6,1,5,0,Bertie,2022-05-30
9,1,8,0,Bertie,2022-05-31
6,3,3,0,Bertie,2022-06-02
4,0,4,0,Bertie,2022-06-03
1,0,1,0,Bertie,2022-06-04
9,3,6,0,Bladen,2021-12-09
5,1,4,0,Bladen,2021-12-10
2,1,1,0,Bladen,2021-12-11
5,0,5,0,Bladen,2021-12-12
15,4,11,0,Bladen,2021-12-13
14,1,13,0,Bladen,2021-12-15
8,1,7,0,Bladen,2021-12-16
8,2,6,0,Bladen,2021-12-18
5,0,5,0,Bladen,2021-12-19
11,2,9,0,Bladen,2021-12-20
9,0,9,0,Bladen,2021-12-22
15,3,12,0,Bladen,2021-12-23
15,1,14,0,Bladen,2021-12-24
32,3,29,0,Bladen,2021-12-27
56,6,50,0,Bladen,2021-12-28
68,3,65,0,Bladen,2021-12-29
85,11,74,0,Bladen,2021-12-30
32,5,27,0,Bladen,2021-12-31
35,2,33,0,Bladen,2022-01-02
100,9,91,0,Bladen,2022-01-03
145,20,125,0,Bladen,2022-01-04
105,14,91,0,Bladen,2022-01-05
92,14,78,0,Bladen,2022-01-07
38,3,35,0,Bladen,2022-01-09
221,38,183,0,Bladen,2022-01-10
158,28,130,0,Bladen,2022-01-11
165,33,132,0,Bladen,2022-01-13
157,33,124,0,Bladen,2022-01-20
25,7,18,0,Bladen,2022-01-21
15,3,12,0,Bladen,2022-01-22
28,4,24,0,Bladen,2022-01-23
60,7,53,0,Bladen,2022-01-27
16,4,12,0,Bladen,2022-01-29
65,14,51,0,Bladen,2022-01-31
50,14,36,0,Bladen,2022-02-01
22,6,16,0,Bladen,2022-02-02
11,3,8,0,Bladen,2022-02-08
4,0,4,0,Bladen,2022-02-12
4,1,3,0,Bladen,2022-02-13
10,1,9,0,Bladen,2022-02-14
5,0,5,0,Bladen,2022-02-15
9,3,6,0,Bladen,2022-02-18
7,1,6,0,Bladen,2022-02-19
7,2,5,0,Bladen,2022-02-20
12,4,8,0,Bladen,2022-02-21
9,2,7,0,Bladen,2022-02-22
10,1,9,0,Bladen,2022-02-23
0,0,0,0,Bladen,2022-02-26
0,0,0,0,Bladen,2022-02-27
2,0,2,0,Bladen,2022-03-01
2,0,2,0,Bladen,2022-03-02
2,0,2,0,Bladen,2022-03-03
5,0,5,0,Bladen,2022-03-04
0,0,0,0,Bladen,2022-03-05
1,0,1,0,Bladen,2022-03-06
2,0,2,0,Bladen,2022-03-07
2,0,2,0,Bladen,2022-03-09
0,0,0,0,Bladen,2022-03-11
2,0,2,0,Bladen,2022-03-13
3,0,3,0,Bladen,2022-03-14
0,0,0,0,Bladen,2022-03-15
0,0,0,0,Bladen,2022-03-16
1,1,0,0,Bladen,2022-03-17
1,0,1,0,Bladen,2022-03-18
0,0,0,0,Bladen,2022-03-19
0,0,0,0,Bladen,2022-03-20
0,0,0,0,Bladen,2022-03-21
0,0,0,0,Bladen,2022-03-22
0,0,0,0,Bladen,2022-03-23
0,0,0,0,Bladen,2022-03-24
1,1,0,0,Bladen,2022-03-25
1,0,1,0,Bladen,2022-03-26
0,0,0,0,Bladen,2022-03-27
0,0,0,0,Bladen,2022-03-28
2,2,0,0,Bladen,2022-03-29
0,0,0,0,Bladen,2022-03-30
1,0,1,0,Bladen,2022-03-31
2,0,2,0,Bladen,2022-04-01
0,0,0,0,Bladen,2022-04-02
0,0,0,0,Bladen,2022-04-03
3,1,2,0,Bladen,2022-04-04
1,0,1,0,Bladen,2022-04-05
0,0,0,0,Bladen,2022-04-06
0,0,0,0,Bladen,2022-04-07
0,0,0,0,Bladen,2022-04-08
0,0,0,0,Bladen,2022-04-09
1,0,1,0,Bladen,2022-04-10
2,1,1,0,Bladen,2022-04-11
3,1,2,0,Bladen,2022-04-12
1,1,0,0,Bladen,2022-04-13
2,0,2,0,Bladen,2022-04-14
2,1,1,0,Bladen,2022-04-15
0,0,0,0,Bladen,2022-04-16
0,0,0,0,Bladen,2022-04-17
1,0,1,0,Bladen,2022-04-18
3,1,2,0,Bladen,2022-04-19
1,0,1,0,Bladen,2022-04-20
4,0,4,0,Bladen,2022-04-21
4,1,3,0,Bladen,2022-04-22
2,0,2,0,Bladen,2022-04-23
0,0,0,0,Bladen,2022-04-24
3,1,2,0,Bladen,2022-04-26
6,1,5,0,Bladen,2022-04-27
2,0,2,0,Bladen,2022-04-28
4,0,4,0,Bladen,2022-04-29
2,0,2,0,Bladen,2022-04-30
1,1,0,0,Bladen,2022-05-01
3,1,2,0,Bladen,2022-05-02
4,0,4,0,Bladen,2022-05-03
4,0,4,0,Bladen,2022-05-04
9,5,4,0,Bladen,2022-05-05
5,1,4,0,Bladen,2022-05-06
2,0,2,0,Bladen,2022-05-07
2,0,2,0,Bladen,2022-05-08
11,2,9,0,Bladen,2022-05-09
8,0,8,0,Bladen,2022-05-10
5,0,5,0,Bladen,2022-05-11
7,1,6,0,Bladen,2022-05-12
15,2,13,0,Bladen,2022-05-13
4,0,4,0,Bladen,2022-05-14
4,0,4,0,Bladen,2022-05-15
12,3,9,0,Bladen,2022-05-16
16,6,10,0,Bladen,2022-05-17
22,4,18,0,Bladen,2022-05-18
13,1,12,0,Bladen,2022-05-19
16,5,11,0,Bladen,2022-05-20
12,3,9,0,Bladen,2022-05-21
5,1,4,0,Bladen,2022-05-22
19,5,14,0,Bladen,2022-05-23
14,0,14,0,Bladen,2022-05-24
23,4,19,0,Bladen,2022-05-25
11,3,8,0,Bladen,2022-05-26
6,2,4,0,Bladen,2022-05-28
8,2,6,0,Bladen,2022-05-29
10,0,10,0,Bladen,2022-05-30
24,3,21,0,Bladen,2022-05-31
19,3,16,0,Bladen,2022-06-01
11,0,11,0,Bladen,2022-06-02
9,1,8,0,Bladen,2022-06-03
3,0,3,0,Bladen,2022-06-04
48,12,36,0,Brunswick,2021-12-08
38,5,33,0,Brunswick,2021-12-10
25,2,23,0,Brunswick,2021-12-11
32,3,29,0,Brunswick,2021-12-12
45,10,35,0,Brunswick,2021-12-14
59,7,52,0,Brunswick,2021-12-17
28,5,23,0,Brunswick,2021-12-19
69,7,62,0,Brunswick,2021-12-22
74,14,60,0,Brunswick,2021-12-23
47,13,34,0,Brunswick,2021-12-24
21,3,18,0,Brunswick,2021-12-25
183,27,156,0,Brunswick,2021-12-27
205,31,174,0,Brunswick,2021-12-28
232,27,205,0,Brunswick,2021-12-29
143,21,122,0,Brunswick,2021-12-31
46,2,44,0,Brunswick,2022-01-01
333,42,291,0,Brunswick,2022-01-07
454,57,397,0,Brunswick,2022-01-10
397,50,347,0,Brunswick,2022-01-13
412,50,362,0,Brunswick,2022-01-14
422,44,378,0,Brunswick,2022-01-17
167,27,140,0,Brunswick,2022-01-21
75,6,69,0,Brunswick,2022-01-22
244,58,186,0,Brunswick,2022-01-26
167,24,143,0,Brunswick,2022-02-02
67,11,56,0,Brunswick,2022-02-06
132,26,106,0,Brunswick,2022-02-07
63,3,60,0,Brunswick,2022-02-11
64,7,57,0,Brunswick,2022-02-14
42,6,36,0,Brunswick,2022-02-17
15,3,12,0,Brunswick,2022-02-20
34,2,32,0,Brunswick,2022-02-22
36,8,28,0,Brunswick,2022-02-23
17,1,16,0,Brunswick,2022-02-26
14,2,12,0,Brunswick,2022-02-27
22,6,16,0,Brunswick,2022-02-28
13,1,12,0,Brunswick,2022-03-04
5,2,3,0,Brunswick,2022-03-08
11,2,9,0,Brunswick,2022-03-09
8,2,6,0,Brunswick,2022-03-11
3,0,3,0,Brunswick,2022-03-12
4,1,3,0,Brunswick,2022-03-14
9,0,9,0,Brunswick,2022-03-15
5,0,5,0,Brunswick,2022-03-16
2,1,1,0,Brunswick,2022-03-19
2,0,2,0,Brunswick,2022-03-20
6,1,5,0,Brunswick,2022-03-21
2,0,2,0,Brunswick,2022-03-22
7,3,4,0,Brunswick,2022-03-23
4,2,2,0,Brunswick,2022-03-24
2,1,1,0,Brunswick,2022-03-26
2,0,2,0,Brunswick,2022-03-27
11,2,9,0,Brunswick,2022-03-28
7,0,7,0,Brunswick,2022-03-29
11,0,11,0,Brunswick,2022-03-30
13,2,11,0,Brunswick,2022-03-31
6,0,6,0,Brunswick,2022-04-01
2,0,2,0,Brunswick,2022-04-02
1,0,1,0,Brunswick,2022-04-03
11,6,5,0,Brunswick,2022-04-04
14,4,10,0,Brunswick,2022-04-05
13,3,10,0,Brunswick,2022-04-06
19,2,17,0,Brunswick,2022-04-07
7,0,7,0,Brunswick,2022-04-09
2,1,1,0,Brunswick,2022-04-10
19,2,17,0,Brunswick,2022-04-11
19,2,17,0,Brunswick,2022-04-13
16,1,15,0,Brunswick,2022-04-14
4,0,4,0,Brunswick,2022-04-15
16,4,12,0,Brunswick,2022-04-16
3,0,3,0,Brunswick,2022-04-17
17,1,16,0,Brunswick,2022-04-18
15,1,14,0,Brunswick,2022-04-19
23,4,19,0,Brunswick,2022-04-20
20,3,17,0,Brunswick,2022-04-21
19,1,18,0,Brunswick,2022-04-22
16,3,13,0,Brunswick,2022-04-23
9,4,5,0,Brunswick,2022-04-24
27,2,25,0,Brunswick,2022-04-25
39,6,33,0,Brunswick,2022-04-26
24,1,23,0,Brunswick,2022-04-27
32,8,24,0,Brunswick,2022-04-28
36,4,32,0,Brunswick,2022-04-29
26,4,22,0,Brunswick,2022-04-30
20,2,18,0,Brunswick,2022-05-01
53,9,44,0,Brunswick,2022-05-02
44,11,33,0,Brunswick,2022-05-03
65,12,53,0,Brunswick,2022-05-04
50,8,42,0,Brunswick,2022-05-05
41,3,38,0,Brunswick,2022-05-06
17,1,16,0,Brunswick,2022-05-07
29,7,22,0,Brunswick,2022-05-08
64,14,50,0,Brunswick,2022-05-10
67,13,54,0,Brunswick,2022-05-11
67,6,61,0,Brunswick,2022-05-13
33,4,29,0,Brunswick,2022-05-14
30,6,24,0,Brunswick,2022-05-15
88,15,73,0,Brunswick,2022-05-16
52,4,48,0,Brunswick,2022-05-17
75,10,65,0,Brunswick,2022-05-18
51,9,42,0,Brunswick,2022-05-19
68,12,56,0,Brunswick,2022-05-20
24,7,17,0,Brunswick,2022-05-21
36,6,30,0,Brunswick,2022-05-22
72,9,63,0,Brunswick,2022-05-23
62,7,55,0,Brunswick,2022-05-24
65,11,54,0,Brunswick,2022-05-25
43,6,37,0,Brunswick,2022-05-27
32,9,23,0,Brunswick,2022-05-28
48,12,36,0,Brunswick,2022-05-29
24,4,20,0,Brunswick,2022-05-30
64,6,58,0,Brunswick,2022-05-31
50,5,45,0,Brunswick,2022-06-01
49,3,46,0,Brunswick,2022-06-02
38,6,32,0,Brunswick,2022-06-03
38,6,32,0,Brunswick,2022-06-04
59,25,34,0,Buncombe,2021-12-07
35,11,24,0,Buncombe,2021-12-12
130,54,76,0,Buncombe,2021-12-15
96,41,55,0,Buncombe,2021-12-17
58,24,34,0,Buncombe,2021-12-18
158,23,135,0,Buncombe,2021-12-21
167,29,138,0,Buncombe,2021-12-22
78,12,66,0,Buncombe,2021-12-24
243,46,197,0,Buncombe,2022-01-02
755,222,533,0,Buncombe,2022-01-04
682,230,452,0,Buncombe,2022-01-05
275,40,235,0,Buncombe,2022-01-09
819,311,508,0,Buncombe,2022-01-11
254,35,219,0,Buncombe,2022-01-22
264,85,179,0,Buncombe,2022-02-02
240,82,158,0,Buncombe,2022-02-03
177,70,107,0,Buncombe,2022-02-09
108,41,67,0,Buncombe,2022-02-15
93,32,61,0,Buncombe,2022-02-21
76,37,39,0,Buncombe,2022-02-22
18,4,14,0,Buncombe,2022-02-27
43,15,28,0,Buncombe,2022-03-01
38,8,30,0,Buncombe,2022-03-02
12,6,6,0,Buncombe,2022-03-05
11,5,6,0,Buncombe,2022-03-06
22,3,19,0,Buncombe,2022-03-09
17,7,10,0,Buncombe,2022-03-11
10,2,8,0,Buncombe,2022-03-12
15,5,10,0,Buncombe,2022-03-17
15,5,10,0,Buncombe,2022-03-18
7,1,6,0,Buncombe,2022-03-19
11,9,2,0,Buncombe,2022-03-21
18,5,13,0,Buncombe,2022-03-22
21,7,14,0,Buncombe,2022-03-23
21,8,13,0,Buncombe,2022-03-24
9,4,5,0,Buncombe,2022-03-27
20,7,13,0,Buncombe,2022-03-28
25,13,12,0,Buncombe,2022-03-31
20,4,16,0,Buncombe,2022-04-01
9,2,7,0,Buncombe,2022-04-02
33,13,20,0,Buncombe,2022-04-04
23,7,16,0,Buncombe,2022-04-05
13,5,8,0,Buncombe,2022-04-09
21,3,18,0,Buncombe,2022-04-10
41,12,29,0,Buncombe,2022-04-11
43,16,27,0,Buncombe,2022-04-12
42,18,24,0,Buncombe,2022-04-13
55,23,32,0,Buncombe,2022-04-14
37,9,28,0,Buncombe,2022-04-15
26,11,15,0,Buncombe,2022-04-16
23,7,16,0,Buncombe,2022-04-17
68,17,51,0,Buncombe,2022-04-18
68,19,49,0,Buncombe,2022-04-20
73,31,42,0,Buncombe,2022-04-21
22,10,12,0,Buncombe,2022-04-23
21,10,11,0,Buncombe,2022-04-24
79,21,58,0,Buncombe,2022-04-25
75,30,45,0,Buncombe,2022-04-26
80,34,46,0,Buncombe,2022-04-27
75,24,51,0,Buncombe,2022-04-28
77,32,45,0,Buncombe,2022-04-29
40,9,31,0,Buncombe,2022-04-30
127,41,86,0,Buncombe,2022-05-02
103,48,55,0,Buncombe,2022-05-04
122,49,73,0,Buncombe,2022-05-05
49,22,27,0,Buncombe,2022-05-07
38,18,20,0,Buncombe,2022-05-08
148,53,95,0,Buncombe,2022-05-09
97,37,60,0,Buncombe,2022-05-10
126,59,67,0,Buncombe,2022-05-11
109,44,65,0,Buncombe,2022-05-13
66,18,48,0,Buncombe,2022-05-14
85,25,60,0,Buncombe,2022-05-15
167,68,99,0,Buncombe,2022-05-16
120,45,75,0,Buncombe,2022-05-17
147,57,90,0,Buncombe,2022-05-18
117,44,73,0,Buncombe,2022-05-19
115,45,70,0,Buncombe,2022-05-20
44,16,28,0,Buncombe,2022-05-22
156,58,98,0,Buncombe,2022-05-23
152,58,94,0,Buncombe,2022-05-25
119,44,75,0,Buncombe,2022-05-26
80,30,50,0,Buncombe,2022-05-27
58,21,37,0,Buncombe,2022-05-28
71,20,51,0,Buncombe,2022-05-29
35,19,16,0,Buncombe,2022-05-30
182,50,132,0,Buncombe,2022-05-31
107,41,66,0,Buncombe,2022-06-01
86,30,56,0,Buncombe,2022-06-02
83,25,58,0,Buncombe,2022-06-03
41,13,28,0,Buncombe,2022-06-04
27,9,18,0,Burke,2021-12-08
11,3,8,0,Burke,2021-12-12
40,15,25,0,Burke,2021-12-13
33,6,27,0,Burke,2021-12-15
18,5,13,0,Burke,2021-12-16
29,6,23,0,Burke,2021-12-17
39,8,31,0,Burke,2021-12-20
35,6,29,0,Burke,2021-12-21
38,9,29,0,Burke,2021-12-22
53,18,35,0,Burke,2021-12-23
28,6,22,0,Burke,2021-12-24
27,9,18,0,Burke,2021-12-26
130,39,91,0,Burke,2021-12-30
96,28,68,0,Burke,2021-12-31
58,12,46,0,Burke,2022-01-01
256,65,191,0,Burke,2022-01-06
214,53,161,0,Burke,2022-01-07
98,37,61,0,Burke,2022-01-09
25,10,15,0,Burke,2022-01-16
77,13,64,0,Burke,2022-01-17
192,54,138,0,Burke,2022-01-21
187,42,145,0,Burke,2022-01-27
54,32,22,0,Burke,2022-01-29
88,25,63,0,Burke,2022-02-04
36,6,30,0,Burke,2022-02-06
76,32,44,0,Burke,2022-02-14
20,3,17,0,Burke,2022-02-18
26,11,15,0,Burke,2022-02-22
17,3,14,0,Burke,2022-02-24
3,0,3,0,Burke,2022-02-27
5,0,5,0,Burke,2022-03-01
17,4,13,0,Burke,2022-03-02
10,3,7,0,Burke,2022-03-03
6,1,5,0,Burke,2022-03-04
5,1,4,0,Burke,2022-03-05
8,4,4,0,Burke,2022-03-07
2,1,1,0,Burke,2022-03-10
6,1,5,0,Burke,2022-03-11
1,0,1,0,Burke,2022-03-13
4,2,2,0,Burke,2022-03-15
5,2,3,0,Burke,2022-03-16
2,2,0,0,Burke,2022-03-17
3,0,3,0,Burke,2022-03-18
1,0,1,0,Burke,2022-03-20
3,2,1,0,Burke,2022-03-21
4,1,3,0,Burke,2022-03-23
1,1,0,0,Burke,2022-03-24
0,0,0,0,Burke,2022-03-25
0,0,0,0,Burke,2022-03-26
3,1,2,0,Burke,2022-03-27
13,6,7,0,Burke,2022-03-28
6,3,3,0,Burke,2022-03-29
3,2,1,0,Burke,2022-03-30
7,2,5,0,Burke,2022-03-31
3,2,1,0,Burke,2022-04-01
1,0,1,0,Burke,2022-04-02
1,0,1,0,Burke,2022-04-03
1,1,0,0,Burke,2022-04-04
10,4,6,0,Burke,2022-04-06
4,1,3,0,Burke,2022-04-07
3,2,1,0,Burke,2022-04-08
4,0,4,0,Burke,2022-04-09
1,0,1,0,Burke,2022-04-10
5,0,5,0,Burke,2022-04-11
6,4,2,0,Burke,2022-04-12
11,9,2,0,Burke,2022-04-15
2,1,1,0,Burke,2022-04-16
0,0,0,0,Burke,2022-04-17
5,1,4,0,Burke,2022-04-19
3,1,2,0,Burke,2022-04-20
12,2,10,0,Burke,2022-04-21
2,2,0,0,Burke,2022-04-22
3,0,3,0,Burke,2022-04-23
8,2,6,0,Burke,2022-04-24
11,5,6,0,Burke,2022-04-25
15,10,5,0,Burke,2022-04-26
4,3,1,0,Burke,2022-04-27
5,4,1,0,Burke,2022-04-28
10,3,7,0,Burke,2022-04-29
4,2,2,0,Burke,2022-05-01
15,6,9,0,Burke,2022-05-02
9,1,8,0,Burke,2022-05-03
6,0,6,0,Burke,2022-05-04
13,3,10,0,Burke,2022-05-05
12,3,9,0,Burke,2022-05-06
9,1,8,0,Burke,2022-05-07
3,2,1,0,Burke,2022-05-08
12,0,12,0,Burke,2022-05-09
16,4,12,0,Burke,2022-05-11
16,1,15,0,Burke,2022-05-12
23,9,14,0,Burke,2022-05-13
8,0,8,0,Burke,2022-05-14
10,1,9,0,Burke,2022-05-15
27,2,25,0,Burke,2022-05-16
22,5,17,0,Burke,2022-05-17
27,7,20,0,Burke,2022-05-18
32,6,26,0,Burke,2022-05-19
26,5,21,0,Burke,2022-05-20
6,0,6,0,Burke,2022-05-21
18,1,17,0,Burke,2022-05-22
25,9,16,0,Burke,2022-05-23
30,6,24,0,Burke,2022-05-24
19,6,13,0,Burke,2022-05-25
28,10,18,0,Burke,2022-05-26
19,9,10,0,Burke,2022-05-27
20,13,7,0,Burke,2022-05-28
16,4,12,0,Burke,2022-05-29
16,3,13,0,Burke,2022-05-30
25,4,21,0,Burke,2022-05-31
26,4,22,0,Burke,2022-06-01
13,6,7,0,Burke,2022-06-02
14,0,14,0,Burke,2022-06-03
10,0,10,0,Burke,2022-06-04
122,45,77,0,Cabarrus,2021-12-07
79,24,55,0,Cabarrus,2021-12-09
68,17,51,0,Cabarrus,2021-12-10
104,15,89,0,Cabarrus,2021-12-14
115,37,78,0,Cabarrus,2021-12-16
112,21,91,0,Cabarrus,2021-12-17
161,30,131,0,Cabarrus,2021-12-20
117,32,85,0,Cabarrus,2021-12-24
504,133,371,0,Cabarrus,2021-12-27
505,107,398,0,Cabarrus,2021-12-29
578,134,444,0,Cabarrus,2021-12-30
353,86,267,0,Cabarrus,2021-12-31
639,192,447,0,Cabarrus,2022-01-03
704,130,574,0,Cabarrus,2022-01-04
279,70,209,0,Cabarrus,2022-01-09
398,105,293,0,Cabarrus,2022-01-21
150,36,114,0,Cabarrus,2022-01-22
529,176,353,0,Cabarrus,2022-01-24
146,28,118,0,Cabarrus,2022-02-04
117,31,86,0,Cabarrus,2022-02-09
87,20,67,0,Cabarrus,2022-02-11
69,11,58,0,Cabarrus,2022-02-16
70,18,52,0,Cabarrus,2022-02-17
41,14,27,0,Cabarrus,2022-02-22
26,8,18,0,Cabarrus,2022-02-23
17,5,12,0,Cabarrus,2022-03-03
9,5,4,0,Cabarrus,2022-03-04
8,1,7,0,Cabarrus,2022-03-05
13,4,9,0,Cabarrus,2022-03-08
10,0,10,0,Cabarrus,2022-03-09
4,2,2,0,Cabarrus,2022-03-11
5,1,4,0,Cabarrus,2022-03-12
5,0,5,0,Cabarrus,2022-03-13
6,1,5,0,Cabarrus,2022-03-14
3,0,3,0,Cabarrus,2022-03-15
6,1,5,0,Cabarrus,2022-03-16
4,1,3,0,Cabarrus,2022-03-18
6,0,6,0,Cabarrus,2022-03-19
4,0,4,0,Cabarrus,2022-03-20
5,2,3,0,Cabarrus,2022-03-21
11,0,11,0,Cabarrus,2022-03-22
5,1,4,0,Cabarrus,2022-03-23
7,2,5,0,Cabarrus,2022-03-24
6,2,4,0,Cabarrus,2022-03-25
3,0,3,0,Cabarrus,2022-03-26
6,2,4,0,Cabarrus,2022-03-27
12,5,7,0,Cabarrus,2022-03-28
6,2,4,0,Cabarrus,2022-03-29
4,3,1,0,Cabarrus,2022-03-30
6,2,4,0,Cabarrus,2022-03-31
8,2,6,0,Cabarrus,2022-04-01
7,0,7,0,Cabarrus,2022-04-03
13,3,10,0,Cabarrus,2022-04-04
7,2,5,0,Cabarrus,2022-04-05
9,7,2,0,Cabarrus,2022-04-06
12,5,7,0,Cabarrus,2022-04-08
3,1,2,0,Cabarrus,2022-04-09
5,2,3,0,Cabarrus,2022-04-10
18,3,15,0,Cabarrus,2022-04-11
20,3,17,0,Cabarrus,2022-04-12
22,5,17,0,Cabarrus,2022-04-14
18,5,13,0,Cabarrus,2022-04-15
12,2,10,0,Cabarrus,2022-04-16
9,1,8,0,Cabarrus,2022-04-17
29,8,21,0,Cabarrus,2022-04-18
37,7,30,0,Cabarrus,2022-04-19
30,9,21,0,Cabarrus,2022-04-20
30,10,20,0,Cabarrus,2022-04-21
23,3,20,0,Cabarrus,2022-04-22
20,4,16,0,Cabarrus,2022-04-23
38,14,24,0,Cabarrus,2022-04-24
68,19,49,0,Cabarrus,2022-04-25
38,4,34,0,Cabarrus,2022-04-27
36,9,27,0,Cabarrus,2022-04-28
32,8,24,0,Cabarrus,2022-04-29
20,1,19,0,Cabarrus,2022-05-01
40,6,34,0,Cabarrus,2022-05-02
57,21,36,0,Cabarrus,2022-05-03
66,17,49,0,Cabarrus,2022-05-04
46,9,37,0,Cabarrus,2022-05-05
47,9,38,0,Cabarrus,2022-05-06
36,5,31,0,Cabarrus,2022-05-07
35,7,28,0,Cabarrus,2022-05-08
74,12,62,0,Cabarrus,2022-05-09
57,12,45,0,Cabarrus,2022-05-10
62,10,52,0,Cabarrus,2022-05-11
75,9,66,0,Cabarrus,2022-05-12
106,23,83,0,Cabarrus,2022-05-13
48,11,37,0,Cabarrus,2022-05-14
53,7,46,0,Cabarrus,2022-05-15
91,28,63,0,Cabarrus,2022-05-16
97,24,73,0,Cabarrus,2022-05-18
76,17,59,0,Cabarrus,2022-05-19
72,13,59,0,Cabarrus,2022-05-20
40,8,32,0,Cabarrus,2022-05-21
55,5,50,0,Cabarrus,2022-05-22
97,24,73,0,Cabarrus,2022-05-23
58,10,48,0,Cabarrus,2022-05-24
86,14,72,0,Cabarrus,2022-05-25
63,13,50,0,Cabarrus,2022-05-26
75,11,64,0,Cabarrus,2022-05-27
29,5,24,0,Cabarrus,2022-05-28
42,9,33,0,Cabarrus,2022-05-29
32,5,27,0,Cabarrus,2022-05-30
127,23,104,0,Cabarrus,2022-05-31
120,22,98,0,Cabarrus,2022-06-01
93,15,78,0,Cabarrus,2022-06-02
60,9,51,0,Cabarrus,2022-06-03
51,7,44,0,Cabarrus,2022-06-04
44,6,38,0,Caldwell,2021-12-08
31,2,29,0,Caldwell,2021-12-09
16,6,10,0,Caldwell,2021-12-11
17,4,13,0,Caldwell,2021-12-12
23,5,18,0,Caldwell,2021-12-17
21,5,16,0,Caldwell,2021-12-18
20,4,16,0,Caldwell,2021-12-19
42,7,35,0,Caldwell,2021-12-20
42,10,32,0,Caldwell,2021-12-21
54,4,50,0,Caldwell,2021-12-22
52,11,41,0,Caldwell,2021-12-23
22,5,17,0,Caldwell,2021-12-25
138,17,121,0,Caldwell,2021-12-28
134,23,111,0,Caldwell,2021-12-30
78,11,67,0,Caldwell,2021-12-31
44,12,32,0,Caldwell,2022-01-01
79,11,68,0,Caldwell,2022-01-02
219,31,188,0,Caldwell,2022-01-04
213,43,170,0,Caldwell,2022-01-05
205,42,163,0,Caldwell,2022-01-07
98,24,74,0,Caldwell,2022-01-08
298,42,256,0,Caldwell,2022-01-10
322,76,246,0,Caldwell,2022-01-13
397,106,291,0,Caldwell,2022-01-20
112,28,84,0,Caldwell,2022-01-23
71,11,60,0,Caldwell,2022-02-08
26,3,23,0,Caldwell,2022-02-12
32,2,30,0,Caldwell,2022-02-16
23,2,21,0,Caldwell,2022-02-17
19,2,17,0,Caldwell,2022-02-18
17,3,14,0,Caldwell,2022-02-20
18,2,16,0,Caldwell,2022-02-24
10,0,10,0,Caldwell,2022-02-26
13,0,13,0,Caldwell,2022-02-28
10,1,9,0,Caldwell,2022-03-02
11,3,8,0,Caldwell,2022-03-03
9,0,9,0,Caldwell,2022-03-04
7,0,7,0,Caldwell,2022-03-06
4,0,4,0,Caldwell,2022-03-07
6,1,5,0,Caldwell,2022-03-08
7,2,5,0,Caldwell,2022-03-09
3,0,3,0,Caldwell,2022-03-10
5,1,4,0,Caldwell,2022-03-11
1,0,1,0,Caldwell,2022-03-12
2,1,1,0,Caldwell,2022-03-13
3,0,3,0,Caldwell,2022-03-14
2,0,2,0,Caldwell,2022-03-15
2,0,2,0,Caldwell,2022-03-16
7,3,4,0,Caldwell,2022-03-17
2,0,2,0,Caldwell,2022-03-19
2,0,2,0,Caldwell,2022-03-20
1,0,1,0,Caldwell,2022-03-21
2,0,2,0,Caldwell,2022-03-22
3,0,3,0,Caldwell,2022-03-24
3,0,3,0,Caldwell,2022-03-25
1,0,1,0,Caldwell,2022-03-26
1,0,1,0,Caldwell,2022-03-27
5,0,5,0,Caldwell,2022-03-28
3,0,3,0,Caldwell,2022-03-29
4,0,4,0,Caldwell,2022-03-30
2,0,2,0,Caldwell,2022-04-01
4,0,4,0,Caldwell,2022-04-02
2,0,2,0,Caldwell,2022-04-03
4,0,4,0,Caldwell,2022-04-04
0,0,0,0,Caldwell,2022-04-05
3,0,3,0,Caldwell,2022-04-06
6,1,5,0,Caldwell,2022-04-07
2,0,2,0,Caldwell,2022-04-08
3,0,3,0,Caldwell,2022-04-09
4,0,4,0,Caldwell,2022-04-10
2,0,2,0,Caldwell,2022-04-11
4,0,4,0,Caldwell,2022-04-12
8,2,6,0,Caldwell,2022-04-13
2,0,2,0,Caldwell,2022-04-14
6,0,6,0,Caldwell,2022-04-15
3,0,3,0,Caldwell,2022-04-16
2,0,2,0,Caldwell,2022-04-17
5,1,4,0,Caldwell,2022-04-18
8,2,6,0,Caldwell,2022-04-19
13,2,11,0,Caldwell,2022-04-20
16,2,14,0,Caldwell,2022-04-21
10,3,7,0,Caldwell,2022-04-22
6,0,6,0,Caldwell,2022-04-23
6,0,6,0,Caldwell,2022-04-24
21,5,16,0,Caldwell,2022-04-25
3,0,3,0,Caldwell,2022-04-26
10,1,9,0,Caldwell,2022-04-27
6,3,3,0,Caldwell,2022-04-28
6,0,6,0,Caldwell,2022-04-29
5,1,4,0,Caldwell,2022-04-30
8,1,7,0,Caldwell,2022-05-01
18,3,15,0,Caldwell,2022-05-02
4,1,3,0,Caldwell,2022-05-03
4,1,3,0,Caldwell,2022-05-04
11,1,10,0,Caldwell,2022-05-05
7,1,6,0,Caldwell,2022-05-06
4,0,4,0,Caldwell,2022-05-07
5,0,5,0,Caldwell,2022-05-08
13,1,12,0,Caldwell,2022-05-09
20,6,14,0,Caldwell,2022-05-10
8,0,8,0,Caldwell,2022-05-11
6,1,5,0,Caldwell,2022-05-12
12,1,11,0,Caldwell,2022-05-13
11,2,9,0,Caldwell,2022-05-14
12,3,9,0,Caldwell,2022-05-15
15,3,12,0,Caldwell,2022-05-16
22,4,18,0,Caldwell,2022-05-17
19,4,15,0,Caldwell,2022-05-18
21,3,18,0,Caldwell,2022-05-19
16,3,13,0,Caldwell,2022-05-20
8,2,6,0,Caldwell,2022-05-21
12,1,11,0,Caldwell,2022-05-22
16,3,13,0,Caldwell,2022-05-23
14,1,13,0,Caldwell,2022-05-24
22,3,19,0,Caldwell,2022-05-25
14,0,14,0,Caldwell,2022-05-26
22,3,19,0,Caldwell,2022-05-27
8,2,6,0,Caldwell,2022-05-28
14,1,13,0,Caldwell,2022-05-29
9,1,8,0,Caldwell,2022-05-30
25,7,18,0,Caldwell,2022-05-31
23,5,18,0,Caldwell,2022-06-01
17,3,14,0,Caldwell,2022-06-02
14,2,12,0,Caldwell,2022-06-03
12,1,11,0,Caldwell,2022-06-04
8,6,2,0,Camden,2021-12-07
2,2,0,0,Camden,2021-12-08
8,2,6,0,Camden,2021-12-09
6,4,2,0,Camden,2021-12-10
2,0,2,0,Camden,2021-12-12
2,0,2,0,Camden,2021-12-13
2,0,2,0,Camden,2021-12-15
2,0,2,0,Camden,2021-12-17
1,0,1,0,Camden,2021-12-18
6,4,2,0,Camden,2021-12-20
2,0,2,0,Camden,2021-12-21
3,2,1,0,Camden,2021-12-22
4,2,2,0,Camden,2021-12-23
3,0,3,0,Camden,2021-12-24
0,0,0,0,Camden,2021-12-25
5,3,2,0,Camden,2021-12-26
7,0,7,0,Camden,2021-12-27
15,5,10,0,Camden,2021-12-28
10,3,7,0,Camden,2021-12-29
15,3,12,0,Camden,2021-12-30
5,0,5,0,Camden,2021-12-31
4,1,3,0,Camden,2022-01-01
7,1,6,0,Camden,2022-01-02
20,5,15,0,Camden,2022-01-03
20,4,16,0,Camden,2022-01-04
25,5,20,0,Camden,2022-01-05
12,3,9,0,Camden,2022-01-07
5,1,4,0,Camden,2022-01-08
5,1,4,0,Camden,2022-01-09
14,3,11,0,Camden,2022-01-10
21,5,16,0,Camden,2022-01-11
21,8,13,0,Camden,2022-01-12
26,10,16,0,Camden,2022-01-13
12,3,9,0,Camden,2022-01-14
5,2,3,0,Camden,2022-01-16
7,6,1,0,Camden,2022-01-17
17,5,12,0,Camden,2022-01-18
7,2,5,0,Camden,2022-01-20
1,1,0,0,Camden,2022-01-21
1,0,1,0,Camden,2022-01-22
3,2,1,0,Camden,2022-01-23
16,10,6,0,Camden,2022-01-24
5,2,3,0,Camden,2022-01-25
11,2,9,0,Camden,2022-01-26
12,6,6,0,Camden,2022-01-27
6,0,6,0,Camden,2022-01-28
1,1,0,0,Camden,2022-01-29
5,0,5,0,Camden,2022-01-30
1,0,1,0,Camden,2022-01-31
1,0,1,0,Camden,2022-02-01
0,0,0,0,Camden,2022-02-02
2,0,2,0,Camden,2022-02-03
0,0,0,0,Camden,2022-02-04
0,0,0,0,Camden,2022-02-05
0,0,0,0,Camden,2022-02-06
2,1,1,0,Camden,2022-02-07
2,1,1,0,Camden,2022-02-08
3,1,2,0,Camden,2022-02-09
3,2,1,0,Camden,2022-02-10
1,0,1,0,Camden,2022-02-11
3,1,2,0,Camden,2022-02-12
0,0,0,0,Camden,2022-02-13
0,0,0,0,Camden,2022-02-14
1,0,1,0,Camden,2022-02-15
3,0,3,0,Camden,2022-02-16
0,0,0,0,Camden,2022-02-17
0,0,0,0,Camden,2022-02-18
1,0,1,0,Camden,2022-02-19
0,0,0,0,Camden,2022-02-20
1,1,0,0,Camden,2022-02-21
4,2,2,0,Camden,2022-02-22
0,0,0,0,Camden,2022-02-23
2,0,2,0,Camden,2022-02-24
2,1,1,0,Camden,2022-02-25
0,0,0,0,Camden,2022-02-26
1,1,0,0,Camden,2022-02-27
0,0,0,0,Camden,2022-02-28
1,0,1,0,Camden,2022-03-01
0,0,0,0,Camden,2022-03-02
0,0,0,0,Camden,2022-03-03
0,0,0,0,Camden,2022-03-04
0,0,0,0,Camden,2022-03-05
0,0,0,0,Camden,2022-03-06
0,0,0,0,Camden,2022-03-07
1,0,1,0,Camden,2022-03-08
1,0,1,0,Camden,2022-03-09
0,0,0,0,Camden,2022-03-10
0,0,0,0,Camden,2022-03-11
0,0,0,0,Camden,2022-03-12
0,0,0,0,Camden,2022-03-13
0,0,0,0,Camden,2022-03-14
0,0,0,0,Camden,2022-03-15
0,0,0,0,Camden,2022-03-16
0,0,0,0,Camden,2022-03-17
0,0,0,0,Camden,2022-03-18
0,0,0,0,Camden,2022-03-19
0,0,0,0,Camden,2022-03-20
0,0,0,0,Camden,2022-03-21
0,0,0,0,Camden,2022-03-22
0,0,0,0,Camden,2022-03-23
1,0,1,0,Camden,2022-03-24
0,0,0,0,Camden,2022-03-25
0,0,0,0,Camden,2022-03-26
0,0,0,0,Camden,2022-03-27
0,0,0,0,Camden,2022-03-28
0,0,0,0,Camden,2022-03-29
0,0,0,0,Camden,2022-03-30
2,0,2,0,Camden,2022-03-31
1,0,1,0,Camden,2022-04-01
0,0,0,0,Camden,2022-04-02
2,0,2,0,Camden,2022-04-03
0,0,0,0,Camden,2022-04-04
3,0,3,0,Camden,2022-04-05
0,0,0,0,Camden,2022-04-06
1,0,1,0,Camden,2022-04-07
0,0,0,0,Camden,2022-04-08
0,0,0,0,Camden,2022-04-09
0,0,0,0,Camden,2022-04-10
0,0,0,0,Camden,2022-04-11
1,0,1,0,Camden,2022-04-12
0,0,0,0,Camden,2022-04-13
1,1,0,0,Camden,2022-04-14
0,0,0,0,Camden,2022-04-15
0,0,0,0,Camden,2022-04-16
0,0,0,0,Camden,2022-04-17
0,0,0,0,Camden,2022-04-18
1,0,1,0,Camden,2022-04-19
0,0,0,0,Camden,2022-04-20
0,0,0,0,Camden,2022-04-21
0,0,0,0,Camden,2022-04-22
0,0,0,0,Camden,2022-04-23
0,0,0,0,Camden,2022-04-24
2,0,2,0,Camden,2022-04-25
0,0,0,0,Camden,2022-04-26
0,0,0,0,Camden,2022-04-27
3,2,1,0,Camden,2022-04-28
2,2,0,0,Camden,2022-04-29
0,0,0,0,Camden,2022-04-30
0,0,0,0,Camden,2022-05-01
3,1,2,0,Camden,2022-05-02
1,0,1,0,Camden,2022-05-03
1,0,1,0,Camden,2022-05-04
1,0,1,0,Camden,2022-05-05
2,1,1,0,Camden,2022-05-06
1,0,1,0,Camden,2022-05-07
1,0,1,0,Camden,2022-05-08
2,1,1,0,Camden,2022-05-09
0,0,0,0,Camden,2022-05-10
3,1,2,0,Camden,2022-05-11
1,0,1,0,Camden,2022-05-12
0,0,0,0,Camden,2022-05-13
4,1,3,0,Camden,2022-05-14
0,0,0,0,Camden,2022-05-15
2,0,2,0,Camden,2022-05-16
2,1,1,0,Camden,2022-05-17
2,0,2,0,Camden,2022-05-18
1,0,1,0,Camden,2022-05-19
3,1,2,0,Camden,2022-05-20
0,0,0,0,Camden,2022-05-21
2,1,1,0,Camden,2022-05-22
4,2,2,0,Camden,2022-05-23
3,1,2,0,Camden,2022-05-24
2,2,0,0,Camden,2022-05-25
2,2,0,0,Camden,2022-05-26
4,3,1,0,Camden,2022-05-27
0,0,0,0,Camden,2022-05-28
4,0,4,0,Camden,2022-05-29
2,2,0,0,Camden,2022-05-30
4,0,4,0,Camden,2022-05-31
4,1,3,0,Camden,2022-06-01
1,1,0,0,Camden,2022-06-02
0,0,0,0,Camden,2022-06-03
1,1,0,0,Camden,2022-06-04
12,2,10,0,Carteret,2021-12-07
9,2,7,0,Carteret,2021-12-09
7,2,5,0,Carteret,2021-12-10
6,1,5,0,Carteret,2021-12-12
19,8,11,0,Carteret,2021-12-15
15,6,9,0,Carteret,2021-12-17
10,2,8,0,Carteret,2021-12-18
29,5,24,0,Carteret,2021-12-20
26,10,16,0,Carteret,2021-12-22
16,4,12,0,Carteret,2021-12-24
2,1,1,0,Carteret,2021-12-25
24,7,17,0,Carteret,2021-12-26
60,13,47,0,Carteret,2021-12-27
82,27,55,0,Carteret,2021-12-29
94,38,56,0,Carteret,2021-12-30
38,11,27,0,Carteret,2021-12-31
7,4,3,0,Carteret,2022-01-01
40,9,31,0,Carteret,2022-01-02
129,50,79,0,Carteret,2022-01-05
140,55,85,0,Carteret,2022-01-07
55,17,38,0,Carteret,2022-01-09
190,83,107,0,Carteret,2022-01-10
193,70,123,0,Carteret,2022-01-14
266,109,157,0,Carteret,2022-01-18
171,55,116,0,Carteret,2022-01-20
64,25,39,0,Carteret,2022-01-21
29,7,22,0,Carteret,2022-01-22
228,112,116,0,Carteret,2022-01-24
165,56,109,0,Carteret,2022-01-25
119,47,72,0,Carteret,2022-01-26
110,35,75,0,Carteret,2022-01-27
32,7,25,0,Carteret,2022-01-30
93,35,58,0,Carteret,2022-02-01
28,5,23,0,Carteret,2022-02-05
24,7,17,0,Carteret,2022-02-06
79,31,48,0,Carteret,2022-02-07
44,13,31,0,Carteret,2022-02-08
42,9,33,0,Carteret,2022-02-09
42,14,28,0,Carteret,2022-02-10
37,17,20,0,Carteret,2022-02-15
15,8,7,0,Carteret,2022-02-18
4,2,2,0,Carteret,2022-02-19
6,1,5,0,Carteret,2022-02-20
20,7,13,0,Carteret,2022-02-22
16,4,12,0,Carteret,2022-02-23
17,7,10,0,Carteret,2022-02-24
3,0,3,0,Carteret,2022-02-27
6,1,5,0,Carteret,2022-02-28
9,2,7,0,Carteret,2022-03-01
11,2,9,0,Carteret,2022-03-02
4,0,4,0,Carteret,2022-03-04
5,0,5,0,Carteret,2022-03-05
3,1,2,0,Carteret,2022-03-06
6,2,4,0,Carteret,2022-03-08
5,2,3,0,Carteret,2022-03-10
6,3,3,0,Carteret,2022-03-11
3,0,3,0,Carteret,2022-03-12
2,0,2,0,Carteret,2022-03-13
3,0,3,0,Carteret,2022-03-14
5,0,5,0,Carteret,2022-03-15
2,1,1,0,Carteret,2022-03-17
2,0,2,0,Carteret,2022-03-18
1,0,1,0,Carteret,2022-03-19
0,0,0,0,Carteret,2022-03-20
3,1,2,0,Carteret,2022-03-21
4,2,2,0,Carteret,2022-03-22
1,0,1,0,Carteret,2022-03-23
1,0,1,0,Carteret,2022-03-24
2,2,0,0,Carteret,2022-03-25
0,0,0,0,Carteret,2022-03-26
3,0,3,0,Carteret,2022-03-27
3,1,2,0,Carteret,2022-03-28
0,0,0,0,Carteret,2022-03-29
2,1,1,0,Carteret,2022-03-30
3,0,3,0,Carteret,2022-04-01
1,0,1,0,Carteret,2022-04-02
2,2,0,0,Carteret,2022-04-03
2,1,1,0,Carteret,2022-04-04
2,1,1,0,Carteret,2022-04-05
1,0,1,0,Carteret,2022-04-06
2,1,1,0,Carteret,2022-04-07
2,1,1,0,Carteret,2022-04-08
3,1,2,0,Carteret,2022-04-09
2,1,1,0,Carteret,2022-04-10
5,3,2,0,Carteret,2022-04-11
6,2,4,0,Carteret,2022-04-12
6,4,2,0,Carteret,2022-04-13
4,1,3,0,Carteret,2022-04-14
2,1,1,0,Carteret,2022-04-15
2,0,2,0,Carteret,2022-04-16
0,0,0,0,Carteret,2022-04-17
5,4,1,0,Carteret,2022-04-19
8,4,4,0,Carteret,2022-04-20
8,6,2,0,Carteret,2022-04-21
7,2,5,0,Carteret,2022-04-22
7,1,6,0,Carteret,2022-04-23
2,0,2,0,Carteret,2022-04-24
11,4,7,0,Carteret,2022-04-25
9,1,8,0,Carteret,2022-04-26
4,0,4,0,Carteret,2022-04-27
4,1,3,0,Carteret,2022-04-29
2,0,2,0,Carteret,2022-04-30
8,1,7,0,Carteret,2022-05-01
12,6,6,0,Carteret,2022-05-02
16,4,12,0,Carteret,2022-05-03
11,8,3,0,Carteret,2022-05-04
14,6,8,0,Carteret,2022-05-05
10,5,5,0,Carteret,2022-05-06
8,3,5,0,Carteret,2022-05-07
7,0,7,0,Carteret,2022-05-08
11,6,5,0,Carteret,2022-05-09
18,10,8,0,Carteret,2022-05-10
22,12,10,0,Carteret,2022-05-11
16,3,13,0,Carteret,2022-05-12
12,5,7,0,Carteret,2022-05-13
11,1,10,0,Carteret,2022-05-14
4,3,1,0,Carteret,2022-05-15
15,3,12,0,Carteret,2022-05-16
21,7,14,0,Carteret,2022-05-17
31,16,15,0,Carteret,2022-05-18
21,8,13,0,Carteret,2022-05-19
18,8,10,0,Carteret,2022-05-20
12,6,6,0,Carteret,2022-05-21
13,4,9,0,Carteret,2022-05-22
22,8,14,0,Carteret,2022-05-23
24,9,15,0,Carteret,2022-05-24
22,8,14,0,Carteret,2022-05-25
23,7,16,0,Carteret,2022-05-26
36,9,27,0,Carteret,2022-05-27
21,7,14,0,Carteret,2022-05-28
13,2,11,0,Carteret,2022-05-29
8,2,6,0,Carteret,2022-05-30
52,33,19,0,Carteret,2022-05-31
21,6,15,0,Carteret,2022-06-01
25,9,16,0,Carteret,2022-06-02
24,7,17,0,Carteret,2022-06-03
10,3,7,0,Carteret,2022-06-04
11,2,9,0,Caswell,2021-12-07
5,0,5,0,Caswell,2021-12-08
3,0,3,0,Caswell,2021-12-09
11,1,10,0,Caswell,2021-12-10
5,0,5,0,Caswell,2021-12-11
1,0,1,0,Caswell,2021-12-12
9,0,9,0,Caswell,2021-12-13
8,3,5,0,Caswell,2021-12-14
11,0,11,0,Caswell,2021-12-15
3,0,3,0,Caswell,2021-12-16
4,1,3,0,Caswell,2021-12-19
19,1,18,0,Caswell,2021-12-20
8,0,8,0,Caswell,2021-12-21
9,1,8,0,Caswell,2021-12-22
11,0,11,0,Caswell,2021-12-23
7,2,5,0,Caswell,2021-12-24
2,1,1,0,Caswell,2021-12-25
12,0,12,0,Caswell,2021-12-26
55,1,54,0,Caswell,2021-12-27
25,2,23,0,Caswell,2021-12-29
50,6,44,0,Caswell,2021-12-30
12,3,9,0,Caswell,2021-12-31
8,1,7,0,Caswell,2022-01-01
9,0,9,0,Caswell,2022-01-02
49,3,46,0,Caswell,2022-01-03
63,4,59,0,Caswell,2022-01-04
67,2,65,0,Caswell,2022-01-06
49,1,48,0,Caswell,2022-01-07
19,1,18,0,Caswell,2022-01-09
89,5,84,0,Caswell,2022-01-10
69,0,69,0,Caswell,2022-01-11
96,8,88,0,Caswell,2022-01-12
76,8,68,0,Caswell,2022-01-13
54,5,49,0,Caswell,2022-01-14
5,1,4,0,Caswell,2022-01-16
28,1,27,0,Caswell,2022-01-17
51,4,47,0,Caswell,2022-01-18
45,3,42,0,Caswell,2022-01-21
21,0,21,0,Caswell,2022-01-23
75,7,68,0,Caswell,2022-01-24
62,2,60,0,Caswell,2022-01-25
28,2,26,0,Caswell,2022-01-26
33,2,31,0,Caswell,2022-01-27
25,3,22,0,Caswell,2022-01-28
3,0,3,0,Caswell,2022-01-29
4,1,3,0,Caswell,2022-01-30
26,1,25,0,Caswell,2022-01-31
22,1,21,0,Caswell,2022-02-01
17,1,16,0,Caswell,2022-02-02
8,1,7,0,Caswell,2022-02-04
4,0,4,0,Caswell,2022-02-05
4,0,4,0,Caswell,2022-02-06
11,1,10,0,Caswell,2022-02-07
25,1,24,0,Caswell,2022-02-08
13,2,11,0,Caswell,2022-02-09
11,1,10,0,Caswell,2022-02-10
10,1,9,0,Caswell,2022-02-11
3,1,2,0,Caswell,2022-02-13
7,0,7,0,Caswell,2022-02-15
5,1,4,0,Caswell,2022-02-17
3,2,1,0,Caswell,2022-02-19
8,0,8,0,Caswell,2022-02-21
2,0,2,0,Caswell,2022-02-23
5,0,5,0,Caswell,2022-02-24
4,0,4,0,Caswell,2022-02-25
1,0,1,0,Caswell,2022-02-26
1,0,1,0,Caswell,2022-02-27
2,0,2,0,Caswell,2022-02-28
0,0,0,0,Caswell,2022-03-01
1,0,1,0,Caswell,2022-03-03
0,0,0,0,Caswell,2022-03-04
1,0,1,0,Caswell,2022-03-05
0,0,0,0,Caswell,2022-03-06
1,0,1,0,Caswell,2022-03-07
0,0,0,0,Caswell,2022-03-08
0,0,0,0,Caswell,2022-03-09
1,0,1,0,Caswell,2022-03-10
0,0,0,0,Caswell,2022-03-11
0,0,0,0,Caswell,2022-03-12
0,0,0,0,Caswell,2022-03-13
0,0,0,0,Caswell,2022-03-14
2,1,1,0,Caswell,2022-03-15
4,1,3,0,Caswell,2022-03-16
1,0,1,0,Caswell,2022-03-17
0,0,0,0,Caswell,2022-03-18
1,0,1,0,Caswell,2022-03-19
0,0,0,0,Caswell,2022-03-20
0,0,0,0,Caswell,2022-03-21
0,0,0,0,Caswell,2022-03-22
0,0,0,0,Caswell,2022-03-23
0,0,0,0,Caswell,2022-03-24
2,0,2,0,Caswell,2022-03-25
0,0,0,0,Caswell,2022-03-26
0,0,0,0,Caswell,2022-03-27
2,0,2,0,Caswell,2022-03-28
0,0,0,0,Caswell,2022-03-29
1,0,1,0,Caswell,2022-03-30
1,0,1,0,Caswell,2022-03-31
0,0,0,0,Caswell,2022-04-01
0,0,0,0,Caswell,2022-04-02
0,0,0,0,Caswell,2022-04-03
3,0,3,0,Caswell,2022-04-04
0,0,0,0,Caswell,2022-04-05
1,0,1,0,Caswell,2022-04-06
1,0,1,0,Caswell,2022-04-07
1,0,1,0,Caswell,2022-04-08
2,0,2,0,Caswell,2022-04-09
1,0,1,0,Caswell,2022-04-10
3,0,3,0,Caswell,2022-04-11
1,0,1,0,Caswell,2022-04-12
1,0,1,0,Caswell,2022-04-13
1,0,1,0,Caswell,2022-04-14
2,1,1,0,Caswell,2022-04-15
0,0,0,0,Caswell,2022-04-16
0,0,0,0,Caswell,2022-04-17
0,0,0,0,Caswell,2022-04-18
7,0,7,0,Caswell,2022-04-19
1,0,1,0,Caswell,2022-04-20
3,1,2,0,Caswell,2022-04-21
2,0,2,0,Caswell,2022-04-22
3,0,3,0,Caswell,2022-04-23
3,0,3,0,Caswell,2022-04-24
7,0,7,0,Caswell,2022-04-25
1,0,1,0,Caswell,2022-04-26
4,0,4,0,Caswell,2022-04-27
3,1,2,0,Caswell,2022-04-28
1,0,1,0,Caswell,2022-04-29
0,0,0,0,Caswell,2022-04-30
2,1,1,0,Caswell,2022-05-01
4,0,4,0,Caswell,2022-05-02
2,1,1,0,Caswell,2022-05-03
7,1,6,0,Caswell,2022-05-04
7,2,5,0,Caswell,2022-05-05
2,0,2,0,Caswell,2022-05-06
3,0,3,0,Caswell,2022-05-07
3,0,3,0,Caswell,2022-05-08
12,2,10,0,Caswell,2022-05-09
8,1,7,0,Caswell,2022-05-10
12,1,11,0,Caswell,2022-05-11
4,2,2,0,Caswell,2022-05-12
9,2,7,0,Caswell,2022-05-13
5,0,5,0,Caswell,2022-05-14
4,0,4,0,Caswell,2022-05-15
9,1,8,0,Caswell,2022-05-16
3,0,3,0,Caswell,2022-05-17
8,1,7,0,Caswell,2022-05-18
5,1,4,0,Caswell,2022-05-19
2,0,2,0,Caswell,2022-05-20
1,0,1,0,Caswell,2022-05-21
0,0,0,0,Caswell,2022-05-22
8,1,7,0,Caswell,2022-05-23
6,1,5,0,Caswell,2022-05-24
8,1,7,0,Caswell,2022-05-25
8,0,8,0,Caswell,2022-05-26
9,0,9,0,Caswell,2022-05-27
5,0,5,0,Caswell,2022-05-28
7,0,7,0,Caswell,2022-05-29
4,2,2,0,Caswell,2022-05-30
9,0,9,0,Caswell,2022-05-31
9,2,7,0,Caswell,2022-06-01
14,1,13,0,Caswell,2022-06-02
7,0,7,0,Caswell,2022-06-03
4,1,3,0,Caswell,2022-06-04
30,10,20,0,Catawba,2021-12-12
94,38,56,0,Catawba,2021-12-13
88,42,46,0,Catawba,2021-12-15
43,13,30,0,Catawba,2021-12-18
34,8,26,0,Catawba,2021-12-19
105,25,80,0,Catawba,2021-12-20
57,20,37,0,Catawba,2021-12-24
100,23,77,0,Catawba,2021-12-26
254,75,179,0,Catawba,2021-12-27
317,119,198,0,Catawba,2021-12-29
203,81,122,0,Catawba,2021-12-31
442,166,276,0,Catawba,2022-01-07
216,57,159,0,Catawba,2022-01-22
106,35,71,0,Catawba,2022-01-30
56,23,33,0,Catawba,2022-02-17
75,36,39,0,Catawba,2022-02-21
32,14,18,0,Catawba,2022-02-25
15,9,6,0,Catawba,2022-03-01
26,8,18,0,Catawba,2022-03-02
18,6,12,0,Catawba,2022-03-04
8,5,3,0,Catawba,2022-03-05
13,2,11,0,Catawba,2022-03-06
21,8,13,0,Catawba,2022-03-07
7,3,4,0,Catawba,2022-03-10
16,4,12,0,Catawba,2022-03-11
3,2,1,0,Catawba,2022-03-12
8,6,2,0,Catawba,2022-03-13
7,3,4,0,Catawba,2022-03-14
6,3,3,0,Catawba,2022-03-16
9,4,5,0,Catawba,2022-03-18
3,1,2,0,Catawba,2022-03-19
1,0,1,0,Catawba,2022-03-20
7,4,3,0,Catawba,2022-03-21
9,6,3,0,Catawba,2022-03-24
1,1,0,0,Catawba,2022-03-25
6,2,4,0,Catawba,2022-03-28
7,3,4,0,Catawba,2022-03-31
1,1,0,0,Catawba,2022-04-02
2,2,0,0,Catawba,2022-04-03
8,5,3,0,Catawba,2022-04-04
5,3,2,0,Catawba,2022-04-05
4,2,2,0,Catawba,2022-04-06
4,3,1,0,Catawba,2022-04-07
3,2,1,0,Catawba,2022-04-08
1,0,1,0,Catawba,2022-04-09
9,0,9,0,Catawba,2022-04-10
11,4,7,0,Catawba,2022-04-11
4,3,1,0,Catawba,2022-04-12
12,5,7,0,Catawba,2022-04-14
9,5,4,0,Catawba,2022-04-15
9,3,6,0,Catawba,2022-04-16
3,2,1,0,Catawba,2022-04-17
16,7,9,0,Catawba,2022-04-18
11,4,7,0,Catawba,2022-04-19
16,9,7,0,Catawba,2022-04-21
16,7,9,0,Catawba,2022-04-22
8,2,6,0,Catawba,2022-04-23
9,3,6,0,Catawba,2022-04-24
19,8,11,0,Catawba,2022-04-25
9,4,5,0,Catawba,2022-04-26
22,8,14,0,Catawba,2022-04-27
12,4,8,0,Catawba,2022-04-28
10,4,6,0,Catawba,2022-04-29
16,5,11,0,Catawba,2022-04-30
7,1,6,0,Catawba,2022-05-01
30,15,15,0,Catawba,2022-05-02
29,11,18,0,Catawba,2022-05-03
34,18,16,0,Catawba,2022-05-04
24,19,5,0,Catawba,2022-05-05
27,9,18,0,Catawba,2022-05-06
18,4,14,0,Catawba,2022-05-07
13,5,8,0,Catawba,2022-05-08
41,16,25,0,Catawba,2022-05-09
40,15,25,0,Catawba,2022-05-10
30,14,16,0,Catawba,2022-05-11
32,16,16,0,Catawba,2022-05-12
30,14,16,0,Catawba,2022-05-13
28,9,19,0,Catawba,2022-05-14
27,7,20,0,Catawba,2022-05-15
66,28,38,0,Catawba,2022-05-16
63,22,41,0,Catawba,2022-05-17
51,26,25,0,Catawba,2022-05-18
50,22,28,0,Catawba,2022-05-19
43,27,16,0,Catawba,2022-05-20
25,13,12,0,Catawba,2022-05-21
43,10,33,0,Catawba,2022-05-22
64,30,34,0,Catawba,2022-05-23
61,30,31,0,Catawba,2022-05-24
60,26,34,0,Catawba,2022-05-25
63,28,35,0,Catawba,2022-05-26
40,19,21,0,Catawba,2022-05-27
36,6,30,0,Catawba,2022-05-28
30,7,23,0,Catawba,2022-05-29
15,7,8,0,Catawba,2022-05-30
59,29,30,0,Catawba,2022-05-31
54,21,33,0,Catawba,2022-06-01
62,18,44,0,Catawba,2022-06-02
38,23,15,0,Catawba,2022-06-03
19,3,16,0,Catawba,2022-06-04
15,3,12,0,Chatham,2021-12-09
13,0,13,0,Chatham,2021-12-11
10,2,8,0,Chatham,2021-12-12
17,0,17,0,Chatham,2021-12-14
25,4,21,0,Chatham,2021-12-17
19,5,14,0,Chatham,2021-12-18
38,2,36,0,Chatham,2021-12-20
51,9,42,0,Chatham,2021-12-23
33,2,31,0,Chatham,2021-12-24
8,4,4,0,Chatham,2021-12-25
40,2,38,0,Chatham,2021-12-26
146,19,127,0,Chatham,2021-12-27
128,26,102,0,Chatham,2021-12-29
106,18,88,0,Chatham,2021-12-30
67,15,52,0,Chatham,2021-12-31
20,3,17,0,Chatham,2022-01-01
59,15,44,0,Chatham,2022-01-02
166,27,139,0,Chatham,2022-01-03
187,30,157,0,Chatham,2022-01-04
166,24,142,0,Chatham,2022-01-06
112,24,88,0,Chatham,2022-01-07
56,13,43,0,Chatham,2022-01-09
266,44,222,0,Chatham,2022-01-10
169,6,163,0,Chatham,2022-01-11
181,5,176,0,Chatham,2022-01-12
84,13,71,0,Chatham,2022-01-15
87,3,84,0,Chatham,2022-01-17
245,47,198,0,Chatham,2022-01-18
172,19,153,0,Chatham,2022-01-20
31,3,28,0,Chatham,2022-01-22
205,33,172,0,Chatham,2022-01-24
118,18,100,0,Chatham,2022-01-25
111,12,99,0,Chatham,2022-01-26
85,19,66,0,Chatham,2022-01-27
30,9,21,0,Chatham,2022-01-30
106,25,81,0,Chatham,2022-01-31
54,9,45,0,Chatham,2022-02-02
71,18,53,0,Chatham,2022-02-03
49,12,37,0,Chatham,2022-02-04
9,5,4,0,Chatham,2022-02-06
70,17,53,0,Chatham,2022-02-07
35,15,20,0,Chatham,2022-02-08
27,3,24,0,Chatham,2022-02-10
19,2,17,0,Chatham,2022-02-11
8,2,6,0,Chatham,2022-02-12
13,6,7,0,Chatham,2022-02-13
35,11,24,0,Chatham,2022-02-14
18,5,13,0,Chatham,2022-02-17
5,1,4,0,Chatham,2022-02-19
14,6,8,0,Chatham,2022-02-20
23,4,19,0,Chatham,2022-02-21
9,5,4,0,Chatham,2022-02-22
15,4,11,0,Chatham,2022-02-23
13,4,9,0,Chatham,2022-02-24
8,3,5,0,Chatham,2022-02-25
4,0,4,0,Chatham,2022-02-26
4,1,3,0,Chatham,2022-02-27
10,5,5,0,Chatham,2022-02-28
11,4,7,0,Chatham,2022-03-01
11,0,11,0,Chatham,2022-03-02
7,3,4,0,Chatham,2022-03-03
8,1,7,0,Chatham,2022-03-04
2,0,2,0,Chatham,2022-03-05
4,2,2,0,Chatham,2022-03-06
10,1,9,0,Chatham,2022-03-07
8,1,7,0,Chatham,2022-03-08
4,0,4,0,Chatham,2022-03-09
6,0,6,0,Chatham,2022-03-10
7,0,7,0,Chatham,2022-03-11
1,0,1,0,Chatham,2022-03-12
0,0,0,0,Chatham,2022-03-13
7,1,6,0,Chatham,2022-03-14
9,3,6,0,Chatham,2022-03-15
3,1,2,0,Chatham,2022-03-16
3,0,3,0,Chatham,2022-03-17
5,0,5,0,Chatham,2022-03-18
1,0,1,0,Chatham,2022-03-19
5,1,4,0,Chatham,2022-03-20
9,4,5,0,Chatham,2022-03-21
1,0,1,0,Chatham,2022-03-22
1,0,1,0,Chatham,2022-03-23
2,1,1,0,Chatham,2022-03-24
1,0,1,0,Chatham,2022-03-25
1,0,1,0,Chatham,2022-03-26
1,0,1,0,Chatham,2022-03-27
3,1,2,0,Chatham,2022-03-28
4,1,3,0,Chatham,2022-03-31
2,2,0,0,Chatham,2022-04-01
3,1,2,0,Chatham,2022-04-02
2,2,0,0,Chatham,2022-04-03
6,2,4,0,Chatham,2022-04-04
8,2,6,0,Chatham,2022-04-05
12,4,8,0,Chatham,2022-04-06
12,3,9,0,Chatham,2022-04-07
8,0,8,0,Chatham,2022-04-08
9,1,8,0,Chatham,2022-04-09
7,1,6,0,Chatham,2022-04-10
14,1,13,0,Chatham,2022-04-11
15,1,14,0,Chatham,2022-04-12
18,2,16,0,Chatham,2022-04-13
11,1,10,0,Chatham,2022-04-14
7,3,4,0,Chatham,2022-04-15
5,0,5,0,Chatham,2022-04-16
5,1,4,0,Chatham,2022-04-17
9,0,9,0,Chatham,2022-04-18
12,0,12,0,Chatham,2022-04-19
18,6,12,0,Chatham,2022-04-20
7,1,6,0,Chatham,2022-04-21
12,0,12,0,Chatham,2022-04-22
4,0,4,0,Chatham,2022-04-23
8,0,8,0,Chatham,2022-04-24
16,3,13,0,Chatham,2022-04-25
20,2,18,0,Chatham,2022-04-26
18,3,15,0,Chatham,2022-04-27
16,2,14,0,Chatham,2022-04-28
18,2,16,0,Chatham,2022-04-29
10,1,9,0,Chatham,2022-04-30
16,5,11,0,Chatham,2022-05-01
34,11,23,0,Chatham,2022-05-02
27,8,19,0,Chatham,2022-05-03
37,8,29,0,Chatham,2022-05-04
29,6,23,0,Chatham,2022-05-05
26,5,21,0,Chatham,2022-05-06
11,1,10,0,Chatham,2022-05-07
22,4,18,0,Chatham,2022-05-08
28,5,23,0,Chatham,2022-05-09
39,4,35,0,Chatham,2022-05-10
21,7,14,0,Chatham,2022-05-11
22,3,19,0,Chatham,2022-05-12
32,5,27,0,Chatham,2022-05-13
15,1,14,0,Chatham,2022-05-14
18,1,17,0,Chatham,2022-05-15
41,9,32,0,Chatham,2022-05-16
32,4,28,0,Chatham,2022-05-17
37,2,35,0,Chatham,2022-05-18
33,8,25,0,Chatham,2022-05-19
35,4,31,0,Chatham,2022-05-20
14,1,13,0,Chatham,2022-05-21
19,2,17,0,Chatham,2022-05-22
39,7,32,0,Chatham,2022-05-23
22,4,18,0,Chatham,2022-05-24
22,4,18,0,Chatham,2022-05-25
37,5,32,0,Chatham,2022-05-26
29,6,23,0,Chatham,2022-05-27
17,5,12,0,Chatham,2022-05-28
8,1,7,0,Chatham,2022-05-29
14,1,13,0,Chatham,2022-05-30
54,5,49,0,Chatham,2022-05-31
29,5,24,0,Chatham,2022-06-01
27,3,24,0,Chatham,2022-06-02
20,3,17,0,Chatham,2022-06-03
13,0,13,0,Chatham,2022-06-04
6,0,6,0,Cherokee,2021-12-08
10,2,8,0,Cherokee,2021-12-10
3,0,3,0,Cherokee,2021-12-11
2,1,1,0,Cherokee,2021-12-12
5,0,5,0,Cherokee,2021-12-14
3,0,3,0,Cherokee,2021-12-15
9,2,7,0,Cherokee,2021-12-16
3,0,3,0,Cherokee,2021-12-17
3,0,3,0,Cherokee,2021-12-18
2,0,2,0,Cherokee,2021-12-19
7,2,5,0,Cherokee,2021-12-20
11,1,10,0,Cherokee,2021-12-22
6,3,3,0,Cherokee,2021-12-23
3,0,3,0,Cherokee,2021-12-24
2,1,1,0,Cherokee,2021-12-25
10,2,8,0,Cherokee,2021-12-26
23,8,15,0,Cherokee,2021-12-27
28,9,19,0,Cherokee,2021-12-29
55,17,38,0,Cherokee,2021-12-30
10,5,5,0,Cherokee,2021-12-31
7,2,5,0,Cherokee,2022-01-01
15,2,13,0,Cherokee,2022-01-02
69,10,59,0,Cherokee,2022-01-03
84,16,68,0,Cherokee,2022-01-04
29,9,20,0,Cherokee,2022-01-08
19,1,18,0,Cherokee,2022-01-09
109,36,73,0,Cherokee,2022-01-10
76,26,50,0,Cherokee,2022-01-11
87,24,63,0,Cherokee,2022-01-14
104,25,79,0,Cherokee,2022-01-18
24,6,18,0,Cherokee,2022-01-22
91,27,64,0,Cherokee,2022-01-24
57,12,45,0,Cherokee,2022-01-25
48,10,38,0,Cherokee,2022-01-26
52,13,39,0,Cherokee,2022-01-27
29,8,21,0,Cherokee,2022-01-28
7,2,5,0,Cherokee,2022-01-29
16,6,10,0,Cherokee,2022-01-30
31,7,24,0,Cherokee,2022-02-01
27,5,22,0,Cherokee,2022-02-02
12,1,11,0,Cherokee,2022-02-05
36,11,25,0,Cherokee,2022-02-07
26,8,18,0,Cherokee,2022-02-08
23,4,19,0,Cherokee,2022-02-09
21,9,12,0,Cherokee,2022-02-10
8,1,7,0,Cherokee,2022-02-13
15,6,9,0,Cherokee,2022-02-14
23,6,17,0,Cherokee,2022-02-15
11,5,6,0,Cherokee,2022-02-16
7,2,5,0,Cherokee,2022-02-18
6,0,6,0,Cherokee,2022-02-19
5,1,4,0,Cherokee,2022-02-21
11,1,10,0,Cherokee,2022-02-22
3,1,2,0,Cherokee,2022-02-23
9,2,7,0,Cherokee,2022-02-24
1,0,1,0,Cherokee,2022-02-26
1,0,1,0,Cherokee,2022-02-27
10,1,9,0,Cherokee,2022-02-28
5,3,2,0,Cherokee,2022-03-01
1,1,0,0,Cherokee,2022-03-02
4,1,3,0,Cherokee,2022-03-03
0,0,0,0,Cherokee,2022-03-05
4,1,3,0,Cherokee,2022-03-07
0,0,0,0,Cherokee,2022-03-08
4,1,3,0,Cherokee,2022-03-09
0,0,0,0,Cherokee,2022-03-10
1,0,1,0,Cherokee,2022-03-11
0,0,0,0,Cherokee,2022-03-13
1,0,1,0,Cherokee,2022-03-14
0,0,0,0,Cherokee,2022-03-15
1,1,0,0,Cherokee,2022-03-17
0,0,0,0,Cherokee,2022-03-19
0,0,0,0,Cherokee,2022-03-20
0,0,0,0,Cherokee,2022-03-21
1,1,0,0,Cherokee,2022-03-22
1,0,1,0,Cherokee,2022-03-23
1,0,1,0,Cherokee,2022-03-24
1,0,1,0,Cherokee,2022-03-25
0,0,0,0,Cherokee,2022-03-26
0,0,0,0,Cherokee,2022-03-27
0,0,0,0,Cherokee,2022-03-28
0,0,0,0,Cherokee,2022-03-29
1,0,1,0,Cherokee,2022-03-31
0,0,0,0,Cherokee,2022-04-01
0,0,0,0,Cherokee,2022-04-02
0,0,0,0,Cherokee,2022-04-03
2,1,1,0,Cherokee,2022-04-04
1,0,1,0,Cherokee,2022-04-05
1,1,0,0,Cherokee,2022-04-06
1,1,0,0,Cherokee,2022-04-07
1,0,1,0,Cherokee,2022-04-08
0,0,0,0,Cherokee,2022-04-09
0,0,0,0,Cherokee,2022-04-10
0,0,0,0,Cherokee,2022-04-11
1,1,0,0,Cherokee,2022-04-12
1,0,1,0,Cherokee,2022-04-13
1,0,1,0,Cherokee,2022-04-14
3,0,3,0,Cherokee,2022-04-15
2,0,2,0,Cherokee,2022-04-16
0,0,0,0,Cherokee,2022-04-17
4,1,3,0,Cherokee,2022-04-18
0,0,0,0,Cherokee,2022-04-19
0,0,0,0,Cherokee,2022-04-20
1,0,1,0,Cherokee,2022-04-21
0,0,0,0,Cherokee,2022-04-22
1,0,1,0,Cherokee,2022-04-23
0,0,0,0,Cherokee,2022-04-24
3,0,3,0,Cherokee,2022-04-25
2,0,2,0,Cherokee,2022-04-26
1,0,1,0,Cherokee,2022-04-27
2,2,0,0,Cherokee,2022-04-28
2,0,2,0,Cherokee,2022-04-29
2,0,2,0,Cherokee,2022-04-30
0,0,0,0,Cherokee,2022-05-01
4,0,4,0,Cherokee,2022-05-02
4,0,4,0,Cherokee,2022-05-03
2,1,1,0,Cherokee,2022-05-04
1,1,0,0,Cherokee,2022-05-05
3,0,3,0,Cherokee,2022-05-06
1,0,1,0,Cherokee,2022-05-07
1,0,1,0,Cherokee,2022-05-08
6,1,5,0,Cherokee,2022-05-09
0,0,0,0,Cherokee,2022-05-10
4,2,2,0,Cherokee,2022-05-11
1,0,1,0,Cherokee,2022-05-12
3,1,2,0,Cherokee,2022-05-13
2,0,2,0,Cherokee,2022-05-14
1,0,1,0,Cherokee,2022-05-15
1,0,1,0,Cherokee,2022-05-16
3,0,3,0,Cherokee,2022-05-17
1,0,1,0,Cherokee,2022-05-18
2,0,2,0,Cherokee,2022-05-19
2,0,2,0,Cherokee,2022-05-20
4,2,2,0,Cherokee,2022-05-21
5,0,5,0,Cherokee,2022-05-22
4,0,4,0,Cherokee,2022-05-23
1,0,1,0,Cherokee,2022-05-24
3,0,3,0,Cherokee,2022-05-25
6,2,4,0,Cherokee,2022-05-26
8,2,6,0,Cherokee,2022-05-27
3,0,3,0,Cherokee,2022-05-28
1,1,0,0,Cherokee,2022-05-29
3,0,3,0,Cherokee,2022-05-30
4,1,3,0,Cherokee,2022-05-31
7,3,4,0,Cherokee,2022-06-01
8,3,5,0,Cherokee,2022-06-02
5,1,4,0,Cherokee,2022-06-03
0,0,0,0,Cherokee,2022-06-04
0,0,0,0,Chowan,2021-12-07
0,0,0,0,Chowan,2021-12-08
2,0,2,0,Chowan,2021-12-09
0,0,0,0,Chowan,2021-12-11
2,0,2,0,Chowan,2021-12-12
5,0,5,0,Chowan,2021-12-14
5,1,4,0,Chowan,2021-12-15
4,0,4,0,Chowan,2021-12-16
8,1,7,0,Chowan,2021-12-17
4,0,4,0,Chowan,2021-12-18
3,0,3,0,Chowan,2021-12-19
9,1,8,0,Chowan,2021-12-20
10,0,10,0,Chowan,2021-12-21
7,0,7,0,Chowan,2021-12-22
11,0,11,0,Chowan,2021-12-23
3,1,2,0,Chowan,2021-12-24
8,1,7,0,Chowan,2021-12-25
2,0,2,0,Chowan,2021-12-26
43,1,42,0,Chowan,2021-12-27
61,0,61,0,Chowan,2021-12-29
35,0,35,0,Chowan,2021-12-30
44,0,44,0,Chowan,2021-12-31
11,0,11,0,Chowan,2022-01-01
18,0,18,0,Chowan,2022-01-02
86,2,84,0,Chowan,2022-01-03
61,0,61,0,Chowan,2022-01-04
57,2,55,0,Chowan,2022-01-05
39,2,37,0,Chowan,2022-01-07
9,0,9,0,Chowan,2022-01-09
59,1,58,0,Chowan,2022-01-11
48,1,47,0,Chowan,2022-01-13
30,1,29,0,Chowan,2022-01-15
12,4,8,0,Chowan,2022-01-16
31,6,25,0,Chowan,2022-01-17
117,4,113,0,Chowan,2022-01-18
39,4,35,0,Chowan,2022-01-19
11,5,6,0,Chowan,2022-01-21
8,4,4,0,Chowan,2022-01-22
12,0,12,0,Chowan,2022-01-23
73,4,69,0,Chowan,2022-01-24
32,1,31,0,Chowan,2022-01-26
5,0,5,0,Chowan,2022-01-30
26,3,23,0,Chowan,2022-01-31
19,0,19,0,Chowan,2022-02-01
9,0,9,0,Chowan,2022-02-03
7,0,7,0,Chowan,2022-02-04
0,0,0,0,Chowan,2022-02-05
4,0,4,0,Chowan,2022-02-08
6,0,6,0,Chowan,2022-02-09
2,0,2,0,Chowan,2022-02-10
4,0,4,0,Chowan,2022-02-11
2,0,2,0,Chowan,2022-02-12
2,1,1,0,Chowan,2022-02-13
3,0,3,0,Chowan,2022-02-14
6,0,6,0,Chowan,2022-02-16
8,2,6,0,Chowan,2022-02-17
7,0,7,0,Chowan,2022-02-18
0,0,0,0,Chowan,2022-02-19
0,0,0,0,Chowan,2022-02-20
7,2,5,0,Chowan,2022-02-21
1,0,1,0,Chowan,2022-02-22
1,0,1,0,Chowan,2022-02-23
1,0,1,0,Chowan,2022-02-25
0,0,0,0,Chowan,2022-02-26
1,0,1,0,Chowan,2022-02-27
4,0,4,0,Chowan,2022-02-28
0,0,0,0,Chowan,2022-03-01
1,0,1,0,Chowan,2022-03-02
0,0,0,0,Chowan,2022-03-04
0,0,0,0,Chowan,2022-03-05
1,0,1,0,Chowan,2022-03-06
0,0,0,0,Chowan,2022-03-07
2,0,2,0,Chowan,2022-03-08
0,0,0,0,Chowan,2022-03-09
1,0,1,0,Chowan,2022-03-11
0,0,0,0,Chowan,2022-03-12
0,0,0,0,Chowan,2022-03-13
0,0,0,0,Chowan,2022-03-14
1,0,1,0,Chowan,2022-03-15
1,0,1,0,Chowan,2022-03-16
0,0,0,0,Chowan,2022-03-17
1,0,1,0,Chowan,2022-03-18
0,0,0,0,Chowan,2022-03-19
3,3,0,0,Chowan,2022-03-20
0,0,0,0,Chowan,2022-03-21
0,0,0,0,Chowan,2022-03-22
0,0,0,0,Chowan,2022-03-23
0,0,0,0,Chowan,2022-03-24
0,0,0,0,Chowan,2022-03-25
0,0,0,0,Chowan,2022-03-26
0,0,0,0,Chowan,2022-03-27
1,0,1,0,Chowan,2022-03-28
0,0,0,0,Chowan,2022-03-29
1,0,1,0,Chowan,2022-03-30
0,0,0,0,Chowan,2022-03-31
1,0,1,0,Chowan,2022-04-01
0,0,0,0,Chowan,2022-04-02
1,0,1,0,Chowan,2022-04-03
0,0,0,0,Chowan,2022-04-04
1,0,1,0,Chowan,2022-04-05
0,0,0,0,Chowan,2022-04-06
0,0,0,0,Chowan,2022-04-07
0,0,0,0,Chowan,2022-04-08
0,0,0,0,Chowan,2022-04-09
0,0,0,0,Chowan,2022-04-10
0,0,0,0,Chowan,2022-04-11
2,0,2,0,Chowan,2022-04-12
0,0,0,0,Chowan,2022-04-13
0,0,0,0,Chowan,2022-04-14
2,0,2,0,Chowan,2022-04-15
1,0,1,0,Chowan,2022-04-16
0,0,0,0,Chowan,2022-04-17
2,0,2,0,Chowan,2022-04-18
0,0,0,0,Chowan,2022-04-19
0,0,0,0,Chowan,2022-04-20
1,0,1,0,Chowan,2022-04-21
2,1,1,0,Chowan,2022-04-22
1,0,1,0,Chowan,2022-04-23
0,0,0,0,Chowan,2022-04-24
3,0,3,0,Chowan,2022-04-25
1,0,1,0,Chowan,2022-04-26
0,0,0,0,Chowan,2022-04-27
1,0,1,0,Chowan,2022-04-28
0,0,0,0,Chowan,2022-04-29
1,0,1,0,Chowan,2022-04-30
0,0,0,0,Chowan,2022-05-01
1,0,1,0,Chowan,2022-05-02
4,0,4,0,Chowan,2022-05-03
1,0,1,0,Chowan,2022-05-04
3,0,3,0,Chowan,2022-05-05
1,0,1,0,Chowan,2022-05-06
1,0,1,0,Chowan,2022-05-07
1,0,1,0,Chowan,2022-05-08
5,0,5,0,Chowan,2022-05-09
5,1,4,0,Chowan,2022-05-10
4,0,4,0,Chowan,2022-05-11
7,0,7,0,Chowan,2022-05-12
11,0,11,0,Chowan,2022-05-13
2,0,2,0,Chowan,2022-05-14
7,2,5,0,Chowan,2022-05-15
9,0,9,0,Chowan,2022-05-16
6,0,6,0,Chowan,2022-05-17
10,0,10,0,Chowan,2022-05-18
4,0,4,0,Chowan,2022-05-19
4,0,4,0,Chowan,2022-05-20
1,0,1,0,Chowan,2022-05-21
1,0,1,0,Chowan,2022-05-22
6,1,5,0,Chowan,2022-05-23
6,1,5,0,Chowan,2022-05-24
5,0,5,0,Chowan,2022-05-25
11,0,11,0,Chowan,2022-05-26
8,0,8,0,Chowan,2022-05-27
2,1,1,0,Chowan,2022-05-28
7,0,7,0,Chowan,2022-05-29
1,0,1,0,Chowan,2022-05-30
8,0,8,0,Chowan,2022-05-31
5,0,5,0,Chowan,2022-06-01
3,0,3,0,Chowan,2022-06-02
2,0,2,0,Chowan,2022-06-03
1,0,1,0,Chowan,2022-06-04
4,0,4,0,Clay,2021-12-08
2,0,2,0,Clay,2021-12-09
3,0,3,0,Clay,2021-12-10
0,0,0,0,Clay,2021-12-11
1,0,1,0,Clay,2021-12-12
3,2,1,0,Clay,2021-12-13
0,0,0,0,Clay,2021-12-14
1,0,1,0,Clay,2021-12-16
5,0,5,0,Clay,2021-12-17
1,0,1,0,Clay,2021-12-18
1,0,1,0,Clay,2021-12-19
0,0,0,0,Clay,2021-12-20
0,0,0,0,Clay,2021-12-21
3,1,2,0,Clay,2021-12-22
5,2,3,0,Clay,2021-12-23
3,0,3,0,Clay,2021-12-24
0,0,0,0,Clay,2021-12-25
4,0,4,0,Clay,2021-12-26
9,0,9,0,Clay,2021-12-27
10,1,9,0,Clay,2021-12-28
13,3,10,0,Clay,2021-12-29
14,2,12,0,Clay,2021-12-30
9,3,6,0,Clay,2021-12-31
1,0,1,0,Clay,2022-01-01
7,1,6,0,Clay,2022-01-02
30,6,24,0,Clay,2022-01-03
34,8,26,0,Clay,2022-01-04
18,3,15,0,Clay,2022-01-05
29,6,23,0,Clay,2022-01-06
25,2,23,0,Clay,2022-01-07
9,2,7,0,Clay,2022-01-08
43,11,32,0,Clay,2022-01-10
19,1,18,0,Clay,2022-01-11
32,10,22,0,Clay,2022-01-12
28,4,24,0,Clay,2022-01-13
29,10,19,0,Clay,2022-01-14
13,0,13,0,Clay,2022-01-15
11,8,3,0,Clay,2022-01-16
22,16,6,0,Clay,2022-01-17
35,4,31,0,Clay,2022-01-18
31,6,25,0,Clay,2022-01-19
20,4,16,0,Clay,2022-01-21
11,0,11,0,Clay,2022-01-22
31,11,20,0,Clay,2022-01-24
16,3,13,0,Clay,2022-01-25
19,4,15,0,Clay,2022-01-26
29,10,19,0,Clay,2022-01-27
18,9,9,0,Clay,2022-01-28
3,0,3,0,Clay,2022-01-29
11,1,10,0,Clay,2022-01-30
19,5,14,0,Clay,2022-01-31
10,4,6,0,Clay,2022-02-01
9,3,6,0,Clay,2022-02-04
8,2,6,0,Clay,2022-02-06
12,3,9,0,Clay,2022-02-07
4,1,3,0,Clay,2022-02-08
11,1,10,0,Clay,2022-02-09
7,3,4,0,Clay,2022-02-10
2,1,1,0,Clay,2022-02-11
1,0,1,0,Clay,2022-02-12
2,1,1,0,Clay,2022-02-13
5,2,3,0,Clay,2022-02-14
0,0,0,0,Clay,2022-02-15
5,0,5,0,Clay,2022-02-16
6,2,4,0,Clay,2022-02-17
8,0,8,0,Clay,2022-02-18
0,0,0,0,Clay,2022-02-19
1,0,1,0,Clay,2022-02-20
2,0,2,0,Clay,2022-02-22
0,0,0,0,Clay,2022-02-23
0,0,0,0,Clay,2022-02-24
0,0,0,0,Clay,2022-02-25
0,0,0,0,Clay,2022-02-26
0,0,0,0,Clay,2022-02-27
2,1,1,0,Clay,2022-02-28
1,0,1,0,Clay,2022-03-01
5,3,2,0,Clay,2022-03-02
1,0,1,0,Clay,2022-03-03
1,0,1,0,Clay,2022-03-04
0,0,0,0,Clay,2022-03-05
0,0,0,0,Clay,2022-03-06
2,0,2,0,Clay,2022-03-07
1,0,1,0,Clay,2022-03-08
0,0,0,0,Clay,2022-03-09
1,0,1,0,Clay,2022-03-10
1,0,1,0,Clay,2022-03-11
0,0,0,0,Clay,2022-03-12
0,0,0,0,Clay,2022-03-13
4,0,4,0,Clay,2022-03-14
1,0,1,0,Clay,2022-03-15
0,0,0,0,Clay,2022-03-16
0,0,0,0,Clay,2022-03-17
1,0,1,0,Clay,2022-03-18
0,0,0,0,Clay,2022-03-19
1,0,1,0,Clay,2022-03-20
0,0,0,0,Clay,2022-03-21
0,0,0,0,Clay,2022-03-22
0,0,0,0,Clay,2022-03-23
0,0,0,0,Clay,2022-03-24
0,0,0,0,Clay,2022-03-25
0,0,0,0,Clay,2022-03-26
0,0,0,0,Clay,2022-03-27
0,0,0,0,Clay,2022-03-28
0,0,0,0,Clay,2022-03-29
0,0,0,0,Clay,2022-03-30
0,0,0,0,Clay,2022-03-31
1,0,1,0,Clay,2022-04-01
0,0,0,0,Clay,2022-04-03
0,0,0,0,Clay,2022-04-04
0,0,0,0,Clay,2022-04-05
0,0,0,0,Clay,2022-04-06
0,0,0,0,Clay,2022-04-07
0,0,0,0,Clay,2022-04-08
0,0,0,0,Clay,2022-04-09
0,0,0,0,Clay,2022-04-10
0,0,0,0,Clay,2022-04-11
0,0,0,0,Clay,2022-04-12
0,0,0,0,Clay,2022-04-13
0,0,0,0,Clay,2022-04-14
0,0,0,0,Clay,2022-04-15
0,0,0,0,Clay,2022-04-16
0,0,0,0,Clay,2022-04-17
4,0,4,0,Clay,2022-04-18
0,0,0,0,Clay,2022-04-19
0,0,0,0,Clay,2022-04-20
0,0,0,0,Clay,2022-04-21
1,0,1,0,Clay,2022-04-22
1,0,1,0,Clay,2022-04-23
0,0,0,0,Clay,2022-04-24
0,0,0,0,Clay,2022-04-25
2,0,2,0,Clay,2022-04-26
0,0,0,0,Clay,2022-04-27
1,1,0,0,Clay,2022-04-28
1,0,1,0,Clay,2022-04-29
0,0,0,0,Clay,2022-04-30
1,0,1,0,Clay,2022-05-01
2,0,2,0,Clay,2022-05-02
0,0,0,0,Clay,2022-05-03
0,0,0,0,Clay,2022-05-05
0,0,0,0,Clay,2022-05-06
1,0,1,0,Clay,2022-05-07
2,0,2,0,Clay,2022-05-08
1,0,1,0,Clay,2022-05-09
3,1,2,0,Clay,2022-05-10
1,0,1,0,Clay,2022-05-11
1,0,1,0,Clay,2022-05-12
1,0,1,0,Clay,2022-05-13
1,1,0,0,Clay,2022-05-14
1,0,1,0,Clay,2022-05-15
1,0,1,0,Clay,2022-05-16
4,2,2,0,Clay,2022-05-17
6,1,5,0,Clay,2022-05-18
3,2,1,0,Clay,2022-05-19
0,0,0,0,Clay,2022-05-20
1,0,1,0,Clay,2022-05-21
0,0,0,0,Clay,2022-05-22
2,1,1,0,Clay,2022-05-23
3,0,3,0,Clay,2022-05-24
3,2,1,0,Clay,2022-05-25
1,0,1,0,Clay,2022-05-26
5,1,4,0,Clay,2022-05-27
5,0,5,0,Clay,2022-05-28
1,0,1,0,Clay,2022-05-29
0,0,0,0,Clay,2022-05-30
3,2,1,0,Clay,2022-05-31
1,0,1,0,Clay,2022-06-01
0,0,0,0,Clay,2022-06-02
1,1,0,0,Clay,2022-06-03
0,0,0,0,Clay,2022-06-04
31,10,21,0,Cleveland,2021-12-09
27,7,20,0,Cleveland,2021-12-12
57,10,47,0,Cleveland,2021-12-13
23,4,19,0,Cleveland,2021-12-18
59,5,54,0,Cleveland,2021-12-22
51,6,45,0,Cleveland,2021-12-23
32,3,29,0,Cleveland,2021-12-24
127,15,112,0,Cleveland,2021-12-27
219,56,163,0,Cleveland,2021-12-29
241,50,191,0,Cleveland,2021-12-30
154,41,113,0,Cleveland,2021-12-31
96,22,74,0,Cleveland,2022-01-01
125,50,75,0,Cleveland,2022-01-02
302,81,221,0,Cleveland,2022-01-03
154,42,112,0,Cleveland,2022-01-08
126,46,80,0,Cleveland,2022-01-09
415,85,330,0,Cleveland,2022-01-10
358,73,285,0,Cleveland,2022-01-12
106,16,90,0,Cleveland,2022-01-17
275,50,225,0,Cleveland,2022-01-21
105,33,72,0,Cleveland,2022-01-23
202,19,183,0,Cleveland,2022-01-26
169,21,148,0,Cleveland,2022-01-27
153,18,135,0,Cleveland,2022-01-28
63,14,49,0,Cleveland,2022-01-29
63,22,41,0,Cleveland,2022-01-30
43,10,33,0,Cleveland,2022-02-15
46,7,39,0,Cleveland,2022-02-16
23,4,19,0,Cleveland,2022-02-21
16,4,12,0,Cleveland,2022-02-24
16,1,15,0,Cleveland,2022-02-25
12,2,10,0,Cleveland,2022-02-28
10,0,10,0,Cleveland,2022-03-01
9,1,8,0,Cleveland,2022-03-02
8,1,7,0,Cleveland,2022-03-03
8,1,7,0,Cleveland,2022-03-04
3,1,2,0,Cleveland,2022-03-05
6,2,4,0,Cleveland,2022-03-08
0,0,0,0,Cleveland,2022-03-09
6,1,5,0,Cleveland,2022-03-10
1,1,0,0,Cleveland,2022-03-11
2,0,2,0,Cleveland,2022-03-13
1,0,1,0,Cleveland,2022-03-14
5,0,5,0,Cleveland,2022-03-16
0,0,0,0,Cleveland,2022-03-19
0,0,0,0,Cleveland,2022-03-20
2,0,2,0,Cleveland,2022-03-21
2,0,2,0,Cleveland,2022-03-22
1,0,1,0,Cleveland,2022-03-24
1,0,1,0,Cleveland,2022-03-25
0,0,0,0,Cleveland,2022-03-27
1,0,1,0,Cleveland,2022-03-28
0,0,0,0,Cleveland,2022-03-29
0,0,0,0,Cleveland,2022-03-30
3,0,3,0,Cleveland,2022-03-31
1,0,1,0,Cleveland,2022-04-01
2,0,2,0,Cleveland,2022-04-02
1,0,1,0,Cleveland,2022-04-03
2,1,1,0,Cleveland,2022-04-04
1,0,1,0,Cleveland,2022-04-05
3,0,3,0,Cleveland,2022-04-06
3,0,3,0,Cleveland,2022-04-07
4,0,4,0,Cleveland,2022-04-08
0,0,0,0,Cleveland,2022-04-09
3,0,3,0,Cleveland,2022-04-10
5,1,4,0,Cleveland,2022-04-11
2,1,1,0,Cleveland,2022-04-12
5,0,5,0,Cleveland,2022-04-13
1,0,1,0,Cleveland,2022-04-14
2,0,2,0,Cleveland,2022-04-15
4,1,3,0,Cleveland,2022-04-16
1,0,1,0,Cleveland,2022-04-17
3,1,2,0,Cleveland,2022-04-18
3,1,2,0,Cleveland,2022-04-19
10,2,8,0,Cleveland,2022-04-20
10,3,7,0,Cleveland,2022-04-21
5,1,4,0,Cleveland,2022-04-22
7,0,7,0,Cleveland,2022-04-23
7,1,6,0,Cleveland,2022-04-24
20,3,17,0,Cleveland,2022-04-26
4,1,3,0,Cleveland,2022-04-27
6,1,5,0,Cleveland,2022-04-28
4,2,2,0,Cleveland,2022-04-29
7,1,6,0,Cleveland,2022-04-30
6,0,6,0,Cleveland,2022-05-01
7,4,3,0,Cleveland,2022-05-02
13,4,9,0,Cleveland,2022-05-03
10,1,9,0,Cleveland,2022-05-04
17,2,15,0,Cleveland,2022-05-05
10,1,9,0,Cleveland,2022-05-06
10,2,8,0,Cleveland,2022-05-07
15,2,13,0,Cleveland,2022-05-08
16,3,13,0,Cleveland,2022-05-09
24,3,21,0,Cleveland,2022-05-10
15,2,13,0,Cleveland,2022-05-11
26,2,24,0,Cleveland,2022-05-12
15,2,13,0,Cleveland,2022-05-13
11,0,11,0,Cleveland,2022-05-14
18,1,17,0,Cleveland,2022-05-15
28,5,23,0,Cleveland,2022-05-16
29,5,24,0,Cleveland,2022-05-17
19,2,17,0,Cleveland,2022-05-18
20,1,19,0,Cleveland,2022-05-19
26,10,16,0,Cleveland,2022-05-20
9,3,6,0,Cleveland,2022-05-21
12,2,10,0,Cleveland,2022-05-22
30,8,22,0,Cleveland,2022-05-23
23,3,20,0,Cleveland,2022-05-25
20,6,14,0,Cleveland,2022-05-26
18,4,14,0,Cleveland,2022-05-27
10,4,6,0,Cleveland,2022-05-28
16,2,14,0,Cleveland,2022-05-29
8,3,5,0,Cleveland,2022-05-30
34,14,20,0,Cleveland,2022-05-31
27,4,23,0,Cleveland,2022-06-01
17,1,16,0,Cleveland,2022-06-02
22,8,14,0,Cleveland,2022-06-03
18,1,17,0,Cleveland,2022-06-04
20,7,13,0,Columbus,2021-12-08
10,3,7,0,Columbus,2021-12-10
5,1,4,0,Columbus,2021-12-11
5,2,3,0,Columbus,2021-12-12
14,4,10,0,Columbus,2021-12-17
4,0,4,0,Columbus,2021-12-19
25,9,16,0,Columbus,2021-12-20
20,2,18,0,Columbus,2021-12-22
26,4,22,0,Columbus,2021-12-23
13,2,11,0,Columbus,2021-12-24
7,2,5,0,Columbus,2021-12-25
9,3,6,0,Columbus,2021-12-26
96,14,82,0,Columbus,2021-12-29
85,11,74,0,Columbus,2021-12-30
50,9,41,0,Columbus,2021-12-31
15,5,10,0,Columbus,2022-01-01
29,8,21,0,Columbus,2022-01-02
120,26,94,0,Columbus,2022-01-03
156,78,78,0,Columbus,2022-01-04
113,29,84,0,Columbus,2022-01-07
40,16,24,0,Columbus,2022-01-08
40,7,33,0,Columbus,2022-01-09
259,68,191,0,Columbus,2022-01-11
273,117,156,0,Columbus,2022-01-13
54,9,45,0,Columbus,2022-01-15
39,13,26,0,Columbus,2022-01-16
189,59,130,0,Columbus,2022-01-17
288,115,173,0,Columbus,2022-01-19
25,9,16,0,Columbus,2022-01-21
15,9,6,0,Columbus,2022-01-29
21,6,15,0,Columbus,2022-01-30
68,30,38,0,Columbus,2022-02-01
16,5,11,0,Columbus,2022-02-05
56,21,35,0,Columbus,2022-02-07
43,23,20,0,Columbus,2022-02-08
25,13,12,0,Columbus,2022-02-09
7,2,5,0,Columbus,2022-02-12
11,1,10,0,Columbus,2022-02-13
23,13,10,0,Columbus,2022-02-16
11,3,8,0,Columbus,2022-02-18
3,1,2,0,Columbus,2022-02-20
18,11,7,0,Columbus,2022-02-21
7,2,5,0,Columbus,2022-02-22
11,6,5,0,Columbus,2022-02-23
7,4,3,0,Columbus,2022-02-24
5,2,3,0,Columbus,2022-02-25
4,0,4,0,Columbus,2022-02-26
2,1,1,0,Columbus,2022-02-27
12,8,4,0,Columbus,2022-02-28
6,0,6,0,Columbus,2022-03-01
4,1,3,0,Columbus,2022-03-02
2,1,1,0,Columbus,2022-03-03
1,0,1,0,Columbus,2022-03-04
0,0,0,0,Columbus,2022-03-05
1,1,0,0,Columbus,2022-03-06
1,0,1,0,Columbus,2022-03-07
6,1,5,0,Columbus,2022-03-08
2,0,2,0,Columbus,2022-03-09
2,1,1,0,Columbus,2022-03-10
2,0,2,0,Columbus,2022-03-11
1,0,1,0,Columbus,2022-03-13
2,2,0,0,Columbus,2022-03-14
0,0,0,0,Columbus,2022-03-15
1,0,1,0,Columbus,2022-03-16
3,0,3,0,Columbus,2022-03-17
2,0,2,0,Columbus,2022-03-18
0,0,0,0,Columbus,2022-03-19
0,0,0,0,Columbus,2022-03-20
0,0,0,0,Columbus,2022-03-21
0,0,0,0,Columbus,2022-03-22
1,0,1,0,Columbus,2022-03-23
0,0,0,0,Columbus,2022-03-24
0,0,0,0,Columbus,2022-03-25
1,0,1,0,Columbus,2022-03-26
1,0,1,0,Columbus,2022-03-27
3,0,3,0,Columbus,2022-03-28
0,0,0,0,Columbus,2022-03-29
0,0,0,0,Columbus,2022-03-30
0,0,0,0,Columbus,2022-04-01
1,0,1,0,Columbus,2022-04-02
0,0,0,0,Columbus,2022-04-03
2,0,2,0,Columbus,2022-04-05
0,0,0,0,Columbus,2022-04-06
1,0,1,0,Columbus,2022-04-07
1,0,1,0,Columbus,2022-04-08
0,0,0,0,Columbus,2022-04-09
0,0,0,0,Columbus,2022-04-10
3,2,1,0,Columbus,2022-04-11
1,1,0,0,Columbus,2022-04-12
0,0,0,0,Columbus,2022-04-13
1,0,1,0,Columbus,2022-04-14
0,0,0,0,Columbus,2022-04-15
0,0,0,0,Columbus,2022-04-16
0,0,0,0,Columbus,2022-04-17
4,0,4,0,Columbus,2022-04-18
1,0,1,0,Columbus,2022-04-19
1,0,1,0,Columbus,2022-04-21
2,0,2,0,Columbus,2022-04-22
2,1,1,0,Columbus,2022-04-23
3,2,1,0,Columbus,2022-04-24
6,2,4,0,Columbus,2022-04-25
9,4,5,0,Columbus,2022-04-26
4,2,2,0,Columbus,2022-04-27
7,0,7,0,Columbus,2022-04-28
2,1,1,0,Columbus,2022-04-29
2,0,2,0,Columbus,2022-04-30
2,1,1,0,Columbus,2022-05-01
10,6,4,0,Columbus,2022-05-02
5,3,2,0,Columbus,2022-05-03
4,1,3,0,Columbus,2022-05-04
0,0,0,0,Columbus,2022-05-05
6,2,4,0,Columbus,2022-05-06
2,0,2,0,Columbus,2022-05-07
2,0,2,0,Columbus,2022-05-08
6,3,3,0,Columbus,2022-05-09
9,3,6,0,Columbus,2022-05-10
7,1,6,0,Columbus,2022-05-11
8,4,4,0,Columbus,2022-05-12
11,4,7,0,Columbus,2022-05-13
2,1,1,0,Columbus,2022-05-14
3,0,3,0,Columbus,2022-05-15
23,8,15,0,Columbus,2022-05-16
22,6,16,0,Columbus,2022-05-17
19,6,13,0,Columbus,2022-05-18
12,3,9,0,Columbus,2022-05-19
7,0,7,0,Columbus,2022-05-20
4,0,4,0,Columbus,2022-05-21
4,1,3,0,Columbus,2022-05-22
19,8,11,0,Columbus,2022-05-23
6,1,5,0,Columbus,2022-05-24
12,7,5,0,Columbus,2022-05-25
7,2,5,0,Columbus,2022-05-26
7,1,6,0,Columbus,2022-05-27
3,1,2,0,Columbus,2022-05-28
6,1,5,0,Columbus,2022-05-29
4,2,2,0,Columbus,2022-05-30
17,5,12,0,Columbus,2022-05-31
14,11,3,0,Columbus,2022-06-01
7,2,5,0,Columbus,2022-06-02
4,1,3,0,Columbus,2022-06-03
1,0,1,0,Columbus,2022-06-04
20,9,11,0,Craven,2021-12-07
14,4,10,0,Craven,2021-12-12
32,11,21,0,Craven,2021-12-13
32,8,24,0,Craven,2021-12-15
34,14,20,0,Craven,2021-12-17
14,5,9,0,Craven,2021-12-18
41,16,25,0,Craven,2021-12-20
47,18,29,0,Craven,2021-12-21
58,13,45,0,Craven,2021-12-22
39,13,26,0,Craven,2021-12-23
17,7,10,0,Craven,2021-12-24
9,1,8,0,Craven,2021-12-25
37,8,29,0,Craven,2021-12-26
99,27,72,0,Craven,2021-12-27
134,33,101,0,Craven,2021-12-29
115,20,95,0,Craven,2021-12-30
74,22,52,0,Craven,2021-12-31
72,17,55,0,Craven,2022-01-02
253,55,198,0,Craven,2022-01-03
216,67,149,0,Craven,2022-01-06
266,86,180,0,Craven,2022-01-07
86,26,60,0,Craven,2022-01-09
412,130,282,0,Craven,2022-01-10
304,104,200,0,Craven,2022-01-11
282,94,188,0,Craven,2022-01-13
280,62,218,0,Craven,2022-01-14
109,32,77,0,Craven,2022-01-21
268,97,171,0,Craven,2022-01-25
213,54,159,0,Craven,2022-01-31
46,12,34,0,Craven,2022-02-05
87,29,58,0,Craven,2022-02-08
84,21,63,0,Craven,2022-02-09
80,37,43,0,Craven,2022-02-10
59,18,41,0,Craven,2022-02-11
35,12,23,0,Craven,2022-02-15
54,15,39,0,Craven,2022-02-16
9,0,9,0,Craven,2022-02-20
37,8,29,0,Craven,2022-02-21
26,9,17,0,Craven,2022-02-22
24,6,18,0,Craven,2022-02-23
18,2,16,0,Craven,2022-02-24
20,3,17,0,Craven,2022-02-25
8,2,6,0,Craven,2022-02-26
4,2,2,0,Craven,2022-02-27
20,1,19,0,Craven,2022-02-28
12,2,10,0,Craven,2022-03-01
8,2,6,0,Craven,2022-03-03
9,3,6,0,Craven,2022-03-04
4,2,2,0,Craven,2022-03-05
8,3,5,0,Craven,2022-03-06
18,10,8,0,Craven,2022-03-07
7,2,5,0,Craven,2022-03-08
6,3,3,0,Craven,2022-03-10
12,4,8,0,Craven,2022-03-11
7,1,6,0,Craven,2022-03-13
8,2,6,0,Craven,2022-03-15
6,2,4,0,Craven,2022-03-16
9,4,5,0,Craven,2022-03-17
5,3,2,0,Craven,2022-03-18
1,0,1,0,Craven,2022-03-19
6,1,5,0,Craven,2022-03-22
2,0,2,0,Craven,2022-03-23
3,1,2,0,Craven,2022-03-24
3,2,1,0,Craven,2022-03-25
3,1,2,0,Craven,2022-03-26
1,0,1,0,Craven,2022-03-27
3,2,1,0,Craven,2022-03-29
3,2,1,0,Craven,2022-03-30
6,0,6,0,Craven,2022-03-31
4,0,4,0,Craven,2022-04-01
3,0,3,0,Craven,2022-04-02
1,1,0,0,Craven,2022-04-03
8,5,3,0,Craven,2022-04-04
5,4,1,0,Craven,2022-04-05
10,2,8,0,Craven,2022-04-06
6,2,4,0,Craven,2022-04-07
6,5,1,0,Craven,2022-04-08
2,0,2,0,Craven,2022-04-09
2,0,2,0,Craven,2022-04-10
7,2,5,0,Craven,2022-04-11
8,2,6,0,Craven,2022-04-12
25,20,5,0,Craven,2022-04-13
10,4,6,0,Craven,2022-04-14
6,3,3,0,Craven,2022-04-15
5,0,5,0,Craven,2022-04-16
7,1,6,0,Craven,2022-04-17
19,14,5,0,Craven,2022-04-18
18,5,13,0,Craven,2022-04-19
11,3,8,0,Craven,2022-04-20
10,6,4,0,Craven,2022-04-21
9,5,4,0,Craven,2022-04-22
3,2,1,0,Craven,2022-04-24
18,4,14,0,Craven,2022-04-25
19,5,14,0,Craven,2022-04-26
10,3,7,0,Craven,2022-04-27
21,5,16,0,Craven,2022-04-28
19,9,10,0,Craven,2022-04-29
8,6,2,0,Craven,2022-04-30
14,6,8,0,Craven,2022-05-01
41,20,21,0,Craven,2022-05-02
41,17,24,0,Craven,2022-05-03
25,9,16,0,Craven,2022-05-04
34,19,15,0,Craven,2022-05-05
31,18,13,0,Craven,2022-05-06
20,12,8,0,Craven,2022-05-07
21,8,13,0,Craven,2022-05-08
59,33,26,0,Craven,2022-05-09
52,27,25,0,Craven,2022-05-10
50,22,28,0,Craven,2022-05-11
40,15,25,0,Craven,2022-05-12
42,27,15,0,Craven,2022-05-13
17,10,7,0,Craven,2022-05-14
18,7,11,0,Craven,2022-05-15
62,24,38,0,Craven,2022-05-16
43,14,29,0,Craven,2022-05-18
44,20,24,0,Craven,2022-05-19
45,18,27,0,Craven,2022-05-20
31,13,18,0,Craven,2022-05-21
38,13,25,0,Craven,2022-05-22
82,39,43,0,Craven,2022-05-23
57,34,23,0,Craven,2022-05-24
54,28,26,0,Craven,2022-05-25
67,37,30,0,Craven,2022-05-26
43,19,24,0,Craven,2022-05-27
30,15,15,0,Craven,2022-05-28
20,9,11,0,Craven,2022-05-29
24,11,13,0,Craven,2022-05-30
67,28,39,0,Craven,2022-05-31
62,27,35,0,Craven,2022-06-01
66,23,43,0,Craven,2022-06-02
29,13,16,0,Craven,2022-06-03
12,6,6,0,Craven,2022-06-04
161,41,120,0,Cumberland,2021-12-10
58,9,49,0,Cumberland,2021-12-11
41,8,33,0,Cumberland,2021-12-12
136,21,115,0,Cumberland,2021-12-14
133,21,112,0,Cumberland,2021-12-17
79,13,66,0,Cumberland,2021-12-18
70,7,63,0,Cumberland,2021-12-19
194,21,173,0,Cumberland,2021-12-20
238,36,202,0,Cumberland,2021-12-21
235,36,199,0,Cumberland,2021-12-22
285,41,244,0,Cumberland,2021-12-23
66,1,65,0,Cumberland,2021-12-25
194,32,162,0,Cumberland,2021-12-26
524,86,438,0,Cumberland,2021-12-27
1011,108,903,0,Cumberland,2021-12-29
609,61,548,0,Cumberland,2021-12-31
1408,122,1286,0,Cumberland,2022-01-04
488,72,416,0,Cumberland,2022-02-01
117,17,100,0,Cumberland,2022-02-05
116,16,100,0,Cumberland,2022-02-15
106,22,84,0,Cumberland,2022-02-21
45,7,38,0,Cumberland,2022-03-01
7,1,6,0,Cumberland,2022-03-06
30,4,26,0,Cumberland,2022-03-07
23,9,14,0,Cumberland,2022-03-08
22,3,19,0,Cumberland,2022-03-09
41,1,40,0,Cumberland,2022-03-11
11,2,9,0,Cumberland,2022-03-12
7,2,5,0,Cumberland,2022-03-13
14,2,12,0,Cumberland,2022-03-17
11,5,6,0,Cumberland,2022-03-18
4,1,3,0,Cumberland,2022-03-20
14,2,12,0,Cumberland,2022-03-23
12,1,11,0,Cumberland,2022-03-24
17,2,15,0,Cumberland,2022-03-25
7,2,5,0,Cumberland,2022-03-26
9,6,3,0,Cumberland,2022-03-27
15,6,9,0,Cumberland,2022-03-29
10,2,8,0,Cumberland,2022-03-30
14,3,11,0,Cumberland,2022-03-31
10,3,7,0,Cumberland,2022-04-01
5,1,4,0,Cumberland,2022-04-02
3,0,3,0,Cumberland,2022-04-03
19,5,14,0,Cumberland,2022-04-04
25,4,21,0,Cumberland,2022-04-05
22,1,21,0,Cumberland,2022-04-06
23,5,18,0,Cumberland,2022-04-07
9,4,5,0,Cumberland,2022-04-09
11,3,8,0,Cumberland,2022-04-10
38,13,25,0,Cumberland,2022-04-13
42,5,37,0,Cumberland,2022-04-14
27,0,27,0,Cumberland,2022-04-15
22,6,16,0,Cumberland,2022-04-16
8,4,4,0,Cumberland,2022-04-17
46,2,44,0,Cumberland,2022-04-18
35,8,27,0,Cumberland,2022-04-19
44,6,38,0,Cumberland,2022-04-20
41,3,38,0,Cumberland,2022-04-21
43,6,37,0,Cumberland,2022-04-22
20,7,13,0,Cumberland,2022-04-23
35,10,25,0,Cumberland,2022-04-24
112,18,94,0,Cumberland,2022-04-25
74,11,63,0,Cumberland,2022-04-27
67,10,57,0,Cumberland,2022-04-29
37,11,26,0,Cumberland,2022-04-30
38,7,31,0,Cumberland,2022-05-01
83,21,62,0,Cumberland,2022-05-02
96,19,77,0,Cumberland,2022-05-03
89,23,66,0,Cumberland,2022-05-04
62,15,47,0,Cumberland,2022-05-05
60,15,45,0,Cumberland,2022-05-06
26,10,16,0,Cumberland,2022-05-07
39,8,31,0,Cumberland,2022-05-08
129,26,103,0,Cumberland,2022-05-10
123,19,104,0,Cumberland,2022-05-11
122,22,100,0,Cumberland,2022-05-12
103,15,88,0,Cumberland,2022-05-13
49,20,29,0,Cumberland,2022-05-14
75,19,56,0,Cumberland,2022-05-15
160,45,115,0,Cumberland,2022-05-17
140,25,115,0,Cumberland,2022-05-18
174,30,144,0,Cumberland,2022-05-19
117,14,103,0,Cumberland,2022-05-20
62,15,47,0,Cumberland,2022-05-21
69,7,62,0,Cumberland,2022-05-22
178,38,140,0,Cumberland,2022-05-23
148,27,121,0,Cumberland,2022-05-24
107,23,84,0,Cumberland,2022-05-25
145,24,121,0,Cumberland,2022-05-26
132,27,105,0,Cumberland,2022-05-27
71,17,54,0,Cumberland,2022-05-28
74,21,53,0,Cumberland,2022-05-29
57,23,34,0,Cumberland,2022-05-30
216,35,181,0,Cumberland,2022-05-31
176,35,141,0,Cumberland,2022-06-01
138,20,118,0,Cumberland,2022-06-02
88,23,65,0,Cumberland,2022-06-03
53,19,34,0,Cumberland,2022-06-04
14,4,10,0,Currituck,2021-12-07
2,0,2,0,Currituck,2021-12-08
3,0,3,0,Currituck,2021-12-09
10,2,8,0,Currituck,2021-12-10
3,1,2,0,Currituck,2021-12-11
7,0,7,0,Currituck,2021-12-12
9,1,8,0,Currituck,2021-12-13
8,1,7,0,Currituck,2021-12-14
8,1,7,0,Currituck,2021-12-15
8,3,5,0,Currituck,2021-12-17
7,0,7,0,Currituck,2021-12-19
16,4,12,0,Currituck,2021-12-20
16,3,13,0,Currituck,2021-12-23
10,7,3,0,Currituck,2021-12-25
21,6,15,0,Currituck,2021-12-26
36,4,32,0,Currituck,2021-12-27
46,5,41,0,Currituck,2021-12-29
18,0,18,0,Currituck,2021-12-31
31,6,25,0,Currituck,2022-01-01
27,8,19,0,Currituck,2022-01-02
61,13,48,0,Currituck,2022-01-03
58,11,47,0,Currituck,2022-01-04
52,8,44,0,Currituck,2022-01-05
57,4,53,0,Currituck,2022-01-06
39,6,33,0,Currituck,2022-01-07
23,3,20,0,Currituck,2022-01-09
77,11,66,0,Currituck,2022-01-10
66,6,60,0,Currituck,2022-01-13
63,4,59,0,Currituck,2022-01-14
34,11,23,0,Currituck,2022-01-15
29,3,26,0,Currituck,2022-01-16
68,18,50,0,Currituck,2022-01-17
78,9,69,0,Currituck,2022-01-18
72,10,62,0,Currituck,2022-01-19
52,6,46,0,Currituck,2022-01-20
19,5,14,0,Currituck,2022-01-21
6,2,4,0,Currituck,2022-01-22
20,4,16,0,Currituck,2022-01-23
59,8,51,0,Currituck,2022-01-24
66,10,56,0,Currituck,2022-01-25
43,3,40,0,Currituck,2022-01-26
20,6,14,0,Currituck,2022-01-27
3,0,3,0,Currituck,2022-01-28
5,2,3,0,Currituck,2022-01-29
4,1,3,0,Currituck,2022-01-30
27,4,23,0,Currituck,2022-01-31
20,5,15,0,Currituck,2022-02-01
12,1,11,0,Currituck,2022-02-03
14,0,14,0,Currituck,2022-02-04
3,2,1,0,Currituck,2022-02-05
3,0,3,0,Currituck,2022-02-06
12,1,11,0,Currituck,2022-02-07
5,0,5,0,Currituck,2022-02-08
9,1,8,0,Currituck,2022-02-09
6,0,6,0,Currituck,2022-02-10
8,0,8,0,Currituck,2022-02-11
5,0,5,0,Currituck,2022-02-12
4,0,4,0,Currituck,2022-02-13
9,0,9,0,Currituck,2022-02-14
4,0,4,0,Currituck,2022-02-15
2,0,2,0,Currituck,2022-02-17
0,0,0,0,Currituck,2022-02-18
0,0,0,0,Currituck,2022-02-19
0,0,0,0,Currituck,2022-02-20
0,0,0,0,Currituck,2022-02-21
3,0,3,0,Currituck,2022-02-22
0,0,0,0,Currituck,2022-02-23
0,0,0,0,Currituck,2022-02-25
2,0,2,0,Currituck,2022-02-26
0,0,0,0,Currituck,2022-02-27
3,0,3,0,Currituck,2022-02-28
0,0,0,0,Currituck,2022-03-01
0,0,0,0,Currituck,2022-03-02
3,3,0,0,Currituck,2022-03-03
3,2,1,0,Currituck,2022-03-05
3,0,3,0,Currituck,2022-03-06
0,0,0,0,Currituck,2022-03-07
2,0,2,0,Currituck,2022-03-08
0,0,0,0,Currituck,2022-03-09
2,1,1,0,Currituck,2022-03-10
0,0,0,0,Currituck,2022-03-11
3,1,2,0,Currituck,2022-03-12
2,1,1,0,Currituck,2022-03-13
0,0,0,0,Currituck,2022-03-14
0,0,0,0,Currituck,2022-03-15
0,0,0,0,Currituck,2022-03-16
0,0,0,0,Currituck,2022-03-17
0,0,0,0,Currituck,2022-03-18
0,0,0,0,Currituck,2022-03-19
0,0,0,0,Currituck,2022-03-20
0,0,0,0,Currituck,2022-03-21
0,0,0,0,Currituck,2022-03-23
0,0,0,0,Currituck,2022-03-24
2,0,2,0,Currituck,2022-03-25
0,0,0,0,Currituck,2022-03-26
0,0,0,0,Currituck,2022-03-27
0,0,0,0,Currituck,2022-03-28
0,0,0,0,Currituck,2022-03-29
2,0,2,0,Currituck,2022-03-30
0,0,0,0,Currituck,2022-03-31
1,0,1,0,Currituck,2022-04-01
0,0,0,0,Currituck,2022-04-02
2,0,2,0,Currituck,2022-04-03
0,0,0,0,Currituck,2022-04-04
0,0,0,0,Currituck,2022-04-05
0,0,0,0,Currituck,2022-04-06
3,0,3,0,Currituck,2022-04-07
0,0,0,0,Currituck,2022-04-08
0,0,0,0,Currituck,2022-04-09
0,0,0,0,Currituck,2022-04-10
1,0,1,0,Currituck,2022-04-11
1,0,1,0,Currituck,2022-04-12
1,0,1,0,Currituck,2022-04-13
2,0,2,0,Currituck,2022-04-14
0,0,0,0,Currituck,2022-04-15
0,0,0,0,Currituck,2022-04-16
0,0,0,0,Currituck,2022-04-17
0,0,0,0,Currituck,2022-04-18
0,0,0,0,Currituck,2022-04-19
2,0,2,0,Currituck,2022-04-20
2,0,2,0,Currituck,2022-04-21
1,0,1,0,Currituck,2022-04-22
3,2,1,0,Currituck,2022-04-23
2,0,2,0,Currituck,2022-04-24
3,0,3,0,Currituck,2022-04-25
6,2,4,0,Currituck,2022-04-26
6,2,4,0,Currituck,2022-04-27
2,0,2,0,Currituck,2022-04-28
3,1,2,0,Currituck,2022-04-29
2,0,2,0,Currituck,2022-04-30
1,0,1,0,Currituck,2022-05-01
1,1,0,0,Currituck,2022-05-02
2,0,2,0,Currituck,2022-05-03
6,3,3,0,Currituck,2022-05-04
3,0,3,0,Currituck,2022-05-05
1,1,0,0,Currituck,2022-05-06
1,0,1,0,Currituck,2022-05-07
5,3,2,0,Currituck,2022-05-08
7,2,5,0,Currituck,2022-05-09
9,0,9,0,Currituck,2022-05-10
1,0,1,0,Currituck,2022-05-11
5,0,5,0,Currituck,2022-05-12
7,0,7,0,Currituck,2022-05-13
11,4,7,0,Currituck,2022-05-14
4,1,3,0,Currituck,2022-05-15
11,3,8,0,Currituck,2022-05-16
9,0,9,0,Currituck,2022-05-17
7,2,5,0,Currituck,2022-05-18
1,1,0,0,Currituck,2022-05-19
3,1,2,0,Currituck,2022-05-20
10,3,7,0,Currituck,2022-05-21
6,0,6,0,Currituck,2022-05-22
11,0,11,0,Currituck,2022-05-23
7,3,4,0,Currituck,2022-05-24
15,4,11,0,Currituck,2022-05-25
6,1,5,0,Currituck,2022-05-26
9,1,8,0,Currituck,2022-05-27
14,3,11,0,Currituck,2022-05-28
5,1,4,0,Currituck,2022-05-29
2,0,2,0,Currituck,2022-05-30
8,0,8,0,Currituck,2022-05-31
3,1,2,0,Currituck,2022-06-01
4,0,4,0,Currituck,2022-06-02
3,0,3,0,Currituck,2022-06-03
3,0,3,0,Currituck,2022-06-04
20,0,20,0,Dare,2021-12-07
19,0,19,0,Dare,2021-12-09
15,0,15,0,Dare,2021-12-10
19,0,19,0,Dare,2021-12-12
24,0,24,0,Dare,2021-12-16
19,0,19,0,Dare,2021-12-17
7,0,7,0,Dare,2021-12-18
24,2,22,0,Dare,2021-12-20
25,0,25,0,Dare,2021-12-22
31,0,31,0,Dare,2021-12-23
23,0,23,0,Dare,2021-12-24
0,0,0,0,Dare,2021-12-25
29,0,29,0,Dare,2021-12-26
49,0,49,0,Dare,2021-12-27
58,1,57,0,Dare,2021-12-29
64,0,64,0,Dare,2021-12-30
52,0,52,0,Dare,2021-12-31
18,0,18,0,Dare,2022-01-01
44,1,43,0,Dare,2022-01-02
91,0,91,0,Dare,2022-01-03
98,0,98,0,Dare,2022-01-04
102,0,102,0,Dare,2022-01-05
103,0,103,0,Dare,2022-01-06
78,0,78,0,Dare,2022-01-07
50,0,50,0,Dare,2022-01-08
128,0,128,0,Dare,2022-01-10
109,0,109,0,Dare,2022-01-11
102,1,101,0,Dare,2022-01-12
109,1,108,0,Dare,2022-01-13
110,1,109,0,Dare,2022-01-14
51,0,51,0,Dare,2022-01-15
41,1,40,0,Dare,2022-01-16
77,0,77,0,Dare,2022-01-17
96,0,96,0,Dare,2022-01-18
108,2,106,0,Dare,2022-01-19
84,1,83,0,Dare,2022-01-20
30,0,30,0,Dare,2022-01-21
23,0,23,0,Dare,2022-01-22
14,0,14,0,Dare,2022-01-23
64,2,62,0,Dare,2022-01-25
57,2,55,0,Dare,2022-01-26
48,0,48,0,Dare,2022-01-27
32,1,31,0,Dare,2022-01-28
9,0,9,0,Dare,2022-01-29
20,0,20,0,Dare,2022-01-30
53,2,51,0,Dare,2022-01-31
38,0,38,0,Dare,2022-02-01
21,1,20,0,Dare,2022-02-02
32,0,32,0,Dare,2022-02-04
9,0,9,0,Dare,2022-02-05
13,0,13,0,Dare,2022-02-06
21,2,19,0,Dare,2022-02-07
17,1,16,0,Dare,2022-02-08
11,0,11,0,Dare,2022-02-09
14,0,14,0,Dare,2022-02-10
15,0,15,0,Dare,2022-02-11
4,0,4,0,Dare,2022-02-12
7,0,7,0,Dare,2022-02-13
9,0,9,0,Dare,2022-02-14
16,0,16,0,Dare,2022-02-15
12,0,12,0,Dare,2022-02-16
13,0,13,0,Dare,2022-02-17
9,0,9,0,Dare,2022-02-18
3,0,3,0,Dare,2022-02-19
11,0,11,0,Dare,2022-02-21
6,0,6,0,Dare,2022-02-22
4,0,4,0,Dare,2022-02-23
5,0,5,0,Dare,2022-02-24
4,0,4,0,Dare,2022-02-25
1,0,1,0,Dare,2022-02-26
1,0,1,0,Dare,2022-02-27
3,0,3,0,Dare,2022-02-28
2,0,2,0,Dare,2022-03-01
3,0,3,0,Dare,2022-03-02
10,0,10,0,Dare,2022-03-03
3,0,3,0,Dare,2022-03-04
2,0,2,0,Dare,2022-03-05
2,0,2,0,Dare,2022-03-06
6,0,6,0,Dare,2022-03-07
4,0,4,0,Dare,2022-03-08
8,0,8,0,Dare,2022-03-09
0,0,0,0,Dare,2022-03-10
0,0,0,0,Dare,2022-03-11
0,0,0,0,Dare,2022-03-12
3,0,3,0,Dare,2022-03-13
1,0,1,0,Dare,2022-03-14
3,0,3,0,Dare,2022-03-15
2,0,2,0,Dare,2022-03-16
1,0,1,0,Dare,2022-03-17
3,0,3,0,Dare,2022-03-18
1,0,1,0,Dare,2022-03-19
2,0,2,0,Dare,2022-03-20
2,0,2,0,Dare,2022-03-21
1,0,1,0,Dare,2022-03-22
2,0,2,0,Dare,2022-03-23
0,0,0,0,Dare,2022-03-24
1,0,1,0,Dare,2022-03-25
1,0,1,0,Dare,2022-03-26
1,0,1,0,Dare,2022-03-27
0,0,0,0,Dare,2022-03-28
0,0,0,0,Dare,2022-03-29
2,1,1,0,Dare,2022-03-30
1,0,1,0,Dare,2022-03-31
1,0,1,0,Dare,2022-04-01
1,0,1,0,Dare,2022-04-02
1,0,1,0,Dare,2022-04-03
0,0,0,0,Dare,2022-04-04
1,0,1,0,Dare,2022-04-05
3,0,3,0,Dare,2022-04-06
2,0,2,0,Dare,2022-04-07
1,0,1,0,Dare,2022-04-08
2,0,2,0,Dare,2022-04-09
1,0,1,0,Dare,2022-04-10
3,0,3,0,Dare,2022-04-11
1,0,1,0,Dare,2022-04-12
4,0,4,0,Dare,2022-04-13
6,0,6,0,Dare,2022-04-14
6,0,6,0,Dare,2022-04-15
2,0,2,0,Dare,2022-04-16
3,0,3,0,Dare,2022-04-17
6,0,6,0,Dare,2022-04-18
7,0,7,0,Dare,2022-04-19
2,0,2,0,Dare,2022-04-20
9,0,9,0,Dare,2022-04-21
7,0,7,0,Dare,2022-04-22
5,0,5,0,Dare,2022-04-23
3,0,3,0,Dare,2022-04-24
10,0,10,0,Dare,2022-04-25
8,0,8,0,Dare,2022-04-26
11,0,11,0,Dare,2022-04-27
13,0,13,0,Dare,2022-04-28
7,0,7,0,Dare,2022-04-29
7,0,7,0,Dare,2022-04-30
1,0,1,0,Dare,2022-05-01
12,1,11,0,Dare,2022-05-02
12,0,12,0,Dare,2022-05-03
11,0,11,0,Dare,2022-05-04
8,0,8,0,Dare,2022-05-05
12,1,11,0,Dare,2022-05-06
5,0,5,0,Dare,2022-05-07
10,0,10,0,Dare,2022-05-08
13,0,13,0,Dare,2022-05-09
17,0,17,0,Dare,2022-05-10
19,0,19,0,Dare,2022-05-11
16,0,16,0,Dare,2022-05-12
19,1,18,0,Dare,2022-05-13
10,0,10,0,Dare,2022-05-14
8,0,8,0,Dare,2022-05-15
13,0,13,0,Dare,2022-05-16
23,0,23,0,Dare,2022-05-17
19,0,19,0,Dare,2022-05-18
27,0,27,0,Dare,2022-05-19
26,1,25,0,Dare,2022-05-20
9,0,9,0,Dare,2022-05-21
10,0,10,0,Dare,2022-05-22
29,0,29,0,Dare,2022-05-23
24,2,22,0,Dare,2022-05-24
18,0,18,0,Dare,2022-05-25
12,1,11,0,Dare,2022-05-26
20,0,20,0,Dare,2022-05-27
12,0,12,0,Dare,2022-05-28
15,0,15,0,Dare,2022-05-29
11,1,10,0,Dare,2022-05-30
28,0,28,0,Dare,2022-05-31
21,0,21,0,Dare,2022-06-01
25,0,25,0,Dare,2022-06-02
16,0,16,0,Dare,2022-06-03
8,0,8,0,Dare,2022-06-04
48,1,47,0,Davidson,2021-12-12
40,2,38,0,Davidson,2021-12-18
110,15,95,0,Davidson,2021-12-20
96,15,81,0,Davidson,2021-12-23
270,36,234,0,Davidson,2021-12-27
355,41,314,0,Davidson,2021-12-29
413,63,350,0,Davidson,2022-01-03
220,17,203,0,Davidson,2022-01-08
186,18,168,0,Davidson,2022-01-09
556,44,512,0,Davidson,2022-01-18
253,40,213,0,Davidson,2022-01-28
161,19,142,0,Davidson,2022-02-03
64,6,58,0,Davidson,2022-02-06
71,19,52,0,Davidson,2022-02-14
40,3,37,0,Davidson,2022-02-17
48,7,41,0,Davidson,2022-02-18
13,2,11,0,Davidson,2022-02-20
34,5,29,0,Davidson,2022-02-23
11,3,8,0,Davidson,2022-02-25
26,6,20,0,Davidson,2022-02-28
13,5,8,0,Davidson,2022-03-01
15,6,9,0,Davidson,2022-03-03
8,0,8,0,Davidson,2022-03-05
11,1,10,0,Davidson,2022-03-06
16,4,12,0,Davidson,2022-03-07
5,1,4,0,Davidson,2022-03-09
6,4,2,0,Davidson,2022-03-10
8,3,5,0,Davidson,2022-03-11
3,0,3,0,Davidson,2022-03-12
2,0,2,0,Davidson,2022-03-13
4,1,3,0,Davidson,2022-03-14
4,0,4,0,Davidson,2022-03-15
5,1,4,0,Davidson,2022-03-17
5,2,3,0,Davidson,2022-03-18
2,0,2,0,Davidson,2022-03-19
1,0,1,0,Davidson,2022-03-20
8,3,5,0,Davidson,2022-03-21
5,2,3,0,Davidson,2022-03-22
5,3,2,0,Davidson,2022-03-23
1,0,1,0,Davidson,2022-03-24
2,0,2,0,Davidson,2022-03-25
1,0,1,0,Davidson,2022-03-26
5,2,3,0,Davidson,2022-03-27
2,0,2,0,Davidson,2022-03-28
6,1,5,0,Davidson,2022-03-29
7,3,4,0,Davidson,2022-03-30
5,1,4,0,Davidson,2022-03-31
5,1,4,0,Davidson,2022-04-01
4,2,2,0,Davidson,2022-04-02
5,0,5,0,Davidson,2022-04-03
8,2,6,0,Davidson,2022-04-04
15,6,9,0,Davidson,2022-04-05
10,8,2,0,Davidson,2022-04-06
11,3,8,0,Davidson,2022-04-07
8,3,5,0,Davidson,2022-04-08
6,2,4,0,Davidson,2022-04-09
9,4,5,0,Davidson,2022-04-10
19,6,13,0,Davidson,2022-04-11
12,4,8,0,Davidson,2022-04-12
17,7,10,0,Davidson,2022-04-13
7,1,6,0,Davidson,2022-04-14
6,2,4,0,Davidson,2022-04-15
12,3,9,0,Davidson,2022-04-16
3,0,3,0,Davidson,2022-04-17
9,1,8,0,Davidson,2022-04-18
17,2,15,0,Davidson,2022-04-19
14,1,13,0,Davidson,2022-04-20
14,1,13,0,Davidson,2022-04-21
13,2,11,0,Davidson,2022-04-22
6,2,4,0,Davidson,2022-04-23
19,1,18,0,Davidson,2022-04-24
21,6,15,0,Davidson,2022-04-25
31,7,24,0,Davidson,2022-04-26
19,4,15,0,Davidson,2022-04-27
20,1,19,0,Davidson,2022-04-28
20,3,17,0,Davidson,2022-04-29
10,0,10,0,Davidson,2022-04-30
15,1,14,0,Davidson,2022-05-01
38,11,27,0,Davidson,2022-05-02
29,1,28,0,Davidson,2022-05-03
28,9,19,0,Davidson,2022-05-05
23,3,20,0,Davidson,2022-05-06
18,3,15,0,Davidson,2022-05-07
24,1,23,0,Davidson,2022-05-08
39,10,29,0,Davidson,2022-05-09
47,23,24,0,Davidson,2022-05-10
31,7,24,0,Davidson,2022-05-11
55,10,45,0,Davidson,2022-05-12
35,9,26,0,Davidson,2022-05-13
16,1,15,0,Davidson,2022-05-14
27,5,22,0,Davidson,2022-05-15
74,26,48,0,Davidson,2022-05-16
72,16,56,0,Davidson,2022-05-17
46,9,37,0,Davidson,2022-05-18
46,17,29,0,Davidson,2022-05-19
54,18,36,0,Davidson,2022-05-20
22,2,20,0,Davidson,2022-05-21
30,7,23,0,Davidson,2022-05-22
67,18,49,0,Davidson,2022-05-23
68,15,53,0,Davidson,2022-05-24
70,26,44,0,Davidson,2022-05-26
47,12,35,0,Davidson,2022-05-27
34,1,33,0,Davidson,2022-05-28
21,3,18,0,Davidson,2022-05-29
36,6,30,0,Davidson,2022-05-30
88,18,70,0,Davidson,2022-05-31
66,14,52,0,Davidson,2022-06-01
57,15,42,0,Davidson,2022-06-02
44,9,35,0,Davidson,2022-06-03
22,4,18,0,Davidson,2022-06-04
31,4,27,0,Davie,2021-12-07
29,4,25,0,Davie,2021-12-09
4,1,3,0,Davie,2021-12-12
41,8,33,0,Davie,2021-12-13
42,10,32,0,Davie,2021-12-15
30,7,23,0,Davie,2021-12-16
37,8,29,0,Davie,2021-12-20
47,7,40,0,Davie,2021-12-21
27,1,26,0,Davie,2021-12-22
32,6,26,0,Davie,2021-12-23
12,1,11,0,Davie,2021-12-24
2,0,2,0,Davie,2021-12-25
21,4,17,0,Davie,2021-12-26
88,10,78,0,Davie,2021-12-27
75,9,66,0,Davie,2021-12-28
76,10,66,0,Davie,2021-12-29
79,8,71,0,Davie,2021-12-30
34,5,29,0,Davie,2021-12-31
24,4,20,0,Davie,2022-01-01
76,13,63,0,Davie,2022-01-03
110,23,87,0,Davie,2022-01-04
109,17,92,0,Davie,2022-01-05
75,6,69,0,Davie,2022-01-07
27,2,25,0,Davie,2022-01-09
136,20,116,0,Davie,2022-01-10
166,16,150,0,Davie,2022-01-11
153,23,130,0,Davie,2022-01-12
129,28,101,0,Davie,2022-01-13
157,29,128,0,Davie,2022-01-14
127,30,97,0,Davie,2022-01-18
105,19,86,0,Davie,2022-01-21
35,7,28,0,Davie,2022-01-22
27,9,18,0,Davie,2022-01-23
133,26,107,0,Davie,2022-01-24
94,17,77,0,Davie,2022-01-25
69,14,55,0,Davie,2022-01-26
30,4,26,0,Davie,2022-01-29
26,7,19,0,Davie,2022-01-30
69,15,54,0,Davie,2022-02-01
51,14,37,0,Davie,2022-02-03
24,3,21,0,Davie,2022-02-06
56,15,41,0,Davie,2022-02-07
34,8,26,0,Davie,2022-02-09
20,3,17,0,Davie,2022-02-10
28,5,23,0,Davie,2022-02-11
6,0,6,0,Davie,2022-02-12
21,4,17,0,Davie,2022-02-14
18,4,14,0,Davie,2022-02-17
13,1,12,0,Davie,2022-02-18
7,2,5,0,Davie,2022-02-19
9,3,6,0,Davie,2022-02-20
13,2,11,0,Davie,2022-02-22
9,1,8,0,Davie,2022-02-23
7,1,6,0,Davie,2022-02-24
6,0,6,0,Davie,2022-02-26
4,1,3,0,Davie,2022-02-27
12,8,4,0,Davie,2022-02-28
5,1,4,0,Davie,2022-03-01
3,0,3,0,Davie,2022-03-02
4,2,2,0,Davie,2022-03-03
6,0,6,0,Davie,2022-03-04
0,0,0,0,Davie,2022-03-05
0,0,0,0,Davie,2022-03-06
2,0,2,0,Davie,2022-03-09
0,0,0,0,Davie,2022-03-10
1,0,1,0,Davie,2022-03-11
1,0,1,0,Davie,2022-03-12
2,1,1,0,Davie,2022-03-13
6,4,2,0,Davie,2022-03-14
3,1,2,0,Davie,2022-03-15
6,1,5,0,Davie,2022-03-16
1,0,1,0,Davie,2022-03-18
0,0,0,0,Davie,2022-03-20
4,2,2,0,Davie,2022-03-21
3,1,2,0,Davie,2022-03-22
1,1,0,0,Davie,2022-03-23
4,2,2,0,Davie,2022-03-24
2,1,1,0,Davie,2022-03-25
1,0,1,0,Davie,2022-03-26
1,0,1,0,Davie,2022-03-27
3,0,3,0,Davie,2022-03-28
4,3,1,0,Davie,2022-03-29
2,1,1,0,Davie,2022-03-30
5,2,3,0,Davie,2022-03-31
1,1,0,0,Davie,2022-04-01
4,3,1,0,Davie,2022-04-02
2,1,1,0,Davie,2022-04-03
0,0,0,0,Davie,2022-04-04
0,0,0,0,Davie,2022-04-05
1,0,1,0,Davie,2022-04-06
3,1,2,0,Davie,2022-04-07
3,0,3,0,Davie,2022-04-08
2,0,2,0,Davie,2022-04-09
2,0,2,0,Davie,2022-04-10
4,2,2,0,Davie,2022-04-11
1,0,1,0,Davie,2022-04-12
3,0,3,0,Davie,2022-04-13
3,2,1,0,Davie,2022-04-14
6,2,4,0,Davie,2022-04-15
2,1,1,0,Davie,2022-04-16
2,1,1,0,Davie,2022-04-17
6,3,3,0,Davie,2022-04-18
8,4,4,0,Davie,2022-04-19
6,3,3,0,Davie,2022-04-20
9,2,7,0,Davie,2022-04-22
13,4,9,0,Davie,2022-04-25
5,3,2,0,Davie,2022-04-26
7,3,4,0,Davie,2022-04-27
7,5,2,0,Davie,2022-04-29
4,0,4,0,Davie,2022-04-30
4,1,3,0,Davie,2022-05-01
11,5,6,0,Davie,2022-05-02
11,6,5,0,Davie,2022-05-03
7,2,5,0,Davie,2022-05-04
11,3,8,0,Davie,2022-05-05
17,6,11,0,Davie,2022-05-06
5,1,4,0,Davie,2022-05-07
4,0,4,0,Davie,2022-05-08
25,10,15,0,Davie,2022-05-09
26,11,15,0,Davie,2022-05-10
19,8,11,0,Davie,2022-05-11
15,9,6,0,Davie,2022-05-12
22,6,16,0,Davie,2022-05-13
5,0,5,0,Davie,2022-05-14
11,4,7,0,Davie,2022-05-15
16,4,12,0,Davie,2022-05-16
21,6,15,0,Davie,2022-05-17
28,8,20,0,Davie,2022-05-18
20,7,13,0,Davie,2022-05-19
11,2,9,0,Davie,2022-05-20
7,2,5,0,Davie,2022-05-21
11,4,7,0,Davie,2022-05-22
23,10,13,0,Davie,2022-05-23
17,9,8,0,Davie,2022-05-24
23,7,16,0,Davie,2022-05-25
15,6,9,0,Davie,2022-05-26
16,1,15,0,Davie,2022-05-27
11,1,10,0,Davie,2022-05-28
9,0,9,0,Davie,2022-05-29
8,1,7,0,Davie,2022-05-30
36,9,27,0,Davie,2022-05-31
23,7,16,0,Davie,2022-06-01
8,2,6,0,Davie,2022-06-02
2,0,2,0,Davie,2022-06-03
2,0,2,0,Davie,2022-06-04
29,11,18,0,Duplin,2021-12-07
15,4,11,0,Duplin,2021-12-09
19,8,11,0,Duplin,2021-12-10
7,1,6,0,Duplin,2021-12-11
3,0,3,0,Duplin,2021-12-12
21,6,15,0,Duplin,2021-12-14
16,7,9,0,Duplin,2021-12-15
2,0,2,0,Duplin,2021-12-18
21,7,14,0,Duplin,2021-12-20
20,12,8,0,Duplin,2021-12-21
16,7,9,0,Duplin,2021-12-22
4,1,3,0,Duplin,2021-12-24
15,5,10,0,Duplin,2021-12-26
41,16,25,0,Duplin,2021-12-27
72,25,47,0,Duplin,2021-12-28
91,21,70,0,Duplin,2021-12-29
93,43,50,0,Duplin,2021-12-30
49,21,28,0,Duplin,2021-12-31
30,4,26,0,Duplin,2022-01-02
178,52,126,0,Duplin,2022-01-03
144,67,77,0,Duplin,2022-01-04
235,88,147,0,Duplin,2022-01-05
196,74,122,0,Duplin,2022-01-07
292,123,169,0,Duplin,2022-01-11
297,147,150,0,Duplin,2022-01-13
264,102,162,0,Duplin,2022-01-14
398,163,235,0,Duplin,2022-01-18
58,18,40,0,Duplin,2022-01-21
224,95,129,0,Duplin,2022-01-24
141,52,89,0,Duplin,2022-01-26
10,3,7,0,Duplin,2022-01-29
22,1,21,0,Duplin,2022-01-30
110,54,56,0,Duplin,2022-01-31
63,21,42,0,Duplin,2022-02-01
44,10,34,0,Duplin,2022-02-03
11,2,9,0,Duplin,2022-02-06
28,9,19,0,Duplin,2022-02-09
20,9,11,0,Duplin,2022-02-11
26,6,20,0,Duplin,2022-02-14
19,6,13,0,Duplin,2022-02-16
11,4,7,0,Duplin,2022-02-17
14,5,9,0,Duplin,2022-02-18
14,4,10,0,Duplin,2022-02-21
7,0,7,0,Duplin,2022-02-22
10,2,8,0,Duplin,2022-02-23
6,3,3,0,Duplin,2022-02-24
5,1,4,0,Duplin,2022-02-27
6,2,4,0,Duplin,2022-02-28
5,2,3,0,Duplin,2022-03-01
6,1,5,0,Duplin,2022-03-02
4,2,2,0,Duplin,2022-03-03
0,0,0,0,Duplin,2022-03-06
2,0,2,0,Duplin,2022-03-07
3,2,1,0,Duplin,2022-03-09
2,0,2,0,Duplin,2022-03-10
0,0,0,0,Duplin,2022-03-12
0,0,0,0,Duplin,2022-03-13
4,2,2,0,Duplin,2022-03-14
3,1,2,0,Duplin,2022-03-17
0,0,0,0,Duplin,2022-03-19
0,0,0,0,Duplin,2022-03-20
0,0,0,0,Duplin,2022-03-21
2,2,0,0,Duplin,2022-03-22
0,0,0,0,Duplin,2022-03-23
2,1,1,0,Duplin,2022-03-24
1,1,0,0,Duplin,2022-03-25
0,0,0,0,Duplin,2022-03-26
0,0,0,0,Duplin,2022-03-27
1,0,1,0,Duplin,2022-03-29
2,1,1,0,Duplin,2022-03-30
0,0,0,0,Duplin,2022-03-31
2,1,1,0,Duplin,2022-04-01
1,0,1,0,Duplin,2022-04-02
1,0,1,0,Duplin,2022-04-03
3,3,0,0,Duplin,2022-04-04
2,0,2,0,Duplin,2022-04-05
1,1,0,0,Duplin,2022-04-06
1,0,1,0,Duplin,2022-04-07
1,0,1,0,Duplin,2022-04-08
1,0,1,0,Duplin,2022-04-09
0,0,0,0,Duplin,2022-04-10
0,0,0,0,Duplin,2022-04-11
1,0,1,0,Duplin,2022-04-12
1,1,0,0,Duplin,2022-04-13
2,1,1,0,Duplin,2022-04-14
2,1,1,0,Duplin,2022-04-15
3,0,3,0,Duplin,2022-04-16
0,0,0,0,Duplin,2022-04-17
2,0,2,0,Duplin,2022-04-18
4,1,3,0,Duplin,2022-04-19
2,0,2,0,Duplin,2022-04-20
4,2,2,0,Duplin,2022-04-21
1,1,0,0,Duplin,2022-04-22
1,0,1,0,Duplin,2022-04-23
3,0,3,0,Duplin,2022-04-24
3,1,2,0,Duplin,2022-04-25
3,1,2,0,Duplin,2022-04-26
8,3,5,0,Duplin,2022-04-27
1,1,0,0,Duplin,2022-04-28
5,2,3,0,Duplin,2022-04-29
2,1,1,0,Duplin,2022-04-30
1,0,1,0,Duplin,2022-05-01
2,1,1,0,Duplin,2022-05-02
9,3,6,0,Duplin,2022-05-03
3,1,2,0,Duplin,2022-05-04
9,5,4,0,Duplin,2022-05-05
2,0,2,0,Duplin,2022-05-06
3,1,2,0,Duplin,2022-05-07
2,1,1,0,Duplin,2022-05-08
6,1,5,0,Duplin,2022-05-10
8,4,4,0,Duplin,2022-05-11
8,4,4,0,Duplin,2022-05-12
10,1,9,0,Duplin,2022-05-13
2,0,2,0,Duplin,2022-05-14
2,1,1,0,Duplin,2022-05-15
15,6,9,0,Duplin,2022-05-16
9,3,6,0,Duplin,2022-05-17
2,1,1,0,Duplin,2022-05-18
9,5,4,0,Duplin,2022-05-19
4,2,2,0,Duplin,2022-05-20
2,1,1,0,Duplin,2022-05-21
7,1,6,0,Duplin,2022-05-22
16,10,6,0,Duplin,2022-05-23
16,7,9,0,Duplin,2022-05-24
12,1,11,0,Duplin,2022-05-26
4,4,0,0,Duplin,2022-05-27
3,0,3,0,Duplin,2022-05-28
1,0,1,0,Duplin,2022-05-29
3,0,3,0,Duplin,2022-05-30
19,9,10,0,Duplin,2022-05-31
13,7,6,0,Duplin,2022-06-01
9,4,5,0,Duplin,2022-06-02
8,3,5,0,Duplin,2022-06-03
2,0,2,0,Duplin,2022-06-04
78,9,69,0,Durham,2021-12-07
71,9,62,0,Durham,2021-12-09
64,2,62,0,Durham,2021-12-10
42,5,37,0,Durham,2021-12-11
30,1,29,0,Durham,2021-12-12
88,8,80,0,Durham,2021-12-16
66,4,62,0,Durham,2021-12-19
158,8,150,0,Durham,2021-12-20
255,13,242,0,Durham,2021-12-22
270,12,258,0,Durham,2021-12-23
172,6,166,0,Durham,2021-12-24
85,3,82,0,Durham,2021-12-25
271,11,260,0,Durham,2021-12-26
617,43,574,0,Durham,2021-12-27
973,37,936,0,Durham,2021-12-29
1066,71,995,0,Durham,2021-12-30
567,41,526,0,Durham,2021-12-31
327,16,311,0,Durham,2022-01-01
682,49,633,0,Durham,2022-01-02
1545,125,1420,0,Durham,2022-01-04
1282,80,1202,0,Durham,2022-01-12
1201,52,1149,0,Durham,2022-01-13
617,45,572,0,Durham,2022-01-17
178,6,172,0,Durham,2022-01-22
483,30,453,0,Durham,2022-01-27
147,10,137,0,Durham,2022-01-29
219,8,211,0,Durham,2022-02-09
137,10,127,0,Durham,2022-02-10
117,14,103,0,Durham,2022-02-14
114,10,104,0,Durham,2022-02-17
49,1,48,0,Durham,2022-02-20
74,4,70,0,Durham,2022-02-23
43,4,39,0,Durham,2022-02-24
44,7,37,0,Durham,2022-02-25
25,9,16,0,Durham,2022-02-26
43,4,39,0,Durham,2022-02-28
36,4,32,0,Durham,2022-03-01
42,2,40,0,Durham,2022-03-02
26,5,21,0,Durham,2022-03-04
10,0,10,0,Durham,2022-03-06
28,1,27,0,Durham,2022-03-07
18,0,18,0,Durham,2022-03-08
19,2,17,0,Durham,2022-03-11
17,1,16,0,Durham,2022-03-12
13,2,11,0,Durham,2022-03-13
44,7,37,0,Durham,2022-03-14
24,0,24,0,Durham,2022-03-15
41,1,40,0,Durham,2022-03-16
13,4,9,0,Durham,2022-03-20
41,4,37,0,Durham,2022-03-22
36,11,25,0,Durham,2022-03-23
25,3,22,0,Durham,2022-03-24
23,0,23,0,Durham,2022-03-25
14,2,12,0,Durham,2022-03-27
30,3,27,0,Durham,2022-03-28
31,2,29,0,Durham,2022-03-30
31,1,30,0,Durham,2022-03-31
33,3,30,0,Durham,2022-04-01
23,1,22,0,Durham,2022-04-02
55,6,49,0,Durham,2022-04-04
77,3,74,0,Durham,2022-04-08
41,3,38,0,Durham,2022-04-09
30,1,29,0,Durham,2022-04-10
115,8,107,0,Durham,2022-04-12
133,6,127,0,Durham,2022-04-13
80,20,60,0,Durham,2022-04-15
54,3,51,0,Durham,2022-04-16
37,3,34,0,Durham,2022-04-17
148,5,143,0,Durham,2022-04-19
128,14,114,0,Durham,2022-04-20
122,11,111,0,Durham,2022-04-21
122,9,113,0,Durham,2022-04-22
82,2,80,0,Durham,2022-04-23
88,8,80,0,Durham,2022-04-24
153,9,144,0,Durham,2022-04-25
151,9,142,0,Durham,2022-04-26
164,4,160,0,Durham,2022-04-27
130,7,123,0,Durham,2022-04-28
113,4,109,0,Durham,2022-04-29
82,5,77,0,Durham,2022-04-30
78,8,70,0,Durham,2022-05-01
157,12,145,0,Durham,2022-05-02
166,12,154,0,Durham,2022-05-03
186,14,172,0,Durham,2022-05-04
193,16,177,0,Durham,2022-05-05
150,12,138,0,Durham,2022-05-06
99,8,91,0,Durham,2022-05-07
101,8,93,0,Durham,2022-05-08
218,14,204,0,Durham,2022-05-09
237,14,223,0,Durham,2022-05-10
227,12,215,0,Durham,2022-05-11
208,17,191,0,Durham,2022-05-12
153,7,146,0,Durham,2022-05-13
125,7,118,0,Durham,2022-05-14
114,4,110,0,Durham,2022-05-15
236,15,221,0,Durham,2022-05-16
222,14,208,0,Durham,2022-05-17
229,12,217,0,Durham,2022-05-18
223,8,215,0,Durham,2022-05-19
169,10,159,0,Durham,2022-05-20
89,5,84,0,Durham,2022-05-21
112,10,102,0,Durham,2022-05-22
218,16,202,0,Durham,2022-05-23
216,16,200,0,Durham,2022-05-24
233,16,217,0,Durham,2022-05-25
172,8,164,0,Durham,2022-05-26
143,12,131,0,Durham,2022-05-27
145,12,133,0,Durham,2022-05-28
132,7,125,0,Durham,2022-05-29
80,10,70,0,Durham,2022-05-30
323,25,298,0,Durham,2022-05-31
272,13,259,0,Durham,2022-06-01
221,8,213,0,Durham,2022-06-02
212,16,196,0,Durham,2022-06-03
125,6,119,0,Durham,2022-06-04
16,0,16,0,Edgecombe,2021-12-07
9,0,9,0,Edgecombe,2021-12-09
9,1,8,0,Edgecombe,2021-12-10
3,1,2,0,Edgecombe,2021-12-12
8,1,7,0,Edgecombe,2021-12-15
14,1,13,0,Edgecombe,2021-12-16
9,2,7,0,Edgecombe,2021-12-19
15,0,15,0,Edgecombe,2021-12-20
36,4,32,0,Edgecombe,2021-12-22
51,3,48,0,Edgecombe,2021-12-23
14,5,9,0,Edgecombe,2021-12-24
26,6,20,0,Edgecombe,2021-12-25
35,2,33,0,Edgecombe,2021-12-26
121,5,116,0,Edgecombe,2021-12-27
170,12,158,0,Edgecombe,2021-12-28
171,8,163,0,Edgecombe,2021-12-29
143,4,139,0,Edgecombe,2021-12-31
56,1,55,0,Edgecombe,2022-01-01
60,2,58,0,Edgecombe,2022-01-02
289,13,276,0,Edgecombe,2022-01-03
286,11,275,0,Edgecombe,2022-01-04
245,4,241,0,Edgecombe,2022-01-06
166,7,159,0,Edgecombe,2022-01-07
274,10,264,0,Edgecombe,2022-01-10
79,12,67,0,Edgecombe,2022-01-17
118,3,115,0,Edgecombe,2022-01-20
17,1,16,0,Edgecombe,2022-01-21
17,1,16,0,Edgecombe,2022-01-22
27,4,23,0,Edgecombe,2022-01-23
124,7,117,0,Edgecombe,2022-01-24
63,4,59,0,Edgecombe,2022-01-26
67,0,67,0,Edgecombe,2022-01-27
11,0,11,0,Edgecombe,2022-01-29
15,1,14,0,Edgecombe,2022-01-30
57,2,55,0,Edgecombe,2022-01-31
46,2,44,0,Edgecombe,2022-02-02
29,2,27,0,Edgecombe,2022-02-04
11,0,11,0,Edgecombe,2022-02-05
25,1,24,0,Edgecombe,2022-02-09
17,1,16,0,Edgecombe,2022-02-10
13,1,12,0,Edgecombe,2022-02-11
2,0,2,0,Edgecombe,2022-02-12
7,1,6,0,Edgecombe,2022-02-13
13,0,13,0,Edgecombe,2022-02-14
14,0,14,0,Edgecombe,2022-02-15
11,0,11,0,Edgecombe,2022-02-17
9,1,8,0,Edgecombe,2022-02-18
6,2,4,0,Edgecombe,2022-02-19
3,1,2,0,Edgecombe,2022-02-20
8,0,8,0,Edgecombe,2022-02-22
4,0,4,0,Edgecombe,2022-02-23
8,5,3,0,Edgecombe,2022-02-24
4,0,4,0,Edgecombe,2022-02-26
1,0,1,0,Edgecombe,2022-02-27
9,6,3,0,Edgecombe,2022-02-28
4,0,4,0,Edgecombe,2022-03-01
9,1,8,0,Edgecombe,2022-03-02
5,0,5,0,Edgecombe,2022-03-03
5,3,2,0,Edgecombe,2022-03-04
1,0,1,0,Edgecombe,2022-03-05
0,0,0,0,Edgecombe,2022-03-06
3,1,2,0,Edgecombe,2022-03-07
2,0,2,0,Edgecombe,2022-03-08
3,1,2,0,Edgecombe,2022-03-09
1,0,1,0,Edgecombe,2022-03-11
0,0,0,0,Edgecombe,2022-03-12
1,0,1,0,Edgecombe,2022-03-13
11,8,3,0,Edgecombe,2022-03-14
5,0,5,0,Edgecombe,2022-03-15
3,1,2,0,Edgecombe,2022-03-16
3,1,2,0,Edgecombe,2022-03-17
3,1,2,0,Edgecombe,2022-03-18
1,0,1,0,Edgecombe,2022-03-19
0,0,0,0,Edgecombe,2022-03-20
6,4,2,0,Edgecombe,2022-03-21
1,0,1,0,Edgecombe,2022-03-22
0,0,0,0,Edgecombe,2022-03-23
2,1,1,0,Edgecombe,2022-03-24
1,0,1,0,Edgecombe,2022-03-25
0,0,0,0,Edgecombe,2022-03-26
1,0,1,0,Edgecombe,2022-03-27
2,2,0,0,Edgecombe,2022-03-28
1,0,1,0,Edgecombe,2022-03-29
2,0,2,0,Edgecombe,2022-03-30
2,0,2,0,Edgecombe,2022-03-31
0,0,0,0,Edgecombe,2022-04-01
0,0,0,0,Edgecombe,2022-04-02
0,0,0,0,Edgecombe,2022-04-03
0,0,0,0,Edgecombe,2022-04-04
2,0,2,0,Edgecombe,2022-04-05
1,0,1,0,Edgecombe,2022-04-06
0,0,0,0,Edgecombe,2022-04-07
1,0,1,0,Edgecombe,2022-04-08
2,0,2,0,Edgecombe,2022-04-09
0,0,0,0,Edgecombe,2022-04-10
3,3,0,0,Edgecombe,2022-04-11
3,0,3,0,Edgecombe,2022-04-12
1,0,1,0,Edgecombe,2022-04-13
6,6,0,0,Edgecombe,2022-04-14
0,0,0,0,Edgecombe,2022-04-16
1,1,0,0,Edgecombe,2022-04-17
5,2,3,0,Edgecombe,2022-04-18
4,0,4,0,Edgecombe,2022-04-19
0,0,0,0,Edgecombe,2022-04-20
2,0,2,0,Edgecombe,2022-04-21
7,1,6,0,Edgecombe,2022-04-22
2,0,2,0,Edgecombe,2022-04-23
2,0,2,0,Edgecombe,2022-04-24
5,1,4,0,Edgecombe,2022-04-25
5,1,4,0,Edgecombe,2022-04-26
5,3,2,0,Edgecombe,2022-04-28
1,1,0,0,Edgecombe,2022-04-29
3,0,3,0,Edgecombe,2022-04-30
1,1,0,0,Edgecombe,2022-05-01
9,4,5,0,Edgecombe,2022-05-02
7,3,4,0,Edgecombe,2022-05-03
7,2,5,0,Edgecombe,2022-05-04
1,0,1,0,Edgecombe,2022-05-05
4,1,3,0,Edgecombe,2022-05-06
2,0,2,0,Edgecombe,2022-05-07
2,0,2,0,Edgecombe,2022-05-08
12,1,11,0,Edgecombe,2022-05-09
8,0,8,0,Edgecombe,2022-05-10
9,2,7,0,Edgecombe,2022-05-11
15,4,11,0,Edgecombe,2022-05-12
11,0,11,0,Edgecombe,2022-05-13
5,1,4,0,Edgecombe,2022-05-14
5,3,2,0,Edgecombe,2022-05-15
16,0,16,0,Edgecombe,2022-05-16
8,0,8,0,Edgecombe,2022-05-17
9,1,8,0,Edgecombe,2022-05-18
16,3,13,0,Edgecombe,2022-05-19
10,0,10,0,Edgecombe,2022-05-20
8,2,6,0,Edgecombe,2022-05-21
11,2,9,0,Edgecombe,2022-05-22
18,0,18,0,Edgecombe,2022-05-23
14,0,14,0,Edgecombe,2022-05-24
20,3,17,0,Edgecombe,2022-05-25
12,2,10,0,Edgecombe,2022-05-26
14,3,11,0,Edgecombe,2022-05-27
7,1,6,0,Edgecombe,2022-05-28
13,1,12,0,Edgecombe,2022-05-29
12,1,11,0,Edgecombe,2022-05-30
27,5,22,0,Edgecombe,2022-05-31
27,2,25,0,Edgecombe,2022-06-01
31,5,26,0,Edgecombe,2022-06-02
10,2,8,0,Edgecombe,2022-06-03
11,1,10,0,Edgecombe,2022-06-04
131,19,112,0,Forsyth,2021-12-09
118,14,104,0,Forsyth,2021-12-10
114,9,105,0,Forsyth,2021-12-14
146,21,125,0,Forsyth,2021-12-15
218,21,197,0,Forsyth,2021-12-26
586,68,518,0,Forsyth,2021-12-31
1216,152,1064,0,Forsyth,2022-01-04
401,68,333,0,Forsyth,2022-02-01
368,48,320,0,Forsyth,2022-02-02
62,5,57,0,Forsyth,2022-02-24
19,2,17,0,Forsyth,2022-03-05
14,4,10,0,Forsyth,2022-03-06
12,3,9,0,Forsyth,2022-03-13
15,3,12,0,Forsyth,2022-03-16
15,4,11,0,Forsyth,2022-03-18
10,1,9,0,Forsyth,2022-03-19
8,0,8,0,Forsyth,2022-03-20
17,4,13,0,Forsyth,2022-03-22
22,6,16,0,Forsyth,2022-03-24
13,3,10,0,Forsyth,2022-03-25
9,2,7,0,Forsyth,2022-03-26
8,5,3,0,Forsyth,2022-03-27
20,5,15,0,Forsyth,2022-03-28
27,3,24,0,Forsyth,2022-03-29
27,5,22,0,Forsyth,2022-03-31
7,1,6,0,Forsyth,2022-04-01
9,1,8,0,Forsyth,2022-04-02
6,1,5,0,Forsyth,2022-04-03
33,7,26,0,Forsyth,2022-04-05
24,5,19,0,Forsyth,2022-04-06
38,9,29,0,Forsyth,2022-04-07
23,3,20,0,Forsyth,2022-04-08
21,5,16,0,Forsyth,2022-04-09
18,5,13,0,Forsyth,2022-04-10
33,8,25,0,Forsyth,2022-04-11
41,6,35,0,Forsyth,2022-04-12
37,2,35,0,Forsyth,2022-04-13
51,10,41,0,Forsyth,2022-04-14
36,6,30,0,Forsyth,2022-04-15
23,6,17,0,Forsyth,2022-04-16
20,5,15,0,Forsyth,2022-04-17
59,14,45,0,Forsyth,2022-04-18
78,22,56,0,Forsyth,2022-04-19
55,14,41,0,Forsyth,2022-04-20
69,20,49,0,Forsyth,2022-04-21
55,5,50,0,Forsyth,2022-04-22
41,9,32,0,Forsyth,2022-04-23
36,7,29,0,Forsyth,2022-04-24
78,25,53,0,Forsyth,2022-04-26
113,29,84,0,Forsyth,2022-04-27
84,12,72,0,Forsyth,2022-04-28
87,20,67,0,Forsyth,2022-04-29
57,12,45,0,Forsyth,2022-04-30
44,7,37,0,Forsyth,2022-05-01
138,27,111,0,Forsyth,2022-05-02
113,27,86,0,Forsyth,2022-05-03
125,28,97,0,Forsyth,2022-05-04
129,30,99,0,Forsyth,2022-05-05
131,30,101,0,Forsyth,2022-05-06
65,20,45,0,Forsyth,2022-05-07
57,9,48,0,Forsyth,2022-05-08
149,37,112,0,Forsyth,2022-05-09
151,26,125,0,Forsyth,2022-05-10
148,33,115,0,Forsyth,2022-05-11
144,31,113,0,Forsyth,2022-05-12
170,38,132,0,Forsyth,2022-05-13
91,9,82,0,Forsyth,2022-05-14
84,15,69,0,Forsyth,2022-05-15
189,27,162,0,Forsyth,2022-05-17
210,44,166,0,Forsyth,2022-05-18
152,37,115,0,Forsyth,2022-05-20
93,11,82,0,Forsyth,2022-05-21
84,13,71,0,Forsyth,2022-05-22
215,62,153,0,Forsyth,2022-05-23
193,40,153,0,Forsyth,2022-05-24
181,40,141,0,Forsyth,2022-05-25
184,48,136,0,Forsyth,2022-05-26
183,29,154,0,Forsyth,2022-05-27
99,17,82,0,Forsyth,2022-05-29
58,12,46,0,Forsyth,2022-05-30
228,37,191,0,Forsyth,2022-05-31
197,32,165,0,Forsyth,2022-06-01
166,32,134,0,Forsyth,2022-06-02
149,25,124,0,Forsyth,2022-06-03
66,11,55,0,Forsyth,2022-06-04
20,1,19,0,Franklin,2021-12-09
26,2,24,0,Franklin,2021-12-10
12,0,12,0,Franklin,2021-12-11
12,2,10,0,Franklin,2021-12-12
30,3,27,0,Franklin,2021-12-14
18,0,18,0,Franklin,2021-12-16
31,2,29,0,Franklin,2021-12-17
9,1,8,0,Franklin,2021-12-19
32,3,29,0,Franklin,2021-12-20
55,1,54,0,Franklin,2021-12-21
42,3,39,0,Franklin,2021-12-22
56,0,56,0,Franklin,2021-12-23
22,4,18,0,Franklin,2021-12-24
6,0,6,0,Franklin,2021-12-25
36,4,32,0,Franklin,2021-12-26
158,14,144,0,Franklin,2021-12-27
213,9,204,0,Franklin,2021-12-29
199,27,172,0,Franklin,2021-12-30
118,13,105,0,Franklin,2021-12-31
60,3,57,0,Franklin,2022-01-02
292,27,265,0,Franklin,2022-01-03
390,25,365,0,Franklin,2022-01-04
336,6,330,0,Franklin,2022-01-06
287,12,275,0,Franklin,2022-01-07
85,12,73,0,Franklin,2022-01-09
442,19,423,0,Franklin,2022-01-10
408,19,389,0,Franklin,2022-01-11
388,15,373,0,Franklin,2022-01-12
345,17,328,0,Franklin,2022-01-13
203,12,191,0,Franklin,2022-01-15
238,32,206,0,Franklin,2022-01-17
550,27,523,0,Franklin,2022-01-18
98,9,89,0,Franklin,2022-01-21
39,3,36,0,Franklin,2022-01-22
42,7,35,0,Franklin,2022-01-23
229,12,217,0,Franklin,2022-01-25
203,12,191,0,Franklin,2022-01-26
162,6,156,0,Franklin,2022-01-27
155,4,151,0,Franklin,2022-01-28
47,3,44,0,Franklin,2022-01-29
171,9,162,0,Franklin,2022-01-31
98,4,94,0,Franklin,2022-02-01
91,11,80,0,Franklin,2022-02-02
77,6,71,0,Franklin,2022-02-03
45,6,39,0,Franklin,2022-02-05
31,2,29,0,Franklin,2022-02-06
66,13,53,0,Franklin,2022-02-08
47,8,39,0,Franklin,2022-02-11
16,2,14,0,Franklin,2022-02-12
16,4,12,0,Franklin,2022-02-13
44,7,37,0,Franklin,2022-02-14
29,2,27,0,Franklin,2022-02-15
36,3,33,0,Franklin,2022-02-16
16,2,14,0,Franklin,2022-02-18
7,0,7,0,Franklin,2022-02-19
12,1,11,0,Franklin,2022-02-20
23,7,16,0,Franklin,2022-02-21
14,1,13,0,Franklin,2022-02-22
23,1,22,0,Franklin,2022-02-23
15,1,14,0,Franklin,2022-02-25
5,0,5,0,Franklin,2022-02-26
16,2,14,0,Franklin,2022-02-28
6,2,4,0,Franklin,2022-03-01
3,0,3,0,Franklin,2022-03-02
8,1,7,0,Franklin,2022-03-03
6,2,4,0,Franklin,2022-03-04
3,0,3,0,Franklin,2022-03-05
12,1,11,0,Franklin,2022-03-07
6,1,5,0,Franklin,2022-03-08
10,2,8,0,Franklin,2022-03-09
3,0,3,0,Franklin,2022-03-10
1,0,1,0,Franklin,2022-03-11
1,1,0,0,Franklin,2022-03-12
0,0,0,0,Franklin,2022-03-13
1,0,1,0,Franklin,2022-03-15
1,0,1,0,Franklin,2022-03-16
2,1,1,0,Franklin,2022-03-17
1,1,0,0,Franklin,2022-03-18
1,0,1,0,Franklin,2022-03-19
2,0,2,0,Franklin,2022-03-20
4,0,4,0,Franklin,2022-03-21
6,0,6,0,Franklin,2022-03-22
1,0,1,0,Franklin,2022-03-23
2,0,2,0,Franklin,2022-03-24
1,0,1,0,Franklin,2022-03-25
1,0,1,0,Franklin,2022-03-26
3,0,3,0,Franklin,2022-03-28
1,0,1,0,Franklin,2022-03-29
5,0,5,0,Franklin,2022-03-30
4,1,3,0,Franklin,2022-03-31
1,0,1,0,Franklin,2022-04-01
2,0,2,0,Franklin,2022-04-02
1,0,1,0,Franklin,2022-04-03
4,0,4,0,Franklin,2022-04-04
2,0,2,0,Franklin,2022-04-05
1,0,1,0,Franklin,2022-04-06
3,0,3,0,Franklin,2022-04-07
7,0,7,0,Franklin,2022-04-08
5,1,4,0,Franklin,2022-04-09
2,0,2,0,Franklin,2022-04-10
4,0,4,0,Franklin,2022-04-11
10,3,7,0,Franklin,2022-04-12
10,0,10,0,Franklin,2022-04-13
14,2,12,0,Franklin,2022-04-14
13,5,8,0,Franklin,2022-04-15
11,1,10,0,Franklin,2022-04-16
4,1,3,0,Franklin,2022-04-17
18,1,17,0,Franklin,2022-04-18
12,0,12,0,Franklin,2022-04-19
9,2,7,0,Franklin,2022-04-20
14,3,11,0,Franklin,2022-04-21
12,0,12,0,Franklin,2022-04-22
8,1,7,0,Franklin,2022-04-23
6,0,6,0,Franklin,2022-04-24
36,0,36,0,Franklin,2022-04-25
13,2,11,0,Franklin,2022-04-26
14,2,12,0,Franklin,2022-04-27
8,0,8,0,Franklin,2022-04-28
11,2,9,0,Franklin,2022-04-29
12,3,9,0,Franklin,2022-04-30
11,3,8,0,Franklin,2022-05-01
25,3,22,0,Franklin,2022-05-02
27,3,24,0,Franklin,2022-05-03
19,1,18,0,Franklin,2022-05-04
21,0,21,0,Franklin,2022-05-05
20,2,18,0,Franklin,2022-05-06
17,2,15,0,Franklin,2022-05-07
9,0,9,0,Franklin,2022-05-08
49,4,45,0,Franklin,2022-05-10
43,2,41,0,Franklin,2022-05-11
40,6,34,0,Franklin,2022-05-12
24,1,23,0,Franklin,2022-05-13
33,4,29,0,Franklin,2022-05-14
29,2,27,0,Franklin,2022-05-15
36,5,31,0,Franklin,2022-05-16
50,7,43,0,Franklin,2022-05-17
58,1,57,0,Franklin,2022-05-18
36,5,31,0,Franklin,2022-05-19
34,1,33,0,Franklin,2022-05-20
14,1,13,0,Franklin,2022-05-21
19,0,19,0,Franklin,2022-05-22
54,4,50,0,Franklin,2022-05-23
56,2,54,0,Franklin,2022-05-24
47,2,45,0,Franklin,2022-05-25
46,7,39,0,Franklin,2022-05-26
22,4,18,0,Franklin,2022-05-27
23,1,22,0,Franklin,2022-05-28
24,4,20,0,Franklin,2022-05-29
9,5,4,0,Franklin,2022-05-30
60,3,57,0,Franklin,2022-05-31
41,3,38,0,Franklin,2022-06-01
38,5,33,0,Franklin,2022-06-02
25,4,21,0,Franklin,2022-06-03
15,0,15,0,Franklin,2022-06-04
98,25,73,0,Gaston,2021-12-09
58,16,42,0,Gaston,2021-12-12
76,15,61,0,Gaston,2021-12-18
207,43,164,0,Gaston,2021-12-22
181,37,144,0,Gaston,2021-12-26
397,72,325,0,Gaston,2021-12-27
592,98,494,0,Gaston,2021-12-28
485,83,402,0,Gaston,2021-12-29
161,35,126,0,Gaston,2022-01-01
692,144,548,0,Gaston,2022-01-13
241,47,194,0,Gaston,2022-02-02
120,29,91,0,Gaston,2022-02-11
56,12,44,0,Gaston,2022-02-18
14,3,11,0,Gaston,2022-02-26
18,3,15,0,Gaston,2022-02-28
7,2,5,0,Gaston,2022-03-04
7,3,4,0,Gaston,2022-03-05
9,2,7,0,Gaston,2022-03-09
11,1,10,0,Gaston,2022-03-10
8,0,8,0,Gaston,2022-03-14
5,1,4,0,Gaston,2022-03-18
2,1,1,0,Gaston,2022-03-19
3,0,3,0,Gaston,2022-03-20
14,0,14,0,Gaston,2022-03-21
1,0,1,0,Gaston,2022-03-22
8,2,6,0,Gaston,2022-03-23
2,0,2,0,Gaston,2022-03-24
3,0,3,0,Gaston,2022-03-26
3,0,3,0,Gaston,2022-03-27
9,5,4,0,Gaston,2022-03-29
11,2,9,0,Gaston,2022-03-31
8,4,4,0,Gaston,2022-04-01
4,3,1,0,Gaston,2022-04-02
7,2,5,0,Gaston,2022-04-03
15,7,8,0,Gaston,2022-04-04
9,1,8,0,Gaston,2022-04-05
11,6,5,0,Gaston,2022-04-06
20,5,15,0,Gaston,2022-04-08
9,2,7,0,Gaston,2022-04-10
17,2,15,0,Gaston,2022-04-11
26,9,17,0,Gaston,2022-04-13
17,7,10,0,Gaston,2022-04-14
12,2,10,0,Gaston,2022-04-15
15,3,12,0,Gaston,2022-04-16
5,0,5,0,Gaston,2022-04-17
21,5,16,0,Gaston,2022-04-18
14,0,14,0,Gaston,2022-04-19
22,5,17,0,Gaston,2022-04-20
21,4,17,0,Gaston,2022-04-21
17,1,16,0,Gaston,2022-04-22
20,7,13,0,Gaston,2022-04-23
12,2,10,0,Gaston,2022-04-24
26,9,17,0,Gaston,2022-04-25
42,11,31,0,Gaston,2022-04-26
25,2,23,0,Gaston,2022-04-27
25,5,20,0,Gaston,2022-04-28
29,6,23,0,Gaston,2022-04-29
27,3,24,0,Gaston,2022-04-30
21,4,17,0,Gaston,2022-05-01
46,8,38,0,Gaston,2022-05-02
33,5,28,0,Gaston,2022-05-03
33,7,26,0,Gaston,2022-05-04
39,5,34,0,Gaston,2022-05-05
50,8,42,0,Gaston,2022-05-06
20,5,15,0,Gaston,2022-05-07
23,3,20,0,Gaston,2022-05-08
59,15,44,0,Gaston,2022-05-09
73,11,62,0,Gaston,2022-05-10
60,9,51,0,Gaston,2022-05-12
60,6,54,0,Gaston,2022-05-13
34,3,31,0,Gaston,2022-05-14
39,2,37,0,Gaston,2022-05-15
83,10,73,0,Gaston,2022-05-16
82,6,76,0,Gaston,2022-05-17
87,16,71,0,Gaston,2022-05-18
79,10,69,0,Gaston,2022-05-19
56,14,42,0,Gaston,2022-05-20
43,6,37,0,Gaston,2022-05-21
43,3,40,0,Gaston,2022-05-22
83,26,57,0,Gaston,2022-05-23
76,15,61,0,Gaston,2022-05-24
52,12,40,0,Gaston,2022-05-26
58,12,46,0,Gaston,2022-05-27
42,5,37,0,Gaston,2022-05-28
27,5,22,0,Gaston,2022-05-30
103,23,80,0,Gaston,2022-05-31
85,14,71,0,Gaston,2022-06-02
64,9,55,0,Gaston,2022-06-03
49,5,44,0,Gaston,2022-06-04
2,0,2,0,Gates,2021-12-07
3,0,3,0,Gates,2021-12-08
5,2,3,0,Gates,2021-12-09
3,1,2,0,Gates,2021-12-10
2,0,2,0,Gates,2021-12-11
0,0,0,0,Gates,2021-12-12
5,0,5,0,Gates,2021-12-13
3,0,3,0,Gates,2021-12-15
4,3,1,0,Gates,2021-12-16
2,0,2,0,Gates,2021-12-17
2,1,1,0,Gates,2021-12-18
4,1,3,0,Gates,2021-12-19
6,0,6,0,Gates,2021-12-20
3,0,3,0,Gates,2021-12-21
9,6,3,0,Gates,2021-12-22
8,0,8,0,Gates,2021-12-23
2,1,1,0,Gates,2021-12-24
7,2,5,0,Gates,2021-12-25
3,1,2,0,Gates,2021-12-26
14,8,6,0,Gates,2021-12-27
17,3,14,0,Gates,2021-12-29
14,3,11,0,Gates,2021-12-30
12,1,11,0,Gates,2021-12-31
8,1,7,0,Gates,2022-01-01
1,0,1,0,Gates,2022-01-02
20,4,16,0,Gates,2022-01-03
19,7,12,0,Gates,2022-01-04
23,7,16,0,Gates,2022-01-06
3,0,3,0,Gates,2022-01-08
3,0,3,0,Gates,2022-01-09
64,32,32,0,Gates,2022-01-10
37,14,23,0,Gates,2022-01-11
26,2,24,0,Gates,2022-01-13
17,6,11,0,Gates,2022-01-17
46,8,38,0,Gates,2022-01-18
9,2,7,0,Gates,2022-01-21
6,2,4,0,Gates,2022-01-22
6,2,4,0,Gates,2022-01-23
21,4,17,0,Gates,2022-01-24
37,10,27,0,Gates,2022-01-25
14,1,13,0,Gates,2022-01-26
7,0,7,0,Gates,2022-01-27
4,0,4,0,Gates,2022-01-28
0,0,0,0,Gates,2022-01-29
2,0,2,0,Gates,2022-01-30
12,2,10,0,Gates,2022-01-31
8,1,7,0,Gates,2022-02-01
6,0,6,0,Gates,2022-02-02
5,2,3,0,Gates,2022-02-03
8,2,6,0,Gates,2022-02-04
0,0,0,0,Gates,2022-02-05
0,0,0,0,Gates,2022-02-06
1,0,1,0,Gates,2022-02-07
3,1,2,0,Gates,2022-02-08
1,1,0,0,Gates,2022-02-09
1,0,1,0,Gates,2022-02-10
0,0,0,0,Gates,2022-02-11
0,0,0,0,Gates,2022-02-12
0,0,0,0,Gates,2022-02-13
3,3,0,0,Gates,2022-02-14
0,0,0,0,Gates,2022-02-15
1,0,1,0,Gates,2022-02-16
2,0,2,0,Gates,2022-02-17
3,0,3,0,Gates,2022-02-18
0,0,0,0,Gates,2022-02-19
2,0,2,0,Gates,2022-02-20
4,0,4,0,Gates,2022-02-21
1,0,1,0,Gates,2022-02-22
1,0,1,0,Gates,2022-02-23
1,0,1,0,Gates,2022-02-24
1,0,1,0,Gates,2022-02-25
0,0,0,0,Gates,2022-02-26
0,0,0,0,Gates,2022-02-27
2,0,2,0,Gates,2022-02-28
0,0,0,0,Gates,2022-03-01
1,0,1,0,Gates,2022-03-02
0,0,0,0,Gates,2022-03-03
0,0,0,0,Gates,2022-03-04
0,0,0,0,Gates,2022-03-05
0,0,0,0,Gates,2022-03-06
0,0,0,0,Gates,2022-03-07
0,0,0,0,Gates,2022-03-08
0,0,0,0,Gates,2022-03-09
0,0,0,0,Gates,2022-03-10
0,0,0,0,Gates,2022-03-11
0,0,0,0,Gates,2022-03-12
0,0,0,0,Gates,2022-03-13
0,0,0,0,Gates,2022-03-14
0,0,0,0,Gates,2022-03-15
0,0,0,0,Gates,2022-03-16
0,0,0,0,Gates,2022-03-17
0,0,0,0,Gates,2022-03-18
0,0,0,0,Gates,2022-03-19
1,1,0,0,Gates,2022-03-20
0,0,0,0,Gates,2022-03-21
0,0,0,0,Gates,2022-03-22
0,0,0,0,Gates,2022-03-23
0,0,0,0,Gates,2022-03-24
0,0,0,0,Gates,2022-03-25
0,0,0,0,Gates,2022-03-26
1,0,1,0,Gates,2022-03-27
0,0,0,0,Gates,2022-03-28
0,0,0,0,Gates,2022-03-29
1,0,1,0,Gates,2022-03-30
0,0,0,0,Gates,2022-03-31
1,1,0,0,Gates,2022-04-01
0,0,0,0,Gates,2022-04-02
0,0,0,0,Gates,2022-04-03
0,0,0,0,Gates,2022-04-04
0,0,0,0,Gates,2022-04-05
0,0,0,0,Gates,2022-04-06
0,0,0,0,Gates,2022-04-07
0,0,0,0,Gates,2022-04-08
1,0,1,0,Gates,2022-04-09
0,0,0,0,Gates,2022-04-10
0,0,0,0,Gates,2022-04-11
1,0,1,0,Gates,2022-04-12
0,0,0,0,Gates,2022-04-13
0,0,0,0,Gates,2022-04-14
0,0,0,0,Gates,2022-04-15
0,0,0,0,Gates,2022-04-16
0,0,0,0,Gates,2022-04-17
0,0,0,0,Gates,2022-04-18
0,0,0,0,Gates,2022-04-19
0,0,0,0,Gates,2022-04-20
1,0,1,0,Gates,2022-04-21
1,0,1,0,Gates,2022-04-22
0,0,0,0,Gates,2022-04-23
0,0,0,0,Gates,2022-04-24
1,0,1,0,Gates,2022-04-25
0,0,0,0,Gates,2022-04-26
0,0,0,0,Gates,2022-04-27
0,0,0,0,Gates,2022-04-28
0,0,0,0,Gates,2022-04-29
0,0,0,0,Gates,2022-04-30
0,0,0,0,Gates,2022-05-01
3,0,3,0,Gates,2022-05-02
2,1,1,0,Gates,2022-05-03
1,0,1,0,Gates,2022-05-04
4,1,3,0,Gates,2022-05-05
1,0,1,0,Gates,2022-05-06
2,2,0,0,Gates,2022-05-07
0,0,0,0,Gates,2022-05-08
0,0,0,0,Gates,2022-05-09
3,0,3,0,Gates,2022-05-10
3,1,2,0,Gates,2022-05-11
1,0,1,0,Gates,2022-05-12
1,1,0,0,Gates,2022-05-13
3,1,2,0,Gates,2022-05-14
1,1,0,0,Gates,2022-05-15
3,1,2,0,Gates,2022-05-16
1,1,0,0,Gates,2022-05-17
3,0,3,0,Gates,2022-05-18
3,1,2,0,Gates,2022-05-19
3,1,2,0,Gates,2022-05-20
1,0,1,0,Gates,2022-05-21
1,0,1,0,Gates,2022-05-22
3,0,3,0,Gates,2022-05-23
2,1,1,0,Gates,2022-05-24
0,0,0,0,Gates,2022-05-25
1,1,0,0,Gates,2022-05-26
0,0,0,0,Gates,2022-05-27
0,0,0,0,Gates,2022-05-28
0,0,0,0,Gates,2022-05-29
2,1,1,0,Gates,2022-05-30
2,0,2,0,Gates,2022-05-31
4,3,1,0,Gates,2022-06-01
1,0,1,0,Gates,2022-06-02
1,1,0,0,Gates,2022-06-03
1,1,0,0,Gates,2022-06-04
4,4,0,0,Graham,2021-12-07
3,3,0,0,Graham,2021-12-08
1,1,0,0,Graham,2021-12-09
1,0,1,0,Graham,2021-12-10
4,0,4,0,Graham,2021-12-11
0,0,0,0,Graham,2021-12-12
2,2,0,0,Graham,2021-12-13
3,2,1,0,Graham,2021-12-14
9,7,2,0,Graham,2021-12-15
2,2,0,0,Graham,2021-12-16
0,0,0,0,Graham,2021-12-19
6,6,0,0,Graham,2021-12-20
1,0,1,0,Graham,2021-12-21
2,2,0,0,Graham,2021-12-22
7,6,1,0,Graham,2021-12-23
0,0,0,0,Graham,2021-12-24
3,1,2,0,Graham,2021-12-25
3,3,0,0,Graham,2021-12-26
7,3,4,0,Graham,2021-12-27
8,7,1,0,Graham,2021-12-28
15,13,2,0,Graham,2021-12-29
14,7,7,0,Graham,2021-12-30
10,6,4,0,Graham,2021-12-31
3,3,0,0,Graham,2022-01-01
9,4,5,0,Graham,2022-01-02
7,3,4,0,Graham,2022-01-03
24,20,4,0,Graham,2022-01-04
6,6,0,0,Graham,2022-01-05
17,15,2,0,Graham,2022-01-07
6,2,4,0,Graham,2022-01-08
11,7,4,0,Graham,2022-01-09
30,23,7,0,Graham,2022-01-11
22,10,12,0,Graham,2022-01-12
20,6,14,0,Graham,2022-01-13
26,12,14,0,Graham,2022-01-14
3,2,1,0,Graham,2022-01-16
13,7,6,0,Graham,2022-01-17
39,27,12,0,Graham,2022-01-18
41,24,17,0,Graham,2022-01-19
35,19,16,0,Graham,2022-01-20
33,23,10,0,Graham,2022-01-21
13,4,9,0,Graham,2022-01-22
12,10,2,0,Graham,2022-01-23
53,17,36,0,Graham,2022-01-24
29,15,14,0,Graham,2022-01-25
21,12,9,0,Graham,2022-01-26
18,10,8,0,Graham,2022-01-27
24,16,8,0,Graham,2022-01-28
4,0,4,0,Graham,2022-01-29
10,7,3,0,Graham,2022-01-30
30,22,8,0,Graham,2022-01-31
18,13,5,0,Graham,2022-02-01
26,19,7,0,Graham,2022-02-02
10,8,2,0,Graham,2022-02-03
8,7,1,0,Graham,2022-02-04
7,3,4,0,Graham,2022-02-05
2,2,0,0,Graham,2022-02-06
14,13,1,0,Graham,2022-02-07
6,5,1,0,Graham,2022-02-08
13,8,5,0,Graham,2022-02-09
3,3,0,0,Graham,2022-02-10
3,2,1,0,Graham,2022-02-11
2,0,2,0,Graham,2022-02-12
3,2,1,0,Graham,2022-02-13
8,4,4,0,Graham,2022-02-14
7,4,3,0,Graham,2022-02-15
6,6,0,0,Graham,2022-02-16
5,3,2,0,Graham,2022-02-17
2,2,0,0,Graham,2022-02-18
0,0,0,0,Graham,2022-02-19
1,0,1,0,Graham,2022-02-20
2,2,0,0,Graham,2022-02-21
3,3,0,0,Graham,2022-02-22
3,2,1,0,Graham,2022-02-23
2,2,0,0,Graham,2022-02-24
0,0,0,0,Graham,2022-02-25
0,0,0,0,Graham,2022-02-26
0,0,0,0,Graham,2022-02-27
3,2,1,0,Graham,2022-02-28
1,1,0,0,Graham,2022-03-01
1,1,0,0,Graham,2022-03-02
2,1,1,0,Graham,2022-03-03
1,1,0,0,Graham,2022-03-04
0,0,0,0,Graham,2022-03-05
0,0,0,0,Graham,2022-03-06
3,1,2,0,Graham,2022-03-07
0,0,0,0,Graham,2022-03-08
0,0,0,0,Graham,2022-03-09
0,0,0,0,Graham,2022-03-10
0,0,0,0,Graham,2022-03-11
0,0,0,0,Graham,2022-03-12
0,0,0,0,Graham,2022-03-13
0,0,0,0,Graham,2022-03-14
0,0,0,0,Graham,2022-03-15
1,0,1,0,Graham,2022-03-16
0,0,0,0,Graham,2022-03-17
0,0,0,0,Graham,2022-03-18
0,0,0,0,Graham,2022-03-19
1,1,0,0,Graham,2022-03-20
0,0,0,0,Graham,2022-03-21
0,0,0,0,Graham,2022-03-22
0,0,0,0,Graham,2022-03-23
0,0,0,0,Graham,2022-03-25
0,0,0,0,Graham,2022-03-26
1,1,0,0,Graham,2022-03-27
1,0,1,0,Graham,2022-03-28
1,0,1,0,Graham,2022-03-29
0,0,0,0,Graham,2022-03-30
0,0,0,0,Graham,2022-03-31
0,0,0,0,Graham,2022-04-01
0,0,0,0,Graham,2022-04-02
0,0,0,0,Graham,2022-04-03
0,0,0,0,Graham,2022-04-04
0,0,0,0,Graham,2022-04-05
0,0,0,0,Graham,2022-04-06
1,0,1,0,Graham,2022-04-07
0,0,0,0,Graham,2022-04-08
0,0,0,0,Graham,2022-04-09
0,0,0,0,Graham,2022-04-10
1,0,1,0,Graham,2022-04-11
1,0,1,0,Graham,2022-04-12
0,0,0,0,Graham,2022-04-13
0,0,0,0,Graham,2022-04-14
0,0,0,0,Graham,2022-04-15
0,0,0,0,Graham,2022-04-16
0,0,0,0,Graham,2022-04-17
6,6,0,0,Graham,2022-04-18
3,2,1,0,Graham,2022-04-19
4,4,0,0,Graham,2022-04-20
0,0,0,0,Graham,2022-04-21
1,1,0,0,Graham,2022-04-22
1,0,1,0,Graham,2022-04-23
0,0,0,0,Graham,2022-04-24
3,1,2,0,Graham,2022-04-25
0,0,0,0,Graham,2022-04-26
0,0,0,0,Graham,2022-04-27
0,0,0,0,Graham,2022-04-28
2,1,1,0,Graham,2022-04-29
0,0,0,0,Graham,2022-04-30
0,0,0,0,Graham,2022-05-01
1,1,0,0,Graham,2022-05-02
0,0,0,0,Graham,2022-05-03
0,0,0,0,Graham,2022-05-04
0,0,0,0,Graham,2022-05-05
0,0,0,0,Graham,2022-05-06
0,0,0,0,Graham,2022-05-07
1,0,1,0,Graham,2022-05-08
4,2,2,0,Graham,2022-05-09
1,1,0,0,Graham,2022-05-10
3,2,1,0,Graham,2022-05-11
2,2,0,0,Graham,2022-05-12
2,2,0,0,Graham,2022-05-13
0,0,0,0,Graham,2022-05-14
0,0,0,0,Graham,2022-05-15
0,0,0,0,Graham,2022-05-16
0,0,0,0,Graham,2022-05-17
2,2,0,0,Graham,2022-05-18
2,2,0,0,Graham,2022-05-19
2,1,1,0,Graham,2022-05-20
0,0,0,0,Graham,2022-05-21
0,0,0,0,Graham,2022-05-22
0,0,0,0,Graham,2022-05-23
2,2,0,0,Graham,2022-05-24
7,6,1,0,Graham,2022-05-25
1,1,0,0,Graham,2022-05-26
0,0,0,0,Graham,2022-05-27
1,0,1,0,Graham,2022-05-28
0,0,0,0,Graham,2022-05-29
2,1,1,0,Graham,2022-05-30
1,1,0,0,Graham,2022-05-31
1,1,0,0,Graham,2022-06-01
2,2,0,0,Graham,2022-06-02
0,0,0,0,Graham,2022-06-03
0,0,0,0,Graham,2022-06-04
14,1,13,0,Granville,2021-12-07
23,9,14,0,Granville,2021-12-09
8,1,7,0,Granville,2021-12-12
23,10,13,0,Granville,2021-12-15
16,2,14,0,Granville,2021-12-18
28,4,24,0,Granville,2021-12-20
31,10,21,0,Granville,2021-12-22
25,6,19,0,Granville,2021-12-23
22,9,13,0,Granville,2021-12-24
16,6,10,0,Granville,2021-12-25
42,7,35,0,Granville,2021-12-26
98,25,73,0,Granville,2021-12-27
178,65,113,0,Granville,2021-12-29
196,92,104,0,Granville,2021-12-30
103,53,50,0,Granville,2021-12-31
42,8,34,0,Granville,2022-01-01
79,22,57,0,Granville,2022-01-02
157,65,92,0,Granville,2022-01-03
170,26,144,0,Granville,2022-01-04
49,9,40,0,Granville,2022-01-09
243,20,223,0,Granville,2022-01-10
215,27,188,0,Granville,2022-01-11
216,20,196,0,Granville,2022-01-12
176,11,165,0,Granville,2022-01-13
172,13,159,0,Granville,2022-01-14
87,8,79,0,Granville,2022-01-15
141,19,122,0,Granville,2022-01-17
60,5,55,0,Granville,2022-01-21
41,3,38,0,Granville,2022-01-22
56,7,49,0,Granville,2022-01-23
184,9,175,0,Granville,2022-01-24
88,6,82,0,Granville,2022-01-26
82,8,74,0,Granville,2022-01-27
77,4,73,0,Granville,2022-01-28
35,1,34,0,Granville,2022-01-29
88,3,85,0,Granville,2022-01-31
66,2,64,0,Granville,2022-02-01
60,10,50,0,Granville,2022-02-02
47,4,43,0,Granville,2022-02-04
36,3,33,0,Granville,2022-02-05
23,3,20,0,Granville,2022-02-06
50,15,35,0,Granville,2022-02-07
50,14,36,0,Granville,2022-02-08
62,10,52,0,Granville,2022-02-09
26,3,23,0,Granville,2022-02-10
27,5,22,0,Granville,2022-02-11
12,3,9,0,Granville,2022-02-12
13,0,13,0,Granville,2022-02-13
18,3,15,0,Granville,2022-02-15
19,7,12,0,Granville,2022-02-16
20,5,15,0,Granville,2022-02-17
13,1,12,0,Granville,2022-02-18
9,0,9,0,Granville,2022-02-19
4,0,4,0,Granville,2022-02-20
22,10,12,0,Granville,2022-02-21
10,2,8,0,Granville,2022-02-22
9,3,6,0,Granville,2022-02-23
10,1,9,0,Granville,2022-02-24
3,0,3,0,Granville,2022-02-25
5,0,5,0,Granville,2022-02-26
3,0,3,0,Granville,2022-02-27
11,2,9,0,Granville,2022-02-28
14,3,11,0,Granville,2022-03-01
8,0,8,0,Granville,2022-03-02
6,1,5,0,Granville,2022-03-03
3,0,3,0,Granville,2022-03-04
2,1,1,0,Granville,2022-03-05
1,0,1,0,Granville,2022-03-06
6,0,6,0,Granville,2022-03-07
10,5,5,0,Granville,2022-03-08
5,2,3,0,Granville,2022-03-09
2,0,2,0,Granville,2022-03-10
2,2,0,0,Granville,2022-03-11
1,0,1,0,Granville,2022-03-12
2,1,1,0,Granville,2022-03-13
3,0,3,0,Granville,2022-03-14
3,0,3,0,Granville,2022-03-15
1,0,1,0,Granville,2022-03-16
1,0,1,0,Granville,2022-03-17
3,0,3,0,Granville,2022-03-18
0,0,0,0,Granville,2022-03-19
0,0,0,0,Granville,2022-03-20
3,1,2,0,Granville,2022-03-21
2,1,1,0,Granville,2022-03-22
1,1,0,0,Granville,2022-03-23
1,1,0,0,Granville,2022-03-24
3,0,3,0,Granville,2022-03-25
1,0,1,0,Granville,2022-03-26
0,0,0,0,Granville,2022-03-27
1,0,1,0,Granville,2022-03-28
2,0,2,0,Granville,2022-03-29
0,0,0,0,Granville,2022-03-30
2,0,2,0,Granville,2022-03-31
1,0,1,0,Granville,2022-04-01
2,2,0,0,Granville,2022-04-02
0,0,0,0,Granville,2022-04-03
3,1,2,0,Granville,2022-04-04
4,3,1,0,Granville,2022-04-05
4,1,3,0,Granville,2022-04-06
7,2,5,0,Granville,2022-04-07
3,0,3,0,Granville,2022-04-09
3,2,1,0,Granville,2022-04-10
8,2,6,0,Granville,2022-04-11
3,1,2,0,Granville,2022-04-12
6,2,4,0,Granville,2022-04-13
10,2,8,0,Granville,2022-04-14
3,0,3,0,Granville,2022-04-15
10,0,10,0,Granville,2022-04-16
4,0,4,0,Granville,2022-04-17
5,1,4,0,Granville,2022-04-18
7,2,5,0,Granville,2022-04-19
9,2,7,0,Granville,2022-04-20
10,4,6,0,Granville,2022-04-21
6,0,6,0,Granville,2022-04-22
5,1,4,0,Granville,2022-04-23
5,1,4,0,Granville,2022-04-24
13,6,7,0,Granville,2022-04-25
14,3,11,0,Granville,2022-04-26
12,5,7,0,Granville,2022-04-27
12,3,9,0,Granville,2022-04-28
8,0,8,0,Granville,2022-04-30
5,2,3,0,Granville,2022-05-01
27,5,22,0,Granville,2022-05-02
17,2,15,0,Granville,2022-05-04
24,8,16,0,Granville,2022-05-05
5,0,5,0,Granville,2022-05-06
9,0,9,0,Granville,2022-05-07
7,1,6,0,Granville,2022-05-08
21,2,19,0,Granville,2022-05-09
16,1,15,0,Granville,2022-05-10
21,3,18,0,Granville,2022-05-11
25,7,18,0,Granville,2022-05-12
25,7,18,0,Granville,2022-05-13
15,2,13,0,Granville,2022-05-14
36,13,23,0,Granville,2022-05-16
37,17,20,0,Granville,2022-05-17
33,9,24,0,Granville,2022-05-18
21,4,17,0,Granville,2022-05-19
25,8,17,0,Granville,2022-05-20
16,4,12,0,Granville,2022-05-21
20,5,15,0,Granville,2022-05-22
51,20,31,0,Granville,2022-05-23
25,7,18,0,Granville,2022-05-24
31,10,21,0,Granville,2022-05-25
29,5,24,0,Granville,2022-05-26
15,7,8,0,Granville,2022-05-27
11,6,5,0,Granville,2022-05-28
13,4,9,0,Granville,2022-05-29
10,3,7,0,Granville,2022-05-30
42,7,35,0,Granville,2022-05-31
32,3,29,0,Granville,2022-06-01
30,4,26,0,Granville,2022-06-02
20,3,17,0,Granville,2022-06-03
5,0,5,0,Granville,2022-06-04
4,0,4,0,Greene,2021-12-09
2,0,2,0,Greene,2021-12-12
10,5,5,0,Greene,2021-12-14
3,0,3,0,Greene,2021-12-18
5,2,3,0,Greene,2021-12-19
16,2,14,0,Greene,2021-12-20
16,5,11,0,Greene,2021-12-21
25,4,21,0,Greene,2021-12-22
12,3,9,0,Greene,2021-12-23
1,1,0,0,Greene,2021-12-24
3,1,2,0,Greene,2021-12-25
9,1,8,0,Greene,2021-12-26
17,3,14,0,Greene,2021-12-27
49,10,39,0,Greene,2021-12-28
36,14,22,0,Greene,2021-12-29
71,12,59,0,Greene,2021-12-30
25,5,20,0,Greene,2021-12-31
8,2,6,0,Greene,2022-01-01
8,0,8,0,Greene,2022-01-02
83,7,76,0,Greene,2022-01-03
73,14,59,0,Greene,2022-01-04
41,6,35,0,Greene,2022-01-07
23,3,20,0,Greene,2022-01-09
130,28,102,0,Greene,2022-01-10
106,25,81,0,Greene,2022-01-11
67,20,47,0,Greene,2022-01-12
125,14,111,0,Greene,2022-01-13
68,19,49,0,Greene,2022-01-14
15,3,12,0,Greene,2022-01-15
78,29,49,0,Greene,2022-01-17
171,38,133,0,Greene,2022-01-18
91,33,58,0,Greene,2022-01-20
25,9,16,0,Greene,2022-01-21
6,5,1,0,Greene,2022-01-22
67,19,48,0,Greene,2022-01-25
44,6,38,0,Greene,2022-01-27
28,5,23,0,Greene,2022-01-28
8,1,7,0,Greene,2022-01-29
5,0,5,0,Greene,2022-01-30
41,12,29,0,Greene,2022-01-31
27,5,22,0,Greene,2022-02-01
14,3,11,0,Greene,2022-02-02
14,3,11,0,Greene,2022-02-03
17,4,13,0,Greene,2022-02-04
5,0,5,0,Greene,2022-02-05
8,2,6,0,Greene,2022-02-06
11,1,10,0,Greene,2022-02-08
11,6,5,0,Greene,2022-02-09
4,0,4,0,Greene,2022-02-10
4,2,2,0,Greene,2022-02-11
6,0,6,0,Greene,2022-02-14
10,2,8,0,Greene,2022-02-15
2,0,2,0,Greene,2022-02-16
4,1,3,0,Greene,2022-02-18
0,0,0,0,Greene,2022-02-19
1,0,1,0,Greene,2022-02-20
8,1,7,0,Greene,2022-02-21
4,0,4,0,Greene,2022-02-22
4,0,4,0,Greene,2022-02-24
2,1,1,0,Greene,2022-02-26
1,0,1,0,Greene,2022-02-27
5,4,1,0,Greene,2022-02-28
2,0,2,0,Greene,2022-03-01
0,0,0,0,Greene,2022-03-02
4,1,3,0,Greene,2022-03-03
1,0,1,0,Greene,2022-03-04
0,0,0,0,Greene,2022-03-05
0,0,0,0,Greene,2022-03-06
1,0,1,0,Greene,2022-03-08
0,0,0,0,Greene,2022-03-09
0,0,0,0,Greene,2022-03-10
0,0,0,0,Greene,2022-03-11
0,0,0,0,Greene,2022-03-12
0,0,0,0,Greene,2022-03-13
0,0,0,0,Greene,2022-03-14
0,0,0,0,Greene,2022-03-16
0,0,0,0,Greene,2022-03-17
0,0,0,0,Greene,2022-03-18
0,0,0,0,Greene,2022-03-19
0,0,0,0,Greene,2022-03-20
0,0,0,0,Greene,2022-03-21
0,0,0,0,Greene,2022-03-22
1,0,1,0,Greene,2022-03-23
0,0,0,0,Greene,2022-03-24
0,0,0,0,Greene,2022-03-25
0,0,0,0,Greene,2022-03-26
0,0,0,0,Greene,2022-03-27
0,0,0,0,Greene,2022-03-28
0,0,0,0,Greene,2022-03-29
2,0,2,0,Greene,2022-03-30
0,0,0,0,Greene,2022-03-31
0,0,0,0,Greene,2022-04-01
0,0,0,0,Greene,2022-04-02
0,0,0,0,Greene,2022-04-03
0,0,0,0,Greene,2022-04-04
1,0,1,0,Greene,2022-04-05
0,0,0,0,Greene,2022-04-06
0,0,0,0,Greene,2022-04-07
0,0,0,0,Greene,2022-04-08
0,0,0,0,Greene,2022-04-09
0,0,0,0,Greene,2022-04-10
0,0,0,0,Greene,2022-04-11
0,0,0,0,Greene,2022-04-12
0,0,0,0,Greene,2022-04-13
4,0,4,0,Greene,2022-04-14
0,0,0,0,Greene,2022-04-15
0,0,0,0,Greene,2022-04-16
0,0,0,0,Greene,2022-04-17
1,0,1,0,Greene,2022-04-18
4,0,4,0,Greene,2022-04-19
0,0,0,0,Greene,2022-04-20
0,0,0,0,Greene,2022-04-21
0,0,0,0,Greene,2022-04-22
0,0,0,0,Greene,2022-04-23
2,0,2,0,Greene,2022-04-24
2,1,1,0,Greene,2022-04-25
0,0,0,0,Greene,2022-04-26
0,0,0,0,Greene,2022-04-27
1,0,1,0,Greene,2022-04-28
1,1,0,0,Greene,2022-04-29
0,0,0,0,Greene,2022-04-30
3,0,3,0,Greene,2022-05-01
0,0,0,0,Greene,2022-05-02
5,2,3,0,Greene,2022-05-03
2,1,1,0,Greene,2022-05-04
5,2,3,0,Greene,2022-05-05
1,0,1,0,Greene,2022-05-06
2,0,2,0,Greene,2022-05-07
0,0,0,0,Greene,2022-05-08
10,4,6,0,Greene,2022-05-09
3,0,3,0,Greene,2022-05-10
3,1,2,0,Greene,2022-05-11
5,0,5,0,Greene,2022-05-12
3,2,1,0,Greene,2022-05-13
0,0,0,0,Greene,2022-05-14
1,1,0,0,Greene,2022-05-15
4,2,2,0,Greene,2022-05-16
8,2,6,0,Greene,2022-05-17
1,0,1,0,Greene,2022-05-18
2,2,0,0,Greene,2022-05-19
8,4,4,0,Greene,2022-05-20
1,1,0,0,Greene,2022-05-21
3,1,2,0,Greene,2022-05-22
4,3,1,0,Greene,2022-05-23
38,2,36,0,Greene,2022-05-24
4,2,2,0,Greene,2022-05-25
5,0,5,0,Greene,2022-05-26
5,0,5,0,Greene,2022-05-27
2,1,1,0,Greene,2022-05-28
0,0,0,0,Greene,2022-05-29
1,1,0,0,Greene,2022-05-30
7,2,5,0,Greene,2022-05-31
5,4,1,0,Greene,2022-06-01
5,0,5,0,Greene,2022-06-02
4,0,4,0,Greene,2022-06-03
3,0,3,0,Greene,2022-06-04
80,7,73,0,Guilford,2021-12-12
221,39,182,0,Guilford,2021-12-16
212,32,180,0,Guilford,2021-12-17
286,39,247,0,Guilford,2021-12-20
100,14,86,0,Guilford,2021-12-25
1648,242,1406,0,Guilford,2022-01-04
70,19,51,0,Guilford,2022-02-19
56,22,34,0,Guilford,2022-02-20
17,6,11,0,Guilford,2022-03-12
31,6,25,0,Guilford,2022-03-14
27,4,23,0,Guilford,2022-03-16
28,9,19,0,Guilford,2022-03-17
15,3,12,0,Guilford,2022-03-18
28,7,21,0,Guilford,2022-03-24
13,1,12,0,Guilford,2022-03-26
21,8,13,0,Guilford,2022-03-28
33,8,25,0,Guilford,2022-03-31
25,11,14,0,Guilford,2022-04-01
17,3,14,0,Guilford,2022-04-03
37,8,29,0,Guilford,2022-04-04
26,3,23,0,Guilford,2022-04-05
27,10,17,0,Guilford,2022-04-06
56,13,43,0,Guilford,2022-04-07
45,9,36,0,Guilford,2022-04-08
40,11,29,0,Guilford,2022-04-10
120,37,83,0,Guilford,2022-04-14
82,13,69,0,Guilford,2022-04-15
39,4,35,0,Guilford,2022-04-17
167,46,121,0,Guilford,2022-04-19
178,42,136,0,Guilford,2022-04-20
123,33,90,0,Guilford,2022-04-21
103,5,98,0,Guilford,2022-04-22
63,10,53,0,Guilford,2022-04-23
76,9,67,0,Guilford,2022-04-24
166,40,126,0,Guilford,2022-04-27
112,21,91,0,Guilford,2022-04-28
90,27,63,0,Guilford,2022-05-01
202,42,160,0,Guilford,2022-05-02
158,37,121,0,Guilford,2022-05-03
171,45,126,0,Guilford,2022-05-04
163,37,126,0,Guilford,2022-05-05
149,25,124,0,Guilford,2022-05-06
91,15,76,0,Guilford,2022-05-07
88,14,74,0,Guilford,2022-05-08
236,36,200,0,Guilford,2022-05-11
209,45,164,0,Guilford,2022-05-13
130,18,112,0,Guilford,2022-05-15
266,52,214,0,Guilford,2022-05-16
235,45,190,0,Guilford,2022-05-17
265,43,222,0,Guilford,2022-05-18
250,41,209,0,Guilford,2022-05-19
221,37,184,0,Guilford,2022-05-20
111,19,92,0,Guilford,2022-05-21
158,35,123,0,Guilford,2022-05-22
255,54,201,0,Guilford,2022-05-23
205,29,176,0,Guilford,2022-05-25
201,29,172,0,Guilford,2022-05-26
163,37,126,0,Guilford,2022-05-27
118,25,93,0,Guilford,2022-05-29
186,31,155,0,Guilford,2022-06-02
143,29,114,0,Guilford,2022-06-03
9,0,9,0,Halifax,2021-12-09
2,1,1,0,Halifax,2021-12-11
4,2,2,0,Halifax,2021-12-12
13,4,9,0,Halifax,2021-12-14
9,0,9,0,Halifax,2021-12-15
15,4,11,0,Halifax,2021-12-16
2,1,1,0,Halifax,2021-12-19
20,2,18,0,Halifax,2021-12-20
22,3,19,0,Halifax,2021-12-21
39,6,33,0,Halifax,2021-12-22
16,2,14,0,Halifax,2021-12-24
17,2,15,0,Halifax,2021-12-25
25,6,19,0,Halifax,2021-12-26
86,13,73,0,Halifax,2021-12-27
215,25,190,0,Halifax,2021-12-30
195,6,189,0,Halifax,2021-12-31
59,2,57,0,Halifax,2022-01-01
204,37,167,0,Halifax,2022-01-03
259,17,242,0,Halifax,2022-01-07
62,8,54,0,Halifax,2022-01-09
274,20,254,0,Halifax,2022-01-10
183,13,170,0,Halifax,2022-01-13
92,25,67,0,Halifax,2022-01-17
257,42,215,0,Halifax,2022-01-18
202,23,179,0,Halifax,2022-01-19
16,2,14,0,Halifax,2022-01-23
82,20,62,0,Halifax,2022-01-26
67,12,55,0,Halifax,2022-01-28
88,25,63,0,Halifax,2022-01-31
58,12,46,0,Halifax,2022-02-01
51,17,34,0,Halifax,2022-02-02
44,9,35,0,Halifax,2022-02-07
23,4,19,0,Halifax,2022-02-08
16,4,12,0,Halifax,2022-02-10
14,0,14,0,Halifax,2022-02-11
6,0,6,0,Halifax,2022-02-13
19,0,19,0,Halifax,2022-02-14
12,2,10,0,Halifax,2022-02-15
19,0,19,0,Halifax,2022-02-17
12,3,9,0,Halifax,2022-02-18
6,1,5,0,Halifax,2022-02-20
14,6,8,0,Halifax,2022-02-21
14,3,11,0,Halifax,2022-02-23
5,1,4,0,Halifax,2022-02-25
4,1,3,0,Halifax,2022-02-27
9,1,8,0,Halifax,2022-02-28
10,2,8,0,Halifax,2022-03-01
3,0,3,0,Halifax,2022-03-02
8,1,7,0,Halifax,2022-03-03
7,1,6,0,Halifax,2022-03-04
1,0,1,0,Halifax,2022-03-05
0,0,0,0,Halifax,2022-03-06
4,0,4,0,Halifax,2022-03-07
1,0,1,0,Halifax,2022-03-08
1,0,1,0,Halifax,2022-03-09
0,0,0,0,Halifax,2022-03-10
2,1,1,0,Halifax,2022-03-11
2,1,1,0,Halifax,2022-03-12
3,2,1,0,Halifax,2022-03-14
1,0,1,0,Halifax,2022-03-15
0,0,0,0,Halifax,2022-03-16
2,0,2,0,Halifax,2022-03-17
0,0,0,0,Halifax,2022-03-18
1,0,1,0,Halifax,2022-03-19
0,0,0,0,Halifax,2022-03-20
1,1,0,0,Halifax,2022-03-21
0,0,0,0,Halifax,2022-03-22
0,0,0,0,Halifax,2022-03-23
0,0,0,0,Halifax,2022-03-24
0,0,0,0,Halifax,2022-03-25
0,0,0,0,Halifax,2022-03-27
0,0,0,0,Halifax,2022-03-28
0,0,0,0,Halifax,2022-03-29
0,0,0,0,Halifax,2022-03-30
1,0,1,0,Halifax,2022-03-31
0,0,0,0,Halifax,2022-04-01
1,1,0,0,Halifax,2022-04-02
0,0,0,0,Halifax,2022-04-03
2,0,2,0,Halifax,2022-04-04
1,0,1,0,Halifax,2022-04-05
2,0,2,0,Halifax,2022-04-06
0,0,0,0,Halifax,2022-04-07
3,0,3,0,Halifax,2022-04-08
0,0,0,0,Halifax,2022-04-09
0,0,0,0,Halifax,2022-04-11
0,0,0,0,Halifax,2022-04-12
2,0,2,0,Halifax,2022-04-13
3,1,2,0,Halifax,2022-04-14
3,0,3,0,Halifax,2022-04-15
0,0,0,0,Halifax,2022-04-16
1,0,1,0,Halifax,2022-04-17
3,0,3,0,Halifax,2022-04-18
1,0,1,0,Halifax,2022-04-19
3,1,2,0,Halifax,2022-04-20
5,1,4,0,Halifax,2022-04-21
11,8,3,0,Halifax,2022-04-22
1,0,1,0,Halifax,2022-04-23
5,0,5,0,Halifax,2022-04-24
8,1,7,0,Halifax,2022-04-25
5,0,5,0,Halifax,2022-04-26
7,2,5,0,Halifax,2022-04-27
3,0,3,0,Halifax,2022-04-28
3,0,3,0,Halifax,2022-04-29
2,1,1,0,Halifax,2022-04-30
0,0,0,0,Halifax,2022-05-01
14,3,11,0,Halifax,2022-05-02
11,1,10,0,Halifax,2022-05-03
12,4,8,0,Halifax,2022-05-04
3,1,2,0,Halifax,2022-05-05
7,1,6,0,Halifax,2022-05-06
7,2,5,0,Halifax,2022-05-07
3,3,0,0,Halifax,2022-05-08
16,8,8,0,Halifax,2022-05-09
18,6,12,0,Halifax,2022-05-10
18,7,11,0,Halifax,2022-05-11
17,6,11,0,Halifax,2022-05-12
12,2,10,0,Halifax,2022-05-13
4,0,4,0,Halifax,2022-05-14
6,3,3,0,Halifax,2022-05-15
16,7,9,0,Halifax,2022-05-16
22,8,14,0,Halifax,2022-05-17
16,5,11,0,Halifax,2022-05-18
23,4,19,0,Halifax,2022-05-19
22,3,19,0,Halifax,2022-05-20
7,0,7,0,Halifax,2022-05-21
8,3,5,0,Halifax,2022-05-22
27,6,21,0,Halifax,2022-05-23
22,3,19,0,Halifax,2022-05-24
21,7,14,0,Halifax,2022-05-25
12,3,9,0,Halifax,2022-05-26
29,8,21,0,Halifax,2022-05-27
5,2,3,0,Halifax,2022-05-28
5,0,5,0,Halifax,2022-05-29
5,1,4,0,Halifax,2022-05-30
23,3,20,0,Halifax,2022-05-31
18,4,14,0,Halifax,2022-06-01
26,4,22,0,Halifax,2022-06-02
15,4,11,0,Halifax,2022-06-03
7,3,4,0,Halifax,2022-06-04
43,8,35,0,Harnett,2021-12-09
37,11,26,0,Harnett,2021-12-10
22,2,20,0,Harnett,2021-12-12
58,19,39,0,Harnett,2021-12-17
73,22,51,0,Harnett,2021-12-20
57,14,43,0,Harnett,2021-12-22
71,14,57,0,Harnett,2021-12-23
38,8,30,0,Harnett,2021-12-24
21,4,17,0,Harnett,2021-12-25
50,9,41,0,Harnett,2021-12-26
272,51,221,0,Harnett,2021-12-30
167,21,146,0,Harnett,2021-12-31
103,11,92,0,Harnett,2022-01-01
426,105,321,0,Harnett,2022-01-03
497,88,409,0,Harnett,2022-01-04
471,61,410,0,Harnett,2022-01-05
635,127,508,0,Harnett,2022-01-11
64,14,50,0,Harnett,2022-01-16
731,162,569,0,Harnett,2022-01-18
46,10,36,0,Harnett,2022-01-22
213,36,177,0,Harnett,2022-01-27
222,37,185,0,Harnett,2022-01-28
224,44,180,0,Harnett,2022-01-31
152,36,116,0,Harnett,2022-02-02
110,15,95,0,Harnett,2022-02-03
110,37,73,0,Harnett,2022-02-07
67,12,55,0,Harnett,2022-02-09
29,4,25,0,Harnett,2022-02-12
13,1,12,0,Harnett,2022-02-20
39,14,25,0,Harnett,2022-02-21
27,4,23,0,Harnett,2022-02-23
12,1,11,0,Harnett,2022-02-24
22,7,15,0,Harnett,2022-02-25
11,2,9,0,Harnett,2022-02-26
15,4,11,0,Harnett,2022-03-03
10,1,9,0,Harnett,2022-03-04
3,1,2,0,Harnett,2022-03-05
6,0,6,0,Harnett,2022-03-06
13,2,11,0,Harnett,2022-03-09
8,3,5,0,Harnett,2022-03-10
1,0,1,0,Harnett,2022-03-12
5,0,5,0,Harnett,2022-03-13
4,1,3,0,Harnett,2022-03-15
8,3,5,0,Harnett,2022-03-17
2,1,1,0,Harnett,2022-03-19
3,1,2,0,Harnett,2022-03-20
9,0,9,0,Harnett,2022-03-21
4,2,2,0,Harnett,2022-03-22
5,1,4,0,Harnett,2022-03-23
3,0,3,0,Harnett,2022-03-24
1,0,1,0,Harnett,2022-03-25
1,0,1,0,Harnett,2022-03-26
2,0,2,0,Harnett,2022-03-27
3,3,0,0,Harnett,2022-03-28
8,0,8,0,Harnett,2022-03-29
8,2,6,0,Harnett,2022-03-30
2,0,2,0,Harnett,2022-03-31
7,0,7,0,Harnett,2022-04-01
4,0,4,0,Harnett,2022-04-02
4,1,3,0,Harnett,2022-04-03
5,0,5,0,Harnett,2022-04-04
6,1,5,0,Harnett,2022-04-05
6,0,6,0,Harnett,2022-04-07
1,0,1,0,Harnett,2022-04-08
4,0,4,0,Harnett,2022-04-09
3,1,2,0,Harnett,2022-04-10
11,1,10,0,Harnett,2022-04-11
6,4,2,0,Harnett,2022-04-12
8,0,8,0,Harnett,2022-04-14
6,2,4,0,Harnett,2022-04-15
5,1,4,0,Harnett,2022-04-16
4,1,3,0,Harnett,2022-04-17
17,8,9,0,Harnett,2022-04-18
13,3,10,0,Harnett,2022-04-19
21,9,12,0,Harnett,2022-04-20
26,12,14,0,Harnett,2022-04-21
10,3,7,0,Harnett,2022-04-22
23,5,18,0,Harnett,2022-04-26
17,5,12,0,Harnett,2022-04-27
16,4,12,0,Harnett,2022-04-28
19,4,15,0,Harnett,2022-04-29
10,3,7,0,Harnett,2022-04-30
3,0,3,0,Harnett,2022-05-01
31,10,21,0,Harnett,2022-05-02
25,8,17,0,Harnett,2022-05-03
25,3,22,0,Harnett,2022-05-04
22,7,15,0,Harnett,2022-05-05
31,7,24,0,Harnett,2022-05-06
12,3,9,0,Harnett,2022-05-07
22,6,16,0,Harnett,2022-05-08
44,10,34,0,Harnett,2022-05-09
24,2,22,0,Harnett,2022-05-10
34,7,27,0,Harnett,2022-05-11
27,5,22,0,Harnett,2022-05-12
34,8,26,0,Harnett,2022-05-13
23,5,18,0,Harnett,2022-05-14
20,3,17,0,Harnett,2022-05-15
57,14,43,0,Harnett,2022-05-16
37,10,27,0,Harnett,2022-05-17
52,7,45,0,Harnett,2022-05-18
52,17,35,0,Harnett,2022-05-19
50,12,38,0,Harnett,2022-05-20
26,3,23,0,Harnett,2022-05-21
20,3,17,0,Harnett,2022-05-22
58,12,46,0,Harnett,2022-05-23
38,9,29,0,Harnett,2022-05-24
48,15,33,0,Harnett,2022-05-25
50,19,31,0,Harnett,2022-05-26
45,9,36,0,Harnett,2022-05-27
20,1,19,0,Harnett,2022-05-29
18,8,10,0,Harnett,2022-05-30
67,25,42,0,Harnett,2022-05-31
40,7,33,0,Harnett,2022-06-01
29,5,24,0,Harnett,2022-06-02
30,3,27,0,Harnett,2022-06-03
15,0,15,0,Harnett,2022-06-04
24,11,13,0,Haywood,2021-12-09
14,8,6,0,Haywood,2021-12-11
26,4,22,0,Haywood,2021-12-15
12,7,5,0,Haywood,2021-12-16
24,12,12,0,Haywood,2021-12-23
7,1,6,0,Haywood,2021-12-25
18,10,8,0,Haywood,2021-12-26
56,14,42,0,Haywood,2021-12-28
58,22,36,0,Haywood,2021-12-30
24,8,16,0,Haywood,2022-01-01
93,32,61,0,Haywood,2022-01-03
93,25,68,0,Haywood,2022-01-04
142,34,108,0,Haywood,2022-01-06
47,17,30,0,Haywood,2022-01-08
55,4,51,0,Haywood,2022-01-09
153,62,91,0,Haywood,2022-01-13
161,62,99,0,Haywood,2022-01-18
169,43,126,0,Haywood,2022-01-20
148,34,114,0,Haywood,2022-01-21
59,13,46,0,Haywood,2022-01-22
65,11,54,0,Haywood,2022-01-23
118,29,89,0,Haywood,2022-01-25
131,35,96,0,Haywood,2022-01-26
60,15,45,0,Haywood,2022-02-04
56,27,29,0,Haywood,2022-02-09
38,16,22,0,Haywood,2022-02-10
17,6,11,0,Haywood,2022-02-12
19,2,17,0,Haywood,2022-02-13
30,17,13,0,Haywood,2022-02-17
18,6,12,0,Haywood,2022-02-18
14,8,6,0,Haywood,2022-02-19
19,5,14,0,Haywood,2022-02-23
6,2,4,0,Haywood,2022-02-27
23,12,11,0,Haywood,2022-02-28
1,0,1,0,Haywood,2022-03-02
11,3,8,0,Haywood,2022-03-03
3,0,3,0,Haywood,2022-03-05
1,0,1,0,Haywood,2022-03-06
4,2,2,0,Haywood,2022-03-10
4,0,4,0,Haywood,2022-03-11
1,0,1,0,Haywood,2022-03-12
2,0,2,0,Haywood,2022-03-13
3,2,1,0,Haywood,2022-03-14
5,2,3,0,Haywood,2022-03-15
14,1,13,0,Haywood,2022-03-16
3,1,2,0,Haywood,2022-03-17
1,0,1,0,Haywood,2022-03-18
0,0,0,0,Haywood,2022-03-19
0,0,0,0,Haywood,2022-03-20
3,1,2,0,Haywood,2022-03-21
2,0,2,0,Haywood,2022-03-22
6,1,5,0,Haywood,2022-03-23
3,2,1,0,Haywood,2022-03-24
1,0,1,0,Haywood,2022-03-25
0,0,0,0,Haywood,2022-03-26
7,6,1,0,Haywood,2022-03-27
2,1,1,0,Haywood,2022-03-28
6,3,3,0,Haywood,2022-03-30
2,0,2,0,Haywood,2022-03-31
1,0,1,0,Haywood,2022-04-01
2,1,1,0,Haywood,2022-04-02
0,0,0,0,Haywood,2022-04-03
5,2,3,0,Haywood,2022-04-04
1,0,1,0,Haywood,2022-04-05
4,2,2,0,Haywood,2022-04-06
3,1,2,0,Haywood,2022-04-07
2,1,1,0,Haywood,2022-04-08
1,0,1,0,Haywood,2022-04-09
2,0,2,0,Haywood,2022-04-10
6,1,5,0,Haywood,2022-04-11
4,2,2,0,Haywood,2022-04-12
5,2,3,0,Haywood,2022-04-13
3,1,2,0,Haywood,2022-04-14
2,1,1,0,Haywood,2022-04-15
4,4,0,0,Haywood,2022-04-16
0,0,0,0,Haywood,2022-04-17
4,3,1,0,Haywood,2022-04-18
2,0,2,0,Haywood,2022-04-19
6,4,2,0,Haywood,2022-04-20
6,3,3,0,Haywood,2022-04-21
7,1,6,0,Haywood,2022-04-22
2,1,1,0,Haywood,2022-04-23
3,0,3,0,Haywood,2022-04-24
15,10,5,0,Haywood,2022-04-25
6,3,3,0,Haywood,2022-04-26
11,2,9,0,Haywood,2022-04-27
6,1,5,0,Haywood,2022-04-28
6,4,2,0,Haywood,2022-04-29
5,4,1,0,Haywood,2022-04-30
4,3,1,0,Haywood,2022-05-01
12,5,7,0,Haywood,2022-05-02
17,7,10,0,Haywood,2022-05-03
16,8,8,0,Haywood,2022-05-04
16,8,8,0,Haywood,2022-05-05
13,5,8,0,Haywood,2022-05-06
7,1,6,0,Haywood,2022-05-07
6,3,3,0,Haywood,2022-05-08
9,5,4,0,Haywood,2022-05-09
17,13,4,0,Haywood,2022-05-10
22,9,13,0,Haywood,2022-05-11
21,12,9,0,Haywood,2022-05-12
13,5,8,0,Haywood,2022-05-13
12,4,8,0,Haywood,2022-05-14
6,4,2,0,Haywood,2022-05-15
38,18,20,0,Haywood,2022-05-16
15,4,11,0,Haywood,2022-05-17
15,1,14,0,Haywood,2022-05-18
18,6,12,0,Haywood,2022-05-19
13,7,6,0,Haywood,2022-05-20
9,6,3,0,Haywood,2022-05-21
12,8,4,0,Haywood,2022-05-22
24,12,12,0,Haywood,2022-05-23
18,14,4,0,Haywood,2022-05-24
25,14,11,0,Haywood,2022-05-25
13,10,3,0,Haywood,2022-05-26
13,4,9,0,Haywood,2022-05-27
6,5,1,0,Haywood,2022-05-28
14,4,10,0,Haywood,2022-05-29
10,5,5,0,Haywood,2022-05-30
27,11,16,0,Haywood,2022-05-31
24,11,13,0,Haywood,2022-06-01
16,9,7,0,Haywood,2022-06-02
20,10,10,0,Haywood,2022-06-03
8,4,4,0,Haywood,2022-06-04
40,12,28,0,Henderson,2021-12-09
68,26,42,0,Henderson,2021-12-13
63,32,31,0,Henderson,2021-12-14
52,15,37,0,Henderson,2021-12-16
25,12,13,0,Henderson,2021-12-18
64,15,49,0,Henderson,2021-12-20
60,16,44,0,Henderson,2021-12-21
70,22,48,0,Henderson,2021-12-22
92,26,66,0,Henderson,2021-12-23
34,8,26,0,Henderson,2021-12-24
141,14,127,0,Henderson,2021-12-27
118,26,92,0,Henderson,2021-12-31
60,24,36,0,Henderson,2022-01-01
91,37,54,0,Henderson,2022-01-02
212,32,180,0,Henderson,2022-01-04
247,51,196,0,Henderson,2022-01-05
199,71,128,0,Henderson,2022-01-06
372,111,261,0,Henderson,2022-01-10
313,92,221,0,Henderson,2022-01-11
181,65,116,0,Henderson,2022-01-21
54,17,37,0,Henderson,2022-01-29
55,21,34,0,Henderson,2022-02-14
44,17,27,0,Henderson,2022-02-15
44,18,26,0,Henderson,2022-02-16
26,14,12,0,Henderson,2022-02-19
10,4,6,0,Henderson,2022-02-20
21,9,12,0,Henderson,2022-02-23
16,8,8,0,Henderson,2022-02-24
19,4,15,0,Henderson,2022-02-25
8,2,6,0,Henderson,2022-02-26
4,2,2,0,Henderson,2022-02-27
17,12,5,0,Henderson,2022-02-28
9,5,4,0,Henderson,2022-03-02
8,2,6,0,Henderson,2022-03-03
13,4,9,0,Henderson,2022-03-04
6,1,5,0,Henderson,2022-03-05
13,6,7,0,Henderson,2022-03-07
4,3,1,0,Henderson,2022-03-08
1,0,1,0,Henderson,2022-03-12
3,1,2,0,Henderson,2022-03-13
4,3,1,0,Henderson,2022-03-14
7,1,6,0,Henderson,2022-03-15
2,1,1,0,Henderson,2022-03-16
1,0,1,0,Henderson,2022-03-18
5,4,1,0,Henderson,2022-03-20
2,2,0,0,Henderson,2022-03-21
6,4,2,0,Henderson,2022-03-22
1,1,0,0,Henderson,2022-03-23
4,1,3,0,Henderson,2022-03-25
2,1,1,0,Henderson,2022-03-26
1,1,0,0,Henderson,2022-03-27
6,2,4,0,Henderson,2022-03-28
4,1,3,0,Henderson,2022-03-29
2,0,2,0,Henderson,2022-03-30
8,2,6,0,Henderson,2022-03-31
3,1,2,0,Henderson,2022-04-01
2,0,2,0,Henderson,2022-04-02
3,1,2,0,Henderson,2022-04-03
3,3,0,0,Henderson,2022-04-04
5,1,4,0,Henderson,2022-04-05
4,3,1,0,Henderson,2022-04-06
2,0,2,0,Henderson,2022-04-07
5,3,2,0,Henderson,2022-04-08
2,0,2,0,Henderson,2022-04-09
2,1,1,0,Henderson,2022-04-10
13,2,11,0,Henderson,2022-04-11
24,5,19,0,Henderson,2022-04-12
15,4,11,0,Henderson,2022-04-13
5,0,5,0,Henderson,2022-04-14
13,2,11,0,Henderson,2022-04-15
4,4,0,0,Henderson,2022-04-16
3,0,3,0,Henderson,2022-04-17
13,6,7,0,Henderson,2022-04-18
13,4,9,0,Henderson,2022-04-19
12,4,8,0,Henderson,2022-04-20
13,7,6,0,Henderson,2022-04-21
11,3,8,0,Henderson,2022-04-22
9,3,6,0,Henderson,2022-04-23
5,4,1,0,Henderson,2022-04-24
17,8,9,0,Henderson,2022-04-25
12,7,5,0,Henderson,2022-04-27
10,7,3,0,Henderson,2022-04-28
14,6,8,0,Henderson,2022-04-29
12,6,6,0,Henderson,2022-04-30
6,1,5,0,Henderson,2022-05-01
20,10,10,0,Henderson,2022-05-02
18,6,12,0,Henderson,2022-05-03
22,11,11,0,Henderson,2022-05-04
16,5,11,0,Henderson,2022-05-05
13,7,6,0,Henderson,2022-05-06
15,7,8,0,Henderson,2022-05-07
17,9,8,0,Henderson,2022-05-08
32,14,18,0,Henderson,2022-05-09
26,10,16,0,Henderson,2022-05-10
28,8,20,0,Henderson,2022-05-11
22,10,12,0,Henderson,2022-05-12
17,5,12,0,Henderson,2022-05-14
60,35,25,0,Henderson,2022-05-16
30,9,21,0,Henderson,2022-05-17
47,17,30,0,Henderson,2022-05-18
44,21,23,0,Henderson,2022-05-19
39,12,27,0,Henderson,2022-05-20
14,2,12,0,Henderson,2022-05-21
23,9,14,0,Henderson,2022-05-22
38,11,27,0,Henderson,2022-05-23
33,5,28,0,Henderson,2022-05-24
24,10,14,0,Henderson,2022-05-26
30,16,14,0,Henderson,2022-05-27
16,7,9,0,Henderson,2022-05-28
17,9,8,0,Henderson,2022-05-29
19,11,8,0,Henderson,2022-05-30
29,7,22,0,Henderson,2022-05-31
28,12,16,0,Henderson,2022-06-01
25,4,21,0,Henderson,2022-06-02
21,11,10,0,Henderson,2022-06-03
17,9,8,0,Henderson,2022-06-04
3,1,2,0,Hertford,2021-12-07
5,2,3,0,Hertford,2021-12-08
7,1,6,0,Hertford,2021-12-09
3,0,3,0,Hertford,2021-12-10
3,0,3,0,Hertford,2021-12-11
2,0,2,0,Hertford,2021-12-12
7,1,6,0,Hertford,2021-12-13
3,1,2,0,Hertford,2021-12-14
4,0,4,0,Hertford,2021-12-17
2,1,1,0,Hertford,2021-12-18
1,0,1,0,Hertford,2021-12-19
9,1,8,0,Hertford,2021-12-20
6,3,3,0,Hertford,2021-12-21
2,2,0,0,Hertford,2021-12-22
7,1,6,0,Hertford,2021-12-23
7,0,7,0,Hertford,2021-12-24
2,0,2,0,Hertford,2021-12-25
11,0,11,0,Hertford,2021-12-26
18,5,13,0,Hertford,2021-12-27
48,6,42,0,Hertford,2021-12-28
62,27,35,0,Hertford,2021-12-29
54,8,46,0,Hertford,2021-12-30
64,8,56,0,Hertford,2021-12-31
9,0,9,0,Hertford,2022-01-01
88,18,70,0,Hertford,2022-01-03
107,40,67,0,Hertford,2022-01-04
70,10,60,0,Hertford,2022-01-07
33,6,27,0,Hertford,2022-01-08
14,0,14,0,Hertford,2022-01-09
107,24,83,0,Hertford,2022-01-10
78,15,63,0,Hertford,2022-01-11
76,19,57,0,Hertford,2022-01-12
66,10,56,0,Hertford,2022-01-14
11,1,10,0,Hertford,2022-01-16
23,4,19,0,Hertford,2022-01-17
82,13,69,0,Hertford,2022-01-18
10,0,10,0,Hertford,2022-01-21
6,1,5,0,Hertford,2022-01-23
52,12,40,0,Hertford,2022-01-24
38,9,29,0,Hertford,2022-01-25
23,6,17,0,Hertford,2022-01-26
18,3,15,0,Hertford,2022-01-27
2,0,2,0,Hertford,2022-01-29
4,1,3,0,Hertford,2022-01-30
12,3,9,0,Hertford,2022-02-01
5,3,2,0,Hertford,2022-02-02
6,1,5,0,Hertford,2022-02-03
3,0,3,0,Hertford,2022-02-04
2,0,2,0,Hertford,2022-02-05
5,0,5,0,Hertford,2022-02-06
5,3,2,0,Hertford,2022-02-07
7,1,6,0,Hertford,2022-02-08
6,2,4,0,Hertford,2022-02-09
4,0,4,0,Hertford,2022-02-10
1,0,1,0,Hertford,2022-02-12
2,0,2,0,Hertford,2022-02-13
0,0,0,0,Hertford,2022-02-14
1,0,1,0,Hertford,2022-02-15
4,0,4,0,Hertford,2022-02-17
3,0,3,0,Hertford,2022-02-18
4,0,4,0,Hertford,2022-02-19
1,1,0,0,Hertford,2022-02-20
6,1,5,0,Hertford,2022-02-21
2,1,1,0,Hertford,2022-02-22
2,1,1,0,Hertford,2022-02-23
2,0,2,0,Hertford,2022-02-24
3,0,3,0,Hertford,2022-02-25
4,1,3,0,Hertford,2022-02-26
3,1,2,0,Hertford,2022-02-27
0,0,0,0,Hertford,2022-02-28
2,0,2,0,Hertford,2022-03-01
3,0,3,0,Hertford,2022-03-02
2,0,2,0,Hertford,2022-03-03
3,1,2,0,Hertford,2022-03-04
0,0,0,0,Hertford,2022-03-05
0,0,0,0,Hertford,2022-03-06
1,0,1,0,Hertford,2022-03-07
0,0,0,0,Hertford,2022-03-08
0,0,0,0,Hertford,2022-03-09
2,0,2,0,Hertford,2022-03-10
1,0,1,0,Hertford,2022-03-11
0,0,0,0,Hertford,2022-03-12
0,0,0,0,Hertford,2022-03-13
0,0,0,0,Hertford,2022-03-14
0,0,0,0,Hertford,2022-03-15
0,0,0,0,Hertford,2022-03-16
0,0,0,0,Hertford,2022-03-17
0,0,0,0,Hertford,2022-03-18
0,0,0,0,Hertford,2022-03-19
0,0,0,0,Hertford,2022-03-20
1,0,1,0,Hertford,2022-03-21
0,0,0,0,Hertford,2022-03-22
1,0,1,0,Hertford,2022-03-23
0,0,0,0,Hertford,2022-03-24
3,0,3,0,Hertford,2022-03-25
0,0,0,0,Hertford,2022-03-26
0,0,0,0,Hertford,2022-03-27
1,0,1,0,Hertford,2022-03-28
1,0,1,0,Hertford,2022-03-29
0,0,0,0,Hertford,2022-03-30
0,0,0,0,Hertford,2022-03-31
0,0,0,0,Hertford,2022-04-01
0,0,0,0,Hertford,2022-04-02
0,0,0,0,Hertford,2022-04-03
0,0,0,0,Hertford,2022-04-04
0,0,0,0,Hertford,2022-04-06
0,0,0,0,Hertford,2022-04-07
1,0,1,0,Hertford,2022-04-08
0,0,0,0,Hertford,2022-04-09
1,0,1,0,Hertford,2022-04-10
1,0,1,0,Hertford,2022-04-11
1,1,0,0,Hertford,2022-04-12
1,0,1,0,Hertford,2022-04-13
2,0,2,0,Hertford,2022-04-14
2,0,2,0,Hertford,2022-04-15
1,0,1,0,Hertford,2022-04-16
0,0,0,0,Hertford,2022-04-17
1,0,1,0,Hertford,2022-04-18
0,0,0,0,Hertford,2022-04-19
2,0,2,0,Hertford,2022-04-20
0,0,0,0,Hertford,2022-04-21
0,0,0,0,Hertford,2022-04-22
1,0,1,0,Hertford,2022-04-23
1,0,1,0,Hertford,2022-04-24
1,0,1,0,Hertford,2022-04-25
2,1,1,0,Hertford,2022-04-26
0,0,0,0,Hertford,2022-04-27
2,0,2,0,Hertford,2022-04-28
1,0,1,0,Hertford,2022-04-29
1,0,1,0,Hertford,2022-04-30
0,0,0,0,Hertford,2022-05-01
2,1,1,0,Hertford,2022-05-02
1,0,1,0,Hertford,2022-05-03
1,1,0,0,Hertford,2022-05-04
7,1,6,0,Hertford,2022-05-05
2,1,1,0,Hertford,2022-05-06
1,0,1,0,Hertford,2022-05-07
1,0,1,0,Hertford,2022-05-08
5,3,2,0,Hertford,2022-05-09
3,0,3,0,Hertford,2022-05-10
0,0,0,0,Hertford,2022-05-11
8,2,6,0,Hertford,2022-05-12
4,1,3,0,Hertford,2022-05-13
0,0,0,0,Hertford,2022-05-14
0,0,0,0,Hertford,2022-05-15
6,0,6,0,Hertford,2022-05-16
3,0,3,0,Hertford,2022-05-17
5,1,4,0,Hertford,2022-05-18
9,4,5,0,Hertford,2022-05-19
2,0,2,0,Hertford,2022-05-20
3,0,3,0,Hertford,2022-05-21
2,0,2,0,Hertford,2022-05-22
6,0,6,0,Hertford,2022-05-23
3,2,1,0,Hertford,2022-05-24
8,2,6,0,Hertford,2022-05-25
3,1,2,0,Hertford,2022-05-26
1,0,1,0,Hertford,2022-05-27
4,0,4,0,Hertford,2022-05-28
3,2,1,0,Hertford,2022-05-29
1,0,1,0,Hertford,2022-05-30
22,6,16,0,Hertford,2022-05-31
9,3,6,0,Hertford,2022-06-01
8,1,7,0,Hertford,2022-06-02
2,0,2,0,Hertford,2022-06-03
4,1,3,0,Hertford,2022-06-04
9,1,8,0,Hoke,2021-12-09
5,0,5,0,Hoke,2021-12-11
0,0,0,0,Hoke,2021-12-12
20,4,16,0,Hoke,2021-12-15
20,2,18,0,Hoke,2021-12-17
9,5,4,0,Hoke,2021-12-18
12,1,11,0,Hoke,2021-12-19
19,4,15,0,Hoke,2021-12-20
43,12,31,0,Hoke,2021-12-21
40,8,32,0,Hoke,2021-12-22
46,12,34,0,Hoke,2021-12-23
27,4,23,0,Hoke,2021-12-24
19,2,17,0,Hoke,2021-12-25
35,6,29,0,Hoke,2021-12-26
93,9,84,0,Hoke,2021-12-27
135,6,129,0,Hoke,2021-12-28
146,8,138,0,Hoke,2021-12-29
159,31,128,0,Hoke,2021-12-30
102,12,90,0,Hoke,2021-12-31
79,1,78,0,Hoke,2022-01-02
172,13,159,0,Hoke,2022-01-03
252,26,226,0,Hoke,2022-01-04
263,24,239,0,Hoke,2022-01-06
212,13,199,0,Hoke,2022-01-07
380,46,334,0,Hoke,2022-01-10
351,34,317,0,Hoke,2022-01-11
246,19,227,0,Hoke,2022-01-14
19,1,18,0,Hoke,2022-01-16
280,31,249,0,Hoke,2022-01-17
382,36,346,0,Hoke,2022-01-18
92,11,81,0,Hoke,2022-01-21
22,2,20,0,Hoke,2022-01-22
64,5,59,0,Hoke,2022-01-23
164,22,142,0,Hoke,2022-01-25
27,2,25,0,Hoke,2022-01-29
19,2,17,0,Hoke,2022-01-30
78,19,59,0,Hoke,2022-01-31
15,3,12,0,Hoke,2022-02-05
20,4,16,0,Hoke,2022-02-06
45,12,33,0,Hoke,2022-02-07
39,10,29,0,Hoke,2022-02-08
36,9,27,0,Hoke,2022-02-09
22,7,15,0,Hoke,2022-02-10
20,7,13,0,Hoke,2022-02-11
12,1,11,0,Hoke,2022-02-12
8,2,6,0,Hoke,2022-02-13
30,5,25,0,Hoke,2022-02-14
26,6,20,0,Hoke,2022-02-15
19,1,18,0,Hoke,2022-02-16
3,0,3,0,Hoke,2022-02-19
11,1,10,0,Hoke,2022-02-21
14,3,11,0,Hoke,2022-02-22
10,2,8,0,Hoke,2022-02-23
10,3,7,0,Hoke,2022-02-24
7,0,7,0,Hoke,2022-02-25
3,0,3,0,Hoke,2022-02-26
5,3,2,0,Hoke,2022-02-27
5,3,2,0,Hoke,2022-03-02
10,2,8,0,Hoke,2022-03-03
3,0,3,0,Hoke,2022-03-04
2,0,2,0,Hoke,2022-03-05
1,1,0,0,Hoke,2022-03-06
5,0,5,0,Hoke,2022-03-07
3,1,2,0,Hoke,2022-03-09
4,0,4,0,Hoke,2022-03-10
4,0,4,0,Hoke,2022-03-11
1,1,0,0,Hoke,2022-03-12
1,0,1,0,Hoke,2022-03-13
1,0,1,0,Hoke,2022-03-14
2,1,1,0,Hoke,2022-03-15
2,1,1,0,Hoke,2022-03-16
1,0,1,0,Hoke,2022-03-17
0,0,0,0,Hoke,2022-03-18
1,0,1,0,Hoke,2022-03-19
0,0,0,0,Hoke,2022-03-20
2,0,2,0,Hoke,2022-03-21
3,0,3,0,Hoke,2022-03-22
1,0,1,0,Hoke,2022-03-23
2,0,2,0,Hoke,2022-03-24
2,0,2,0,Hoke,2022-03-25
3,1,2,0,Hoke,2022-03-26
0,0,0,0,Hoke,2022-03-27
1,0,1,0,Hoke,2022-03-28
3,0,3,0,Hoke,2022-03-29
2,2,0,0,Hoke,2022-03-30
1,0,1,0,Hoke,2022-03-31
3,2,1,0,Hoke,2022-04-01
3,0,3,0,Hoke,2022-04-02
2,0,2,0,Hoke,2022-04-03
1,1,0,0,Hoke,2022-04-05
4,0,4,0,Hoke,2022-04-06
1,0,1,0,Hoke,2022-04-07
2,0,2,0,Hoke,2022-04-08
2,1,1,0,Hoke,2022-04-09
0,0,0,0,Hoke,2022-04-10
4,0,4,0,Hoke,2022-04-11
3,1,2,0,Hoke,2022-04-12
6,3,3,0,Hoke,2022-04-13
8,4,4,0,Hoke,2022-04-14
3,2,1,0,Hoke,2022-04-15
3,0,3,0,Hoke,2022-04-16
2,0,2,0,Hoke,2022-04-17
9,1,8,0,Hoke,2022-04-18
2,1,1,0,Hoke,2022-04-19
3,0,3,0,Hoke,2022-04-20
4,1,3,0,Hoke,2022-04-21
2,0,2,0,Hoke,2022-04-22
4,2,2,0,Hoke,2022-04-23
4,1,3,0,Hoke,2022-04-24
9,2,7,0,Hoke,2022-04-25
10,2,8,0,Hoke,2022-04-26
12,3,9,0,Hoke,2022-04-27
9,1,8,0,Hoke,2022-04-28
7,1,6,0,Hoke,2022-04-29
6,0,6,0,Hoke,2022-04-30
5,3,2,0,Hoke,2022-05-01
24,10,14,0,Hoke,2022-05-02
13,8,5,0,Hoke,2022-05-03
20,4,16,0,Hoke,2022-05-04
14,6,8,0,Hoke,2022-05-05
12,3,9,0,Hoke,2022-05-06
9,2,7,0,Hoke,2022-05-07
7,3,4,0,Hoke,2022-05-08
25,11,14,0,Hoke,2022-05-09
18,3,15,0,Hoke,2022-05-10
16,7,9,0,Hoke,2022-05-11
24,7,17,0,Hoke,2022-05-12
12,3,9,0,Hoke,2022-05-13
4,1,3,0,Hoke,2022-05-14
17,8,9,0,Hoke,2022-05-15
35,8,27,0,Hoke,2022-05-16
27,6,21,0,Hoke,2022-05-17
31,6,25,0,Hoke,2022-05-18
22,2,20,0,Hoke,2022-05-19
13,2,11,0,Hoke,2022-05-20
13,3,10,0,Hoke,2022-05-21
6,0,6,0,Hoke,2022-05-22
26,7,19,0,Hoke,2022-05-23
26,6,20,0,Hoke,2022-05-24
33,7,26,0,Hoke,2022-05-25
22,5,17,0,Hoke,2022-05-26
10,2,8,0,Hoke,2022-05-27
14,1,13,0,Hoke,2022-05-28
9,2,7,0,Hoke,2022-05-29
13,5,8,0,Hoke,2022-05-30
40,14,26,0,Hoke,2022-05-31
27,9,18,0,Hoke,2022-06-01
20,5,15,0,Hoke,2022-06-02
8,2,6,0,Hoke,2022-06-03
6,0,6,0,Hoke,2022-06-04
1,0,1,0,Hyde,2021-12-07
0,0,0,0,Hyde,2021-12-09
2,1,1,0,Hyde,2021-12-10
0,0,0,0,Hyde,2021-12-11
0,0,0,0,Hyde,2021-12-12
5,0,5,0,Hyde,2021-12-13
0,0,0,0,Hyde,2021-12-14
1,1,0,0,Hyde,2021-12-15
1,0,1,0,Hyde,2021-12-16
2,0,2,0,Hyde,2021-12-17
2,0,2,0,Hyde,2021-12-18
0,0,0,0,Hyde,2021-12-19
3,0,3,0,Hyde,2021-12-20
0,0,0,0,Hyde,2021-12-21
2,1,1,0,Hyde,2021-12-22
1,0,1,0,Hyde,2021-12-23
1,0,1,0,Hyde,2021-12-24
0,0,0,0,Hyde,2021-12-25
1,0,1,0,Hyde,2021-12-26
6,0,6,0,Hyde,2021-12-27
4,0,4,0,Hyde,2021-12-28
4,0,4,0,Hyde,2021-12-29
1,0,1,0,Hyde,2021-12-31
1,0,1,0,Hyde,2022-01-01
4,0,4,0,Hyde,2022-01-02
21,0,21,0,Hyde,2022-01-03
13,0,13,0,Hyde,2022-01-04
8,0,8,0,Hyde,2022-01-05
13,1,12,0,Hyde,2022-01-07
2,0,2,0,Hyde,2022-01-08
3,0,3,0,Hyde,2022-01-09
13,1,12,0,Hyde,2022-01-10
11,0,11,0,Hyde,2022-01-11
12,0,12,0,Hyde,2022-01-13
50,14,36,0,Hyde,2022-01-14
4,0,4,0,Hyde,2022-01-15
7,1,6,0,Hyde,2022-01-17
24,1,23,0,Hyde,2022-01-18
18,2,16,0,Hyde,2022-01-19
13,2,11,0,Hyde,2022-01-20
6,1,5,0,Hyde,2022-01-21
1,0,1,0,Hyde,2022-01-22
3,0,3,0,Hyde,2022-01-23
19,3,16,0,Hyde,2022-01-24
11,0,11,0,Hyde,2022-01-25
7,0,7,0,Hyde,2022-01-26
11,3,8,0,Hyde,2022-01-27
6,1,5,0,Hyde,2022-01-28
2,0,2,0,Hyde,2022-01-29
3,0,3,0,Hyde,2022-01-30
18,0,18,0,Hyde,2022-01-31
10,1,9,0,Hyde,2022-02-01
4,0,4,0,Hyde,2022-02-02
5,1,4,0,Hyde,2022-02-03
5,0,5,0,Hyde,2022-02-04
1,1,0,0,Hyde,2022-02-05
0,0,0,0,Hyde,2022-02-06
7,0,7,0,Hyde,2022-02-07
2,0,2,0,Hyde,2022-02-08
1,0,1,0,Hyde,2022-02-09
3,0,3,0,Hyde,2022-02-10
5,0,5,0,Hyde,2022-02-11
3,0,3,0,Hyde,2022-02-12
0,0,0,0,Hyde,2022-02-13
2,0,2,0,Hyde,2022-02-14
2,0,2,0,Hyde,2022-02-15
0,0,0,0,Hyde,2022-02-16
3,0,3,0,Hyde,2022-02-17
1,0,1,0,Hyde,2022-02-18
0,0,0,0,Hyde,2022-02-19
0,0,0,0,Hyde,2022-02-20
4,1,3,0,Hyde,2022-02-21
3,0,3,0,Hyde,2022-02-22
1,1,0,0,Hyde,2022-02-23
0,0,0,0,Hyde,2022-02-24
1,0,1,0,Hyde,2022-02-25
1,0,1,0,Hyde,2022-02-26
0,0,0,0,Hyde,2022-02-27
0,0,0,0,Hyde,2022-02-28
1,0,1,0,Hyde,2022-03-01
0,0,0,0,Hyde,2022-03-02
1,0,1,0,Hyde,2022-03-03
1,0,1,0,Hyde,2022-03-04
0,0,0,0,Hyde,2022-03-05
0,0,0,0,Hyde,2022-03-06
1,0,1,0,Hyde,2022-03-07
0,0,0,0,Hyde,2022-03-08
0,0,0,0,Hyde,2022-03-09
1,0,1,0,Hyde,2022-03-10
0,0,0,0,Hyde,2022-03-11
0,0,0,0,Hyde,2022-03-12
1,0,1,0,Hyde,2022-03-13
0,0,0,0,Hyde,2022-03-14
0,0,0,0,Hyde,2022-03-15
0,0,0,0,Hyde,2022-03-16
0,0,0,0,Hyde,2022-03-17
0,0,0,0,Hyde,2022-03-18
0,0,0,0,Hyde,2022-03-19
0,0,0,0,Hyde,2022-03-20
0,0,0,0,Hyde,2022-03-21
1,0,1,0,Hyde,2022-03-22
0,0,0,0,Hyde,2022-03-23
0,0,0,0,Hyde,2022-03-24
0,0,0,0,Hyde,2022-03-25
0,0,0,0,Hyde,2022-03-26
0,0,0,0,Hyde,2022-03-27
0,0,0,0,Hyde,2022-03-28
0,0,0,0,Hyde,2022-03-29
0,0,0,0,Hyde,2022-03-30
0,0,0,0,Hyde,2022-03-31
0,0,0,0,Hyde,2022-04-01
0,0,0,0,Hyde,2022-04-02
0,0,0,0,Hyde,2022-04-03
0,0,0,0,Hyde,2022-04-04
0,0,0,0,Hyde,2022-04-05
0,0,0,0,Hyde,2022-04-06
0,0,0,0,Hyde,2022-04-07
0,0,0,0,Hyde,2022-04-08
0,0,0,0,Hyde,2022-04-09
0,0,0,0,Hyde,2022-04-10
1,0,1,0,Hyde,2022-04-11
1,0,1,0,Hyde,2022-04-12
1,0,1,0,Hyde,2022-04-13
0,0,0,0,Hyde,2022-04-14
0,0,0,0,Hyde,2022-04-15
0,0,0,0,Hyde,2022-04-16
0,0,0,0,Hyde,2022-04-17
1,1,0,0,Hyde,2022-04-18
0,0,0,0,Hyde,2022-04-19
1,0,1,0,Hyde,2022-04-20
0,0,0,0,Hyde,2022-04-21
2,0,2,0,Hyde,2022-04-22
0,0,0,0,Hyde,2022-04-23
0,0,0,0,Hyde,2022-04-24
0,0,0,0,Hyde,2022-04-25
1,0,1,0,Hyde,2022-04-26
0,0,0,0,Hyde,2022-04-27
0,0,0,0,Hyde,2022-04-28
4,0,4,0,Hyde,2022-04-29
0,0,0,0,Hyde,2022-04-30
0,0,0,0,Hyde,2022-05-01
8,0,8,0,Hyde,2022-05-02
6,0,6,0,Hyde,2022-05-03
3,1,2,0,Hyde,2022-05-04
0,0,0,0,Hyde,2022-05-05
2,0,2,0,Hyde,2022-05-06
0,0,0,0,Hyde,2022-05-07
0,0,0,0,Hyde,2022-05-08
3,2,1,0,Hyde,2022-05-09
6,0,6,0,Hyde,2022-05-10
3,0,3,0,Hyde,2022-05-11
2,0,2,0,Hyde,2022-05-12
3,0,3,0,Hyde,2022-05-13
0,0,0,0,Hyde,2022-05-14
2,0,2,0,Hyde,2022-05-15
15,0,15,0,Hyde,2022-05-16
1,0,1,0,Hyde,2022-05-17
5,0,5,0,Hyde,2022-05-18
4,0,4,0,Hyde,2022-05-19
5,0,5,0,Hyde,2022-05-20
0,0,0,0,Hyde,2022-05-21
1,0,1,0,Hyde,2022-05-22
5,0,5,0,Hyde,2022-05-23
1,0,1,0,Hyde,2022-05-24
1,0,1,0,Hyde,2022-05-25
8,0,8,0,Hyde,2022-05-26
0,0,0,0,Hyde,2022-05-27
0,0,0,0,Hyde,2022-05-28
0,0,0,0,Hyde,2022-05-29
3,0,3,0,Hyde,2022-05-30
7,0,7,0,Hyde,2022-05-31
4,0,4,0,Hyde,2022-06-01
3,0,3,0,Hyde,2022-06-02
0,0,0,0,Hyde,2022-06-03
0,0,0,0,Hyde,2022-06-04
103,42,61,0,Iredell,2021-12-09
46,9,37,0,Iredell,2021-12-11
104,37,67,0,Iredell,2021-12-15
164,65,99,0,Iredell,2021-12-23
44,14,30,0,Iredell,2021-12-25
217,92,125,0,Iredell,2021-12-31
675,213,462,0,Iredell,2022-01-11
70,24,46,0,Iredell,2022-02-06
162,45,117,0,Iredell,2022-02-07
16,7,9,0,Iredell,2022-02-25
12,10,2,0,Iredell,2022-02-26
14,8,6,0,Iredell,2022-02-27
21,8,13,0,Iredell,2022-03-01
21,9,12,0,Iredell,2022-03-02
6,4,2,0,Iredell,2022-03-04
8,1,7,0,Iredell,2022-03-06
11,2,9,0,Iredell,2022-03-07
11,5,6,0,Iredell,2022-03-09
3,0,3,0,Iredell,2022-03-10
6,4,2,0,Iredell,2022-03-11
3,0,3,0,Iredell,2022-03-13
20,13,7,0,Iredell,2022-03-14
7,2,5,0,Iredell,2022-03-15
6,2,4,0,Iredell,2022-03-16
6,3,3,0,Iredell,2022-03-17
5,1,4,0,Iredell,2022-03-18
10,7,3,0,Iredell,2022-03-19
5,1,4,0,Iredell,2022-03-20
13,8,5,0,Iredell,2022-03-21
8,3,5,0,Iredell,2022-03-22
6,2,4,0,Iredell,2022-03-23
10,4,6,0,Iredell,2022-03-24
2,1,1,0,Iredell,2022-03-25
6,3,3,0,Iredell,2022-03-26
6,5,1,0,Iredell,2022-03-27
8,5,3,0,Iredell,2022-03-28
6,3,3,0,Iredell,2022-03-29
6,4,2,0,Iredell,2022-03-30
8,5,3,0,Iredell,2022-03-31
5,3,2,0,Iredell,2022-04-01
2,0,2,0,Iredell,2022-04-03
10,4,6,0,Iredell,2022-04-04
12,7,5,0,Iredell,2022-04-05
7,4,3,0,Iredell,2022-04-06
8,4,4,0,Iredell,2022-04-07
10,5,5,0,Iredell,2022-04-08
10,4,6,0,Iredell,2022-04-09
13,6,7,0,Iredell,2022-04-10
23,7,16,0,Iredell,2022-04-11
18,8,10,0,Iredell,2022-04-12
28,12,16,0,Iredell,2022-04-13
23,11,12,0,Iredell,2022-04-14
11,1,10,0,Iredell,2022-04-15
10,4,6,0,Iredell,2022-04-16
13,7,6,0,Iredell,2022-04-17
28,16,12,0,Iredell,2022-04-18
26,14,12,0,Iredell,2022-04-19
24,5,19,0,Iredell,2022-04-20
30,10,20,0,Iredell,2022-04-21
25,2,23,0,Iredell,2022-04-22
9,2,7,0,Iredell,2022-04-23
22,6,16,0,Iredell,2022-04-24
32,18,14,0,Iredell,2022-04-25
23,8,15,0,Iredell,2022-04-26
34,12,22,0,Iredell,2022-04-27
26,17,9,0,Iredell,2022-04-28
36,8,28,0,Iredell,2022-04-29
10,4,6,0,Iredell,2022-04-30
13,6,7,0,Iredell,2022-05-01
41,16,25,0,Iredell,2022-05-02
45,21,24,0,Iredell,2022-05-03
42,20,22,0,Iredell,2022-05-04
26,13,13,0,Iredell,2022-05-05
36,10,26,0,Iredell,2022-05-06
22,8,14,0,Iredell,2022-05-07
20,11,9,0,Iredell,2022-05-08
51,22,29,0,Iredell,2022-05-09
49,23,26,0,Iredell,2022-05-10
54,22,32,0,Iredell,2022-05-11
41,12,29,0,Iredell,2022-05-12
37,10,27,0,Iredell,2022-05-13
33,9,24,0,Iredell,2022-05-14
72,31,41,0,Iredell,2022-05-16
77,31,46,0,Iredell,2022-05-17
69,30,39,0,Iredell,2022-05-18
82,31,51,0,Iredell,2022-05-19
55,22,33,0,Iredell,2022-05-20
46,19,27,0,Iredell,2022-05-22
64,26,38,0,Iredell,2022-05-24
60,33,27,0,Iredell,2022-05-26
55,11,44,0,Iredell,2022-05-27
38,19,19,0,Iredell,2022-05-28
44,16,28,0,Iredell,2022-05-29
34,15,19,0,Iredell,2022-05-30
78,30,48,0,Iredell,2022-05-31
75,32,43,0,Iredell,2022-06-01
62,25,37,0,Iredell,2022-06-02
54,16,38,0,Iredell,2022-06-03
31,18,13,0,Iredell,2022-06-04
7,1,6,0,Jackson,2021-12-09
10,1,9,0,Jackson,2021-12-10
8,1,7,0,Jackson,2021-12-12
9,1,8,0,Jackson,2021-12-18
8,4,4,0,Jackson,2021-12-19
16,3,13,0,Jackson,2021-12-20
25,7,18,0,Jackson,2021-12-22
17,2,15,0,Jackson,2021-12-23
8,1,7,0,Jackson,2021-12-24
4,1,3,0,Jackson,2021-12-25
27,5,22,0,Jackson,2021-12-26
50,11,39,0,Jackson,2021-12-27
64,11,53,0,Jackson,2021-12-29
66,6,60,0,Jackson,2021-12-30
26,11,15,0,Jackson,2021-12-31
53,7,46,0,Jackson,2022-01-02
104,8,96,0,Jackson,2022-01-03
39,3,36,0,Jackson,2022-01-08
52,5,47,0,Jackson,2022-01-09
134,38,96,0,Jackson,2022-01-10
106,15,91,0,Jackson,2022-01-11
108,17,91,0,Jackson,2022-01-12
123,16,107,0,Jackson,2022-01-13
6,0,6,0,Jackson,2022-01-16
37,4,33,0,Jackson,2022-01-17
103,26,77,0,Jackson,2022-01-18
122,30,92,0,Jackson,2022-01-20
39,4,35,0,Jackson,2022-01-22
26,4,22,0,Jackson,2022-01-23
123,47,76,0,Jackson,2022-01-24
114,38,76,0,Jackson,2022-01-25
43,15,28,0,Jackson,2022-01-28
6,1,5,0,Jackson,2022-01-29
31,7,24,0,Jackson,2022-01-30
67,16,51,0,Jackson,2022-01-31
54,12,42,0,Jackson,2022-02-01
43,17,26,0,Jackson,2022-02-02
44,14,30,0,Jackson,2022-02-03
12,2,10,0,Jackson,2022-02-05
10,2,8,0,Jackson,2022-02-06
42,11,31,0,Jackson,2022-02-07
25,6,19,0,Jackson,2022-02-08
28,3,25,0,Jackson,2022-02-09
29,3,26,0,Jackson,2022-02-10
7,1,6,0,Jackson,2022-02-12
3,0,3,0,Jackson,2022-02-13
29,9,20,0,Jackson,2022-02-15
28,11,17,0,Jackson,2022-02-16
18,7,11,0,Jackson,2022-02-17
14,7,7,0,Jackson,2022-02-18
7,4,3,0,Jackson,2022-02-19
8,4,4,0,Jackson,2022-02-20
11,5,6,0,Jackson,2022-02-21
17,6,11,0,Jackson,2022-02-23
10,3,7,0,Jackson,2022-02-24
7,0,7,0,Jackson,2022-02-26
12,5,7,0,Jackson,2022-02-28
12,3,9,0,Jackson,2022-03-01
5,1,4,0,Jackson,2022-03-04
0,0,0,0,Jackson,2022-03-05
0,0,0,0,Jackson,2022-03-06
1,0,1,0,Jackson,2022-03-07
2,0,2,0,Jackson,2022-03-08
3,0,3,0,Jackson,2022-03-09
3,0,3,0,Jackson,2022-03-10
0,0,0,0,Jackson,2022-03-11
1,0,1,0,Jackson,2022-03-12
0,0,0,0,Jackson,2022-03-13
2,2,0,0,Jackson,2022-03-14
3,1,2,0,Jackson,2022-03-15
0,0,0,0,Jackson,2022-03-16
2,0,2,0,Jackson,2022-03-17
2,1,1,0,Jackson,2022-03-18
0,0,0,0,Jackson,2022-03-19
1,1,0,0,Jackson,2022-03-20
2,2,0,0,Jackson,2022-03-22
2,1,1,0,Jackson,2022-03-23
2,1,1,0,Jackson,2022-03-24
3,1,2,0,Jackson,2022-03-25
0,0,0,0,Jackson,2022-03-26
1,1,0,0,Jackson,2022-03-28
2,1,1,0,Jackson,2022-03-29
1,1,0,0,Jackson,2022-03-30
0,0,0,0,Jackson,2022-03-31
0,0,0,0,Jackson,2022-04-01
0,0,0,0,Jackson,2022-04-02
2,0,2,0,Jackson,2022-04-03
1,0,1,0,Jackson,2022-04-04
2,0,2,0,Jackson,2022-04-05
1,0,1,0,Jackson,2022-04-06
5,3,2,0,Jackson,2022-04-07
2,1,1,0,Jackson,2022-04-08
4,1,3,0,Jackson,2022-04-09
1,0,1,0,Jackson,2022-04-10
1,1,0,0,Jackson,2022-04-11
1,0,1,0,Jackson,2022-04-12
3,0,3,0,Jackson,2022-04-13
2,0,2,0,Jackson,2022-04-14
3,1,2,0,Jackson,2022-04-16
0,0,0,0,Jackson,2022-04-17
6,2,4,0,Jackson,2022-04-18
2,0,2,0,Jackson,2022-04-19
6,1,5,0,Jackson,2022-04-20
4,1,3,0,Jackson,2022-04-21
4,2,2,0,Jackson,2022-04-22
0,0,0,0,Jackson,2022-04-23
3,1,2,0,Jackson,2022-04-24
8,1,7,0,Jackson,2022-04-25
7,1,6,0,Jackson,2022-04-26
3,1,2,0,Jackson,2022-04-27
4,3,1,0,Jackson,2022-04-28
5,1,4,0,Jackson,2022-04-29
2,1,1,0,Jackson,2022-04-30
2,0,2,0,Jackson,2022-05-01
10,5,5,0,Jackson,2022-05-03
8,2,6,0,Jackson,2022-05-04
3,1,2,0,Jackson,2022-05-05
7,4,3,0,Jackson,2022-05-06
5,2,3,0,Jackson,2022-05-07
4,0,4,0,Jackson,2022-05-08
12,5,7,0,Jackson,2022-05-09
11,4,7,0,Jackson,2022-05-10
0,0,0,0,Jackson,2022-05-11
6,0,6,0,Jackson,2022-05-12
13,3,10,0,Jackson,2022-05-13
5,0,5,0,Jackson,2022-05-14
4,1,3,0,Jackson,2022-05-15
17,6,11,0,Jackson,2022-05-16
7,0,7,0,Jackson,2022-05-17
13,2,11,0,Jackson,2022-05-18
17,3,14,0,Jackson,2022-05-19
8,3,5,0,Jackson,2022-05-20
5,1,4,0,Jackson,2022-05-21
4,0,4,0,Jackson,2022-05-22
12,1,11,0,Jackson,2022-05-23
9,0,9,0,Jackson,2022-05-24
5,2,3,0,Jackson,2022-05-25
10,0,10,0,Jackson,2022-05-26
17,4,13,0,Jackson,2022-05-27
6,3,3,0,Jackson,2022-05-28
6,1,5,0,Jackson,2022-05-29
5,1,4,0,Jackson,2022-05-30
9,6,3,0,Jackson,2022-05-31
13,2,11,0,Jackson,2022-06-01
6,2,4,0,Jackson,2022-06-02
6,0,6,0,Jackson,2022-06-03
4,0,4,0,Jackson,2022-06-04
84,27,57,0,Johnston,2021-12-09
85,22,63,0,Johnston,2021-12-10
65,19,46,0,Johnston,2021-12-11
51,11,40,0,Johnston,2021-12-12
121,31,90,0,Johnston,2021-12-14
106,23,83,0,Johnston,2021-12-16
112,17,95,0,Johnston,2021-12-17
56,13,43,0,Johnston,2021-12-19
142,21,121,0,Johnston,2021-12-21
179,24,155,0,Johnston,2021-12-23
83,16,67,0,Johnston,2021-12-24
122,24,98,0,Johnston,2021-12-26
401,49,352,0,Johnston,2021-12-27
298,35,263,0,Johnston,2021-12-31
172,18,154,0,Johnston,2022-01-01
876,83,793,0,Johnston,2022-01-05
703,97,606,0,Johnston,2022-01-07
1044,123,921,0,Johnston,2022-01-10
765,115,650,0,Johnston,2022-01-13
73,25,48,0,Johnston,2022-02-06
51,7,44,0,Johnston,2022-02-17
59,9,50,0,Johnston,2022-02-18
13,4,9,0,Johnston,2022-02-20
78,32,46,0,Johnston,2022-02-21
40,15,25,0,Johnston,2022-02-24
31,7,24,0,Johnston,2022-02-25
27,11,16,0,Johnston,2022-02-28
18,4,14,0,Johnston,2022-03-02
5,1,4,0,Johnston,2022-03-05
11,2,9,0,Johnston,2022-03-06
9,2,7,0,Johnston,2022-03-08
12,4,8,0,Johnston,2022-03-09
10,6,4,0,Johnston,2022-03-11
6,0,6,0,Johnston,2022-03-12
14,1,13,0,Johnston,2022-03-14
6,2,4,0,Johnston,2022-03-16
10,2,8,0,Johnston,2022-03-17
9,1,8,0,Johnston,2022-03-18
10,2,8,0,Johnston,2022-03-19
3,1,2,0,Johnston,2022-03-20
14,3,11,0,Johnston,2022-03-21
9,3,6,0,Johnston,2022-03-22
8,2,6,0,Johnston,2022-03-23
7,1,6,0,Johnston,2022-03-25
6,2,4,0,Johnston,2022-03-26
7,2,5,0,Johnston,2022-03-29
6,1,5,0,Johnston,2022-03-30
11,2,9,0,Johnston,2022-03-31
5,1,4,0,Johnston,2022-04-01
5,0,5,0,Johnston,2022-04-02
1,0,1,0,Johnston,2022-04-03
11,1,10,0,Johnston,2022-04-04
10,3,7,0,Johnston,2022-04-05
15,6,9,0,Johnston,2022-04-06
8,1,7,0,Johnston,2022-04-07
5,3,2,0,Johnston,2022-04-08
10,3,7,0,Johnston,2022-04-09
10,2,8,0,Johnston,2022-04-10
14,4,10,0,Johnston,2022-04-11
11,3,8,0,Johnston,2022-04-12
12,3,9,0,Johnston,2022-04-13
17,3,14,0,Johnston,2022-04-14
14,8,6,0,Johnston,2022-04-15
8,2,6,0,Johnston,2022-04-16
9,2,7,0,Johnston,2022-04-17
26,8,18,0,Johnston,2022-04-18
21,7,14,0,Johnston,2022-04-19
24,6,18,0,Johnston,2022-04-20
24,6,18,0,Johnston,2022-04-21
19,0,19,0,Johnston,2022-04-22
18,6,12,0,Johnston,2022-04-23
16,3,13,0,Johnston,2022-04-24
39,10,29,0,Johnston,2022-04-25
41,6,35,0,Johnston,2022-04-26
34,4,30,0,Johnston,2022-04-27
37,9,28,0,Johnston,2022-04-28
29,7,22,0,Johnston,2022-04-29
36,7,29,0,Johnston,2022-04-30
16,6,10,0,Johnston,2022-05-01
62,15,47,0,Johnston,2022-05-02
61,13,48,0,Johnston,2022-05-03
60,11,49,0,Johnston,2022-05-04
49,13,36,0,Johnston,2022-05-05
41,10,31,0,Johnston,2022-05-06
29,10,19,0,Johnston,2022-05-07
73,10,63,0,Johnston,2022-05-11
70,21,49,0,Johnston,2022-05-12
55,16,39,0,Johnston,2022-05-13
42,6,36,0,Johnston,2022-05-14
50,10,40,0,Johnston,2022-05-15
132,28,104,0,Johnston,2022-05-16
100,26,74,0,Johnston,2022-05-18
82,16,66,0,Johnston,2022-05-19
88,27,61,0,Johnston,2022-05-20
49,5,44,0,Johnston,2022-05-22
107,28,79,0,Johnston,2022-05-23
97,13,84,0,Johnston,2022-05-25
96,23,73,0,Johnston,2022-05-26
95,20,75,0,Johnston,2022-05-27
73,17,56,0,Johnston,2022-05-28
74,13,61,0,Johnston,2022-05-29
39,12,27,0,Johnston,2022-05-30
128,20,108,0,Johnston,2022-05-31
98,19,79,0,Johnston,2022-06-01
99,17,82,0,Johnston,2022-06-02
65,12,53,0,Johnston,2022-06-03
29,1,28,0,Johnston,2022-06-04
2,1,1,0,Jones,2021-12-07
0,0,0,0,Jones,2021-12-08
4,1,3,0,Jones,2021-12-09
0,0,0,0,Jones,2021-12-10
1,0,1,0,Jones,2021-12-11
1,0,1,0,Jones,2021-12-12
0,0,0,0,Jones,2021-12-14
2,1,1,0,Jones,2021-12-15
2,1,1,0,Jones,2021-12-16
1,0,1,0,Jones,2021-12-18
1,0,1,0,Jones,2021-12-19
0,0,0,0,Jones,2021-12-20
5,2,3,0,Jones,2021-12-21
2,1,1,0,Jones,2021-12-22
3,1,2,0,Jones,2021-12-23
2,2,0,0,Jones,2021-12-24
1,0,1,0,Jones,2021-12-25
5,0,5,0,Jones,2021-12-26
9,1,8,0,Jones,2021-12-27
10,1,9,0,Jones,2021-12-28
15,4,11,0,Jones,2021-12-29
15,3,12,0,Jones,2021-12-30
6,2,4,0,Jones,2021-12-31
5,2,3,0,Jones,2022-01-01
2,1,1,0,Jones,2022-01-02
25,9,16,0,Jones,2022-01-03
11,3,8,0,Jones,2022-01-04
23,12,11,0,Jones,2022-01-05
24,10,14,0,Jones,2022-01-07
14,3,11,0,Jones,2022-01-08
6,5,1,0,Jones,2022-01-09
44,19,25,0,Jones,2022-01-10
37,16,21,0,Jones,2022-01-11
24,7,17,0,Jones,2022-01-12
30,11,19,0,Jones,2022-01-13
26,10,16,0,Jones,2022-01-14
7,1,6,0,Jones,2022-01-16
30,16,14,0,Jones,2022-01-17
47,12,35,0,Jones,2022-01-18
25,12,13,0,Jones,2022-01-20
3,1,2,0,Jones,2022-01-21
1,0,1,0,Jones,2022-01-22
5,1,4,0,Jones,2022-01-23
42,18,24,0,Jones,2022-01-24
49,31,18,0,Jones,2022-01-25
21,5,16,0,Jones,2022-01-27
11,2,9,0,Jones,2022-01-28
3,1,2,0,Jones,2022-01-29
1,0,1,0,Jones,2022-01-30
21,11,10,0,Jones,2022-01-31
21,9,12,0,Jones,2022-02-01
2,1,1,0,Jones,2022-02-02
9,2,7,0,Jones,2022-02-03
6,2,4,0,Jones,2022-02-04
5,2,3,0,Jones,2022-02-05
1,0,1,0,Jones,2022-02-06
10,3,7,0,Jones,2022-02-07
1,1,0,0,Jones,2022-02-08
3,1,2,0,Jones,2022-02-09
5,2,3,0,Jones,2022-02-10
4,0,4,0,Jones,2022-02-11
0,0,0,0,Jones,2022-02-12
0,0,0,0,Jones,2022-02-13
7,1,6,0,Jones,2022-02-14
2,1,1,0,Jones,2022-02-15
2,1,1,0,Jones,2022-02-16
3,1,2,0,Jones,2022-02-17
3,2,1,0,Jones,2022-02-18
2,2,0,0,Jones,2022-02-19
1,0,1,0,Jones,2022-02-20
7,4,3,0,Jones,2022-02-21
3,0,3,0,Jones,2022-02-22
1,0,1,0,Jones,2022-02-23
1,0,1,0,Jones,2022-02-24
0,0,0,0,Jones,2022-02-25
0,0,0,0,Jones,2022-02-26
1,0,1,0,Jones,2022-02-27
1,0,1,0,Jones,2022-02-28
1,1,0,0,Jones,2022-03-01
0,0,0,0,Jones,2022-03-02
0,0,0,0,Jones,2022-03-03
1,0,1,0,Jones,2022-03-04
0,0,0,0,Jones,2022-03-05
0,0,0,0,Jones,2022-03-06
0,0,0,0,Jones,2022-03-07
1,1,0,0,Jones,2022-03-08
0,0,0,0,Jones,2022-03-09
0,0,0,0,Jones,2022-03-10
1,0,1,0,Jones,2022-03-11
0,0,0,0,Jones,2022-03-12
0,0,0,0,Jones,2022-03-13
0,0,0,0,Jones,2022-03-14
0,0,0,0,Jones,2022-03-15
0,0,0,0,Jones,2022-03-16
1,0,1,0,Jones,2022-03-17
0,0,0,0,Jones,2022-03-18
0,0,0,0,Jones,2022-03-19
0,0,0,0,Jones,2022-03-20
0,0,0,0,Jones,2022-03-21
0,0,0,0,Jones,2022-03-22
0,0,0,0,Jones,2022-03-23
0,0,0,0,Jones,2022-03-24
0,0,0,0,Jones,2022-03-25
0,0,0,0,Jones,2022-03-26
0,0,0,0,Jones,2022-03-27
0,0,0,0,Jones,2022-03-28
0,0,0,0,Jones,2022-03-29
0,0,0,0,Jones,2022-03-30
0,0,0,0,Jones,2022-03-31
0,0,0,0,Jones,2022-04-01
0,0,0,0,Jones,2022-04-02
1,0,1,0,Jones,2022-04-03
0,0,0,0,Jones,2022-04-04
0,0,0,0,Jones,2022-04-05
0,0,0,0,Jones,2022-04-06
0,0,0,0,Jones,2022-04-07
0,0,0,0,Jones,2022-04-08
0,0,0,0,Jones,2022-04-09
0,0,0,0,Jones,2022-04-10
0,0,0,0,Jones,2022-04-11
1,0,1,0,Jones,2022-04-12
0,0,0,0,Jones,2022-04-13
1,0,1,0,Jones,2022-04-14
0,0,0,0,Jones,2022-04-15
0,0,0,0,Jones,2022-04-16
0,0,0,0,Jones,2022-04-17
0,0,0,0,Jones,2022-04-18
0,0,0,0,Jones,2022-04-19
2,0,2,0,Jones,2022-04-20
0,0,0,0,Jones,2022-04-21
0,0,0,0,Jones,2022-04-22
0,0,0,0,Jones,2022-04-23
2,0,2,0,Jones,2022-04-24
2,0,2,0,Jones,2022-04-25
0,0,0,0,Jones,2022-04-26
0,0,0,0,Jones,2022-04-27
1,1,0,0,Jones,2022-04-28
1,0,1,0,Jones,2022-04-29
0,0,0,0,Jones,2022-04-30
0,0,0,0,Jones,2022-05-01
2,1,1,0,Jones,2022-05-02
0,0,0,0,Jones,2022-05-03
2,0,2,0,Jones,2022-05-04
1,1,0,0,Jones,2022-05-05
3,2,1,0,Jones,2022-05-06
2,1,1,0,Jones,2022-05-07
0,0,0,0,Jones,2022-05-08
1,1,0,0,Jones,2022-05-09
3,1,2,0,Jones,2022-05-10
2,1,1,0,Jones,2022-05-11
3,2,1,0,Jones,2022-05-12
3,0,3,0,Jones,2022-05-13
2,0,2,0,Jones,2022-05-14
0,0,0,0,Jones,2022-05-15
4,1,3,0,Jones,2022-05-16
3,0,3,0,Jones,2022-05-17
6,1,5,0,Jones,2022-05-18
1,0,1,0,Jones,2022-05-19
4,2,2,0,Jones,2022-05-20
2,1,1,0,Jones,2022-05-21
3,1,2,0,Jones,2022-05-22
1,1,0,0,Jones,2022-05-23
0,0,0,0,Jones,2022-05-24
5,0,5,0,Jones,2022-05-25
5,3,2,0,Jones,2022-05-26
2,1,1,0,Jones,2022-05-27
1,0,1,0,Jones,2022-05-28
0,0,0,0,Jones,2022-05-29
2,2,0,0,Jones,2022-05-30
2,0,2,0,Jones,2022-05-31
6,0,6,0,Jones,2022-06-01
1,1,0,0,Jones,2022-06-02
1,1,0,0,Jones,2022-06-03
0,0,0,0,Jones,2022-06-04
12,3,9,0,Lee,2021-12-07
27,1,26,0,Lee,2021-12-09
11,1,10,0,Lee,2021-12-11
8,0,8,0,Lee,2021-12-12
15,2,13,0,Lee,2021-12-18
24,1,23,0,Lee,2021-12-20
26,2,24,0,Lee,2021-12-22
32,6,26,0,Lee,2021-12-23
47,4,43,0,Lee,2021-12-26
86,16,70,0,Lee,2021-12-27
120,24,96,0,Lee,2021-12-29
149,19,130,0,Lee,2021-12-30
75,9,66,0,Lee,2021-12-31
43,4,39,0,Lee,2022-01-01
74,8,66,0,Lee,2022-01-02
178,20,158,0,Lee,2022-01-03
161,12,149,0,Lee,2022-01-07
281,24,257,0,Lee,2022-01-11
285,49,236,0,Lee,2022-01-13
157,20,137,0,Lee,2022-01-15
25,6,19,0,Lee,2022-01-16
239,51,188,0,Lee,2022-01-18
302,39,263,0,Lee,2022-01-19
211,72,139,0,Lee,2022-01-20
80,13,67,0,Lee,2022-01-21
50,17,33,0,Lee,2022-01-23
180,42,138,0,Lee,2022-01-24
126,36,90,0,Lee,2022-01-25
137,23,114,0,Lee,2022-01-26
78,11,67,0,Lee,2022-01-27
25,7,18,0,Lee,2022-01-29
29,4,25,0,Lee,2022-01-30
81,6,75,0,Lee,2022-01-31
71,8,63,0,Lee,2022-02-02
38,4,34,0,Lee,2022-02-03
41,3,38,0,Lee,2022-02-04
26,3,23,0,Lee,2022-02-06
36,10,26,0,Lee,2022-02-07
21,2,19,0,Lee,2022-02-10
22,2,20,0,Lee,2022-02-11
7,1,6,0,Lee,2022-02-12
18,5,13,0,Lee,2022-02-15
9,2,7,0,Lee,2022-02-18
6,2,4,0,Lee,2022-02-19
8,2,6,0,Lee,2022-02-20
13,1,12,0,Lee,2022-02-21
7,0,7,0,Lee,2022-02-23
8,0,8,0,Lee,2022-02-24
4,0,4,0,Lee,2022-02-25
0,0,0,0,Lee,2022-02-27
4,1,3,0,Lee,2022-02-28
5,2,3,0,Lee,2022-03-01
10,1,9,0,Lee,2022-03-02
4,1,3,0,Lee,2022-03-03
6,1,5,0,Lee,2022-03-04
1,0,1,0,Lee,2022-03-05
5,4,1,0,Lee,2022-03-07
3,0,3,0,Lee,2022-03-09
1,1,0,0,Lee,2022-03-11
1,1,0,0,Lee,2022-03-13
9,2,7,0,Lee,2022-03-14
1,1,0,0,Lee,2022-03-15
5,3,2,0,Lee,2022-03-16
1,0,1,0,Lee,2022-03-17
4,0,4,0,Lee,2022-03-18
0,0,0,0,Lee,2022-03-19
0,0,0,0,Lee,2022-03-20
4,1,3,0,Lee,2022-03-21
0,0,0,0,Lee,2022-03-22
2,0,2,0,Lee,2022-03-24
4,0,4,0,Lee,2022-03-25
0,0,0,0,Lee,2022-03-26
0,0,0,0,Lee,2022-03-27
2,1,1,0,Lee,2022-03-28
1,0,1,0,Lee,2022-03-29
5,0,5,0,Lee,2022-03-30
4,1,3,0,Lee,2022-03-31
1,1,0,0,Lee,2022-04-02
2,0,2,0,Lee,2022-04-03
4,0,4,0,Lee,2022-04-04
1,0,1,0,Lee,2022-04-05
1,0,1,0,Lee,2022-04-06
3,1,2,0,Lee,2022-04-07
2,0,2,0,Lee,2022-04-08
0,0,0,0,Lee,2022-04-09
1,0,1,0,Lee,2022-04-10
1,0,1,0,Lee,2022-04-11
3,1,2,0,Lee,2022-04-12
5,1,4,0,Lee,2022-04-13
5,0,5,0,Lee,2022-04-14
4,2,2,0,Lee,2022-04-15
0,0,0,0,Lee,2022-04-16
2,0,2,0,Lee,2022-04-17
4,2,2,0,Lee,2022-04-18
4,0,4,0,Lee,2022-04-19
12,0,12,0,Lee,2022-04-20
6,1,5,0,Lee,2022-04-21
10,2,8,0,Lee,2022-04-22
8,0,8,0,Lee,2022-04-23
2,1,1,0,Lee,2022-04-24
5,4,1,0,Lee,2022-04-25
5,0,5,0,Lee,2022-04-26
12,1,11,0,Lee,2022-04-27
7,0,7,0,Lee,2022-04-28
6,0,6,0,Lee,2022-04-29
7,1,6,0,Lee,2022-04-30
3,1,2,0,Lee,2022-05-01
9,3,6,0,Lee,2022-05-02
14,3,11,0,Lee,2022-05-03
14,3,11,0,Lee,2022-05-04
6,1,5,0,Lee,2022-05-05
8,2,6,0,Lee,2022-05-06
7,0,7,0,Lee,2022-05-07
11,1,10,0,Lee,2022-05-08
17,1,16,0,Lee,2022-05-09
9,0,9,0,Lee,2022-05-10
14,1,13,0,Lee,2022-05-11
15,0,15,0,Lee,2022-05-12
17,4,13,0,Lee,2022-05-13
12,3,9,0,Lee,2022-05-14
13,6,7,0,Lee,2022-05-15
26,5,21,0,Lee,2022-05-16
23,6,17,0,Lee,2022-05-17
23,4,19,0,Lee,2022-05-18
18,5,13,0,Lee,2022-05-19
23,5,18,0,Lee,2022-05-20
10,5,5,0,Lee,2022-05-21
12,2,10,0,Lee,2022-05-22
25,8,17,0,Lee,2022-05-24
26,6,20,0,Lee,2022-05-25
17,2,15,0,Lee,2022-05-26
13,1,12,0,Lee,2022-05-27
11,3,8,0,Lee,2022-05-28
4,3,1,0,Lee,2022-05-29
15,7,8,0,Lee,2022-05-30
32,7,25,0,Lee,2022-05-31
27,4,23,0,Lee,2022-06-01
22,4,18,0,Lee,2022-06-02
9,2,7,0,Lee,2022-06-03
6,0,6,0,Lee,2022-06-04
22,10,12,0,Lenoir,2021-12-07
20,3,17,0,Lenoir,2021-12-08
9,1,8,0,Lenoir,2021-12-09
5,1,4,0,Lenoir,2021-12-11
7,2,5,0,Lenoir,2021-12-12
32,11,21,0,Lenoir,2021-12-13
16,1,15,0,Lenoir,2021-12-14
15,5,10,0,Lenoir,2021-12-17
9,0,9,0,Lenoir,2021-12-18
14,5,9,0,Lenoir,2021-12-19
24,3,21,0,Lenoir,2021-12-20
26,4,22,0,Lenoir,2021-12-23
11,1,10,0,Lenoir,2021-12-24
12,2,10,0,Lenoir,2021-12-25
20,2,18,0,Lenoir,2021-12-26
74,11,63,0,Lenoir,2021-12-27
111,15,96,0,Lenoir,2021-12-29
131,18,113,0,Lenoir,2021-12-30
84,15,69,0,Lenoir,2021-12-31
52,14,38,0,Lenoir,2022-01-02
164,53,111,0,Lenoir,2022-01-05
163,34,129,0,Lenoir,2022-01-07
45,17,28,0,Lenoir,2022-01-08
317,80,237,0,Lenoir,2022-01-10
256,38,218,0,Lenoir,2022-01-11
263,47,216,0,Lenoir,2022-01-12
229,52,177,0,Lenoir,2022-01-14
73,22,51,0,Lenoir,2022-01-15
44,17,27,0,Lenoir,2022-01-16
157,59,98,0,Lenoir,2022-01-17
38,8,30,0,Lenoir,2022-01-21
12,5,7,0,Lenoir,2022-01-22
44,15,29,0,Lenoir,2022-01-23
53,10,43,0,Lenoir,2022-02-02
50,14,36,0,Lenoir,2022-02-03
31,10,21,0,Lenoir,2022-02-04
28,9,19,0,Lenoir,2022-02-10
23,5,18,0,Lenoir,2022-02-11
6,4,2,0,Lenoir,2022-02-12
14,2,12,0,Lenoir,2022-02-16
11,0,11,0,Lenoir,2022-02-18
4,0,4,0,Lenoir,2022-02-19
4,0,4,0,Lenoir,2022-02-20
13,1,12,0,Lenoir,2022-02-21
7,1,6,0,Lenoir,2022-02-22
11,0,11,0,Lenoir,2022-02-24
1,0,1,0,Lenoir,2022-02-26
4,1,3,0,Lenoir,2022-02-27
7,1,6,0,Lenoir,2022-03-02
3,0,3,0,Lenoir,2022-03-03
8,1,7,0,Lenoir,2022-03-07
2,0,2,0,Lenoir,2022-03-08
3,2,1,0,Lenoir,2022-03-09
4,0,4,0,Lenoir,2022-03-11
0,0,0,0,Lenoir,2022-03-12
1,0,1,0,Lenoir,2022-03-13
2,0,2,0,Lenoir,2022-03-14
0,0,0,0,Lenoir,2022-03-15
0,0,0,0,Lenoir,2022-03-16
2,0,2,0,Lenoir,2022-03-17
1,0,1,0,Lenoir,2022-03-18
0,0,0,0,Lenoir,2022-03-19
0,0,0,0,Lenoir,2022-03-20
1,0,1,0,Lenoir,2022-03-21
2,1,1,0,Lenoir,2022-03-22
1,0,1,0,Lenoir,2022-03-24
0,0,0,0,Lenoir,2022-03-25
2,0,2,0,Lenoir,2022-03-27
2,1,1,0,Lenoir,2022-03-28
2,2,0,0,Lenoir,2022-03-29
1,0,1,0,Lenoir,2022-03-30
2,0,2,0,Lenoir,2022-03-31
0,0,0,0,Lenoir,2022-04-01
0,0,0,0,Lenoir,2022-04-02
1,0,1,0,Lenoir,2022-04-03
1,1,0,0,Lenoir,2022-04-04
3,1,2,0,Lenoir,2022-04-05
1,0,1,0,Lenoir,2022-04-06
0,0,0,0,Lenoir,2022-04-07
1,0,1,0,Lenoir,2022-04-08
1,0,1,0,Lenoir,2022-04-09
1,0,1,0,Lenoir,2022-04-10
2,0,2,0,Lenoir,2022-04-11
3,0,3,0,Lenoir,2022-04-12
2,1,1,0,Lenoir,2022-04-13
1,1,0,0,Lenoir,2022-04-15
0,0,0,0,Lenoir,2022-04-16
1,1,0,0,Lenoir,2022-04-17
6,4,2,0,Lenoir,2022-04-18
2,1,1,0,Lenoir,2022-04-19
3,2,1,0,Lenoir,2022-04-20
2,1,1,0,Lenoir,2022-04-21
3,1,2,0,Lenoir,2022-04-22
1,1,0,0,Lenoir,2022-04-23
3,3,0,0,Lenoir,2022-04-24
4,1,3,0,Lenoir,2022-04-25
2,1,1,0,Lenoir,2022-04-26
1,0,1,0,Lenoir,2022-04-27
4,1,3,0,Lenoir,2022-04-28
3,2,1,0,Lenoir,2022-04-29
3,3,0,0,Lenoir,2022-04-30
0,0,0,0,Lenoir,2022-05-01
6,1,5,0,Lenoir,2022-05-02
7,1,6,0,Lenoir,2022-05-03
8,3,5,0,Lenoir,2022-05-04
7,0,7,0,Lenoir,2022-05-05
0,0,0,0,Lenoir,2022-05-06
2,0,2,0,Lenoir,2022-05-07
2,1,1,0,Lenoir,2022-05-08
5,2,3,0,Lenoir,2022-05-09
7,2,5,0,Lenoir,2022-05-10
4,2,2,0,Lenoir,2022-05-11
13,4,9,0,Lenoir,2022-05-12
9,3,6,0,Lenoir,2022-05-13
4,1,3,0,Lenoir,2022-05-14
10,4,6,0,Lenoir,2022-05-15
19,5,14,0,Lenoir,2022-05-16
11,1,10,0,Lenoir,2022-05-17
7,1,6,0,Lenoir,2022-05-18
13,4,9,0,Lenoir,2022-05-19
12,4,8,0,Lenoir,2022-05-20
2,0,2,0,Lenoir,2022-05-21
5,4,1,0,Lenoir,2022-05-22
15,5,10,0,Lenoir,2022-05-23
9,3,6,0,Lenoir,2022-05-24
17,9,8,0,Lenoir,2022-05-25
11,5,6,0,Lenoir,2022-05-26
14,5,9,0,Lenoir,2022-05-27
6,3,3,0,Lenoir,2022-05-28
3,1,2,0,Lenoir,2022-05-29
3,2,1,0,Lenoir,2022-05-30
17,8,9,0,Lenoir,2022-06-01
22,7,15,0,Lenoir,2022-06-02
9,6,3,0,Lenoir,2022-06-03
3,0,3,0,Lenoir,2022-06-04
52,21,31,0,Lincoln,2021-12-07
55,20,35,0,Lincoln,2021-12-08
21,6,15,0,Lincoln,2021-12-11
20,3,17,0,Lincoln,2021-12-12
47,11,36,0,Lincoln,2021-12-14
29,9,20,0,Lincoln,2021-12-15
56,20,36,0,Lincoln,2021-12-16
49,6,43,0,Lincoln,2021-12-17
19,4,15,0,Lincoln,2021-12-19
59,18,41,0,Lincoln,2021-12-20
64,9,55,0,Lincoln,2021-12-22
33,10,23,0,Lincoln,2021-12-24
7,2,5,0,Lincoln,2021-12-25
46,5,41,0,Lincoln,2021-12-26
203,46,157,0,Lincoln,2021-12-28
174,48,126,0,Lincoln,2021-12-29
204,58,146,0,Lincoln,2021-12-30
76,29,47,0,Lincoln,2021-12-31
32,9,23,0,Lincoln,2022-01-01
164,56,108,0,Lincoln,2022-01-03
252,44,208,0,Lincoln,2022-01-05
169,56,113,0,Lincoln,2022-01-07
66,17,49,0,Lincoln,2022-01-09
312,90,222,0,Lincoln,2022-01-14
16,5,11,0,Lincoln,2022-01-16
89,28,61,0,Lincoln,2022-01-17
93,22,71,0,Lincoln,2022-01-22
204,76,128,0,Lincoln,2022-01-24
228,78,150,0,Lincoln,2022-01-25
180,63,117,0,Lincoln,2022-01-26
108,41,67,0,Lincoln,2022-01-28
96,26,70,0,Lincoln,2022-02-02
85,27,58,0,Lincoln,2022-02-03
42,7,35,0,Lincoln,2022-02-05
60,20,40,0,Lincoln,2022-02-08
67,19,48,0,Lincoln,2022-02-09
19,5,14,0,Lincoln,2022-02-13
48,15,33,0,Lincoln,2022-02-14
28,10,18,0,Lincoln,2022-02-17
14,3,11,0,Lincoln,2022-02-19
23,4,19,0,Lincoln,2022-02-21
5,2,3,0,Lincoln,2022-02-23
14,9,5,0,Lincoln,2022-02-24
16,1,15,0,Lincoln,2022-02-25
3,2,1,0,Lincoln,2022-02-26
4,2,2,0,Lincoln,2022-02-27
11,1,10,0,Lincoln,2022-02-28
3,2,1,0,Lincoln,2022-03-03
5,2,3,0,Lincoln,2022-03-04
4,1,3,0,Lincoln,2022-03-05
1,1,0,0,Lincoln,2022-03-06
8,3,5,0,Lincoln,2022-03-07
4,0,4,0,Lincoln,2022-03-08
3,0,3,0,Lincoln,2022-03-09
0,0,0,0,Lincoln,2022-03-10
4,1,3,0,Lincoln,2022-03-11
4,0,4,0,Lincoln,2022-03-12
1,0,1,0,Lincoln,2022-03-13
7,2,5,0,Lincoln,2022-03-14
9,0,9,0,Lincoln,2022-03-15
3,0,3,0,Lincoln,2022-03-17
2,1,1,0,Lincoln,2022-03-19
1,1,0,0,Lincoln,2022-03-20
1,0,1,0,Lincoln,2022-03-21
0,0,0,0,Lincoln,2022-03-22
4,1,3,0,Lincoln,2022-03-23
2,0,2,0,Lincoln,2022-03-24
0,0,0,0,Lincoln,2022-03-25
0,0,0,0,Lincoln,2022-03-26
1,0,1,0,Lincoln,2022-03-27
1,0,1,0,Lincoln,2022-03-28
2,0,2,0,Lincoln,2022-03-30
2,0,2,0,Lincoln,2022-03-31
0,0,0,0,Lincoln,2022-04-01
4,0,4,0,Lincoln,2022-04-02
1,0,1,0,Lincoln,2022-04-03
0,0,0,0,Lincoln,2022-04-04
2,0,2,0,Lincoln,2022-04-06
2,1,1,0,Lincoln,2022-04-07
4,0,4,0,Lincoln,2022-04-08
4,1,3,0,Lincoln,2022-04-09
3,2,1,0,Lincoln,2022-04-10
4,1,3,0,Lincoln,2022-04-11
5,1,4,0,Lincoln,2022-04-12
3,0,3,0,Lincoln,2022-04-13
9,1,8,0,Lincoln,2022-04-14
4,0,4,0,Lincoln,2022-04-15
3,1,2,0,Lincoln,2022-04-16
1,0,1,0,Lincoln,2022-04-17
7,0,7,0,Lincoln,2022-04-18
5,0,5,0,Lincoln,2022-04-19
6,2,4,0,Lincoln,2022-04-20
3,1,2,0,Lincoln,2022-04-21
4,0,4,0,Lincoln,2022-04-22
5,0,5,0,Lincoln,2022-04-23
6,2,4,0,Lincoln,2022-04-24
9,1,8,0,Lincoln,2022-04-25
20,2,18,0,Lincoln,2022-04-26
9,1,8,0,Lincoln,2022-04-27
6,0,6,0,Lincoln,2022-04-28
13,4,9,0,Lincoln,2022-04-29
6,1,5,0,Lincoln,2022-04-30
12,1,11,0,Lincoln,2022-05-01
17,5,12,0,Lincoln,2022-05-03
19,7,12,0,Lincoln,2022-05-04
14,2,12,0,Lincoln,2022-05-05
17,4,13,0,Lincoln,2022-05-06
9,3,6,0,Lincoln,2022-05-07
7,1,6,0,Lincoln,2022-05-08
14,2,12,0,Lincoln,2022-05-09
21,5,16,0,Lincoln,2022-05-10
26,8,18,0,Lincoln,2022-05-11
27,8,19,0,Lincoln,2022-05-12
21,3,18,0,Lincoln,2022-05-13
17,7,10,0,Lincoln,2022-05-14
5,2,3,0,Lincoln,2022-05-15
32,14,18,0,Lincoln,2022-05-16
23,5,18,0,Lincoln,2022-05-17
27,5,22,0,Lincoln,2022-05-18
33,7,26,0,Lincoln,2022-05-19
20,4,16,0,Lincoln,2022-05-20
9,3,6,0,Lincoln,2022-05-21
10,0,10,0,Lincoln,2022-05-22
40,11,29,0,Lincoln,2022-05-23
33,9,24,0,Lincoln,2022-05-24
23,4,19,0,Lincoln,2022-05-25
26,7,19,0,Lincoln,2022-05-26
16,4,12,0,Lincoln,2022-05-27
7,1,6,0,Lincoln,2022-05-28
5,2,3,0,Lincoln,2022-05-29
15,4,11,0,Lincoln,2022-05-30
41,7,34,0,Lincoln,2022-05-31
22,5,17,0,Lincoln,2022-06-01
22,4,18,0,Lincoln,2022-06-02
15,5,10,0,Lincoln,2022-06-03
18,2,16,0,Lincoln,2022-06-04
11,4,7,0,Macon,2021-12-07
17,7,10,0,Macon,2021-12-08
10,4,6,0,Macon,2021-12-09
6,0,6,0,Macon,2021-12-10
2,0,2,0,Macon,2021-12-11
2,0,2,0,Macon,2021-12-12
11,4,7,0,Macon,2021-12-13
4,1,3,0,Macon,2021-12-15
1,0,1,0,Macon,2021-12-19
6,2,4,0,Macon,2021-12-20
11,5,6,0,Macon,2021-12-21
13,3,10,0,Macon,2021-12-22
10,3,7,0,Macon,2021-12-23
10,6,4,0,Macon,2021-12-24
9,2,7,0,Macon,2021-12-26
24,6,18,0,Macon,2021-12-27
44,7,37,0,Macon,2021-12-28
48,12,36,0,Macon,2021-12-29
13,3,10,0,Macon,2021-12-31
23,3,20,0,Macon,2022-01-02
71,4,67,0,Macon,2022-01-04
63,10,53,0,Macon,2022-01-05
112,35,77,0,Macon,2022-01-10
90,15,75,0,Macon,2022-01-11
91,29,62,0,Macon,2022-01-13
23,3,20,0,Macon,2022-01-15
28,6,22,0,Macon,2022-01-17
74,12,62,0,Macon,2022-01-21
28,4,24,0,Macon,2022-01-22
19,3,16,0,Macon,2022-01-23
94,10,84,0,Macon,2022-01-24
51,4,47,0,Macon,2022-01-25
54,7,47,0,Macon,2022-01-26
34,10,24,0,Macon,2022-01-28
7,0,7,0,Macon,2022-01-29
16,2,14,0,Macon,2022-01-30
32,6,26,0,Macon,2022-02-01
28,4,24,0,Macon,2022-02-02
25,7,18,0,Macon,2022-02-03
28,4,24,0,Macon,2022-02-04
10,1,9,0,Macon,2022-02-05
5,1,4,0,Macon,2022-02-06
34,7,27,0,Macon,2022-02-07
15,1,14,0,Macon,2022-02-09
16,5,11,0,Macon,2022-02-11
6,0,6,0,Macon,2022-02-12
3,0,3,0,Macon,2022-02-13
11,2,9,0,Macon,2022-02-14
11,0,11,0,Macon,2022-02-15
12,2,10,0,Macon,2022-02-16
6,1,5,0,Macon,2022-02-18
3,0,3,0,Macon,2022-02-19
2,1,1,0,Macon,2022-02-20
8,4,4,0,Macon,2022-02-21
2,1,1,0,Macon,2022-02-23
3,2,1,0,Macon,2022-02-25
2,1,1,0,Macon,2022-02-26
2,0,2,0,Macon,2022-02-28
2,0,2,0,Macon,2022-03-01
3,1,2,0,Macon,2022-03-03
2,0,2,0,Macon,2022-03-04
0,0,0,0,Macon,2022-03-05
0,0,0,0,Macon,2022-03-06
3,1,2,0,Macon,2022-03-08
1,0,1,0,Macon,2022-03-09
2,1,1,0,Macon,2022-03-10
2,0,2,0,Macon,2022-03-11
0,0,0,0,Macon,2022-03-12
0,0,0,0,Macon,2022-03-13
2,0,2,0,Macon,2022-03-14
2,0,2,0,Macon,2022-03-15
1,0,1,0,Macon,2022-03-16
2,0,2,0,Macon,2022-03-17
2,0,2,0,Macon,2022-03-18
0,0,0,0,Macon,2022-03-20
0,0,0,0,Macon,2022-03-22
0,0,0,0,Macon,2022-03-23
0,0,0,0,Macon,2022-03-24
0,0,0,0,Macon,2022-03-25
0,0,0,0,Macon,2022-03-26
0,0,0,0,Macon,2022-03-27
0,0,0,0,Macon,2022-03-28
3,1,2,0,Macon,2022-03-29
0,0,0,0,Macon,2022-03-31
1,1,0,0,Macon,2022-04-01
1,0,1,0,Macon,2022-04-02
4,0,4,0,Macon,2022-04-03
1,1,0,0,Macon,2022-04-04
1,0,1,0,Macon,2022-04-05
2,1,1,0,Macon,2022-04-06
2,1,1,0,Macon,2022-04-07
3,0,3,0,Macon,2022-04-08
0,0,0,0,Macon,2022-04-09
1,0,1,0,Macon,2022-04-10
0,0,0,0,Macon,2022-04-11
1,0,1,0,Macon,2022-04-12
1,0,1,0,Macon,2022-04-14
2,2,0,0,Macon,2022-04-16
0,0,0,0,Macon,2022-04-17
5,4,1,0,Macon,2022-04-18
2,1,1,0,Macon,2022-04-19
3,3,0,0,Macon,2022-04-20
1,0,1,0,Macon,2022-04-21
1,0,1,0,Macon,2022-04-22
1,0,1,0,Macon,2022-04-23
1,0,1,0,Macon,2022-04-24
4,0,4,0,Macon,2022-04-25
2,0,2,0,Macon,2022-04-26
2,1,1,0,Macon,2022-04-27
4,2,2,0,Macon,2022-04-28
1,0,1,0,Macon,2022-04-29
3,0,3,0,Macon,2022-04-30
2,0,2,0,Macon,2022-05-01
2,0,2,0,Macon,2022-05-02
4,3,1,0,Macon,2022-05-03
1,0,1,0,Macon,2022-05-04
1,0,1,0,Macon,2022-05-05
1,0,1,0,Macon,2022-05-06
2,0,2,0,Macon,2022-05-07
4,0,4,0,Macon,2022-05-08
5,1,4,0,Macon,2022-05-09
2,1,1,0,Macon,2022-05-11
6,0,6,0,Macon,2022-05-12
2,0,2,0,Macon,2022-05-13
0,0,0,0,Macon,2022-05-14
1,0,1,0,Macon,2022-05-15
4,1,3,0,Macon,2022-05-16
4,1,3,0,Macon,2022-05-17
11,0,11,0,Macon,2022-05-18
10,1,9,0,Macon,2022-05-19
6,0,6,0,Macon,2022-05-20
7,2,5,0,Macon,2022-05-21
0,0,0,0,Macon,2022-05-22
9,1,8,0,Macon,2022-05-23
6,0,6,0,Macon,2022-05-24
8,0,8,0,Macon,2022-05-25
7,1,6,0,Macon,2022-05-26
7,5,2,0,Macon,2022-05-27
1,0,1,0,Macon,2022-05-28
3,0,3,0,Macon,2022-05-29
2,0,2,0,Macon,2022-05-30
7,1,6,0,Macon,2022-05-31
11,5,6,0,Macon,2022-06-01
6,0,6,0,Macon,2022-06-02
4,1,3,0,Macon,2022-06-03
4,1,3,0,Macon,2022-06-04
3,0,3,0,Madison,2021-12-07
12,8,4,0,Madison,2021-12-09
8,1,7,0,Madison,2021-12-10
5,0,5,0,Madison,2021-12-11
1,0,1,0,Madison,2021-12-12
16,3,13,0,Madison,2021-12-15
6,1,5,0,Madison,2021-12-17
4,2,2,0,Madison,2021-12-18
0,0,0,0,Madison,2021-12-19
12,1,11,0,Madison,2021-12-20
7,2,5,0,Madison,2021-12-22
2,0,2,0,Madison,2021-12-24
0,0,0,0,Madison,2021-12-25
8,2,6,0,Madison,2021-12-26
20,4,16,0,Madison,2021-12-27
35,2,33,0,Madison,2021-12-28
24,2,22,0,Madison,2021-12-29
22,0,22,0,Madison,2021-12-30
14,2,12,0,Madison,2022-01-01
12,1,11,0,Madison,2022-01-02
35,3,32,0,Madison,2022-01-03
50,5,45,0,Madison,2022-01-04
82,7,75,0,Madison,2022-01-05
30,2,28,0,Madison,2022-01-07
94,12,82,0,Madison,2022-01-10
62,9,53,0,Madison,2022-01-11
83,10,73,0,Madison,2022-01-12
57,3,54,0,Madison,2022-01-13
34,2,32,0,Madison,2022-01-15
4,1,3,0,Madison,2022-01-16
20,1,19,0,Madison,2022-01-17
52,10,42,0,Madison,2022-01-20
43,5,38,0,Madison,2022-01-21
33,2,31,0,Madison,2022-01-22
10,5,5,0,Madison,2022-01-23
74,19,55,0,Madison,2022-01-24
63,8,55,0,Madison,2022-01-25
38,7,31,0,Madison,2022-01-26
43,4,39,0,Madison,2022-01-28
5,2,3,0,Madison,2022-01-29
12,1,11,0,Madison,2022-01-30
47,7,40,0,Madison,2022-01-31
36,11,25,0,Madison,2022-02-02
37,8,29,0,Madison,2022-02-03
18,7,11,0,Madison,2022-02-04
7,1,6,0,Madison,2022-02-05
52,13,39,0,Madison,2022-02-07
29,5,24,0,Madison,2022-02-09
27,7,20,0,Madison,2022-02-10
9,2,7,0,Madison,2022-02-12
7,3,4,0,Madison,2022-02-13
31,6,25,0,Madison,2022-02-14
9,1,8,0,Madison,2022-02-15
25,5,20,0,Madison,2022-02-16
19,3,16,0,Madison,2022-02-17
11,2,9,0,Madison,2022-02-18
2,1,1,0,Madison,2022-02-19
4,4,0,0,Madison,2022-02-20
19,6,13,0,Madison,2022-02-21
5,0,5,0,Madison,2022-02-23
6,2,4,0,Madison,2022-02-24
8,4,4,0,Madison,2022-02-25
3,0,3,0,Madison,2022-02-27
6,4,2,0,Madison,2022-02-28
6,0,6,0,Madison,2022-03-01
5,2,3,0,Madison,2022-03-02
3,1,2,0,Madison,2022-03-03
4,1,3,0,Madison,2022-03-04
0,0,0,0,Madison,2022-03-05
1,1,0,0,Madison,2022-03-06
3,0,3,0,Madison,2022-03-07
4,2,2,0,Madison,2022-03-08
2,0,2,0,Madison,2022-03-10
1,0,1,0,Madison,2022-03-11
0,0,0,0,Madison,2022-03-12
1,1,0,0,Madison,2022-03-13
4,0,4,0,Madison,2022-03-14
2,0,2,0,Madison,2022-03-15
2,1,1,0,Madison,2022-03-16
1,0,1,0,Madison,2022-03-17
1,0,1,0,Madison,2022-03-18
0,0,0,0,Madison,2022-03-19
0,0,0,0,Madison,2022-03-20
1,0,1,0,Madison,2022-03-21
1,0,1,0,Madison,2022-03-22
0,0,0,0,Madison,2022-03-23
1,0,1,0,Madison,2022-03-24
0,0,0,0,Madison,2022-03-25
0,0,0,0,Madison,2022-03-26
0,0,0,0,Madison,2022-03-27
3,0,3,0,Madison,2022-03-28
2,0,2,0,Madison,2022-03-29
0,0,0,0,Madison,2022-03-30
3,0,3,0,Madison,2022-03-31
0,0,0,0,Madison,2022-04-01
0,0,0,0,Madison,2022-04-02
0,0,0,0,Madison,2022-04-03
0,0,0,0,Madison,2022-04-04
3,1,2,0,Madison,2022-04-05
3,1,2,0,Madison,2022-04-06
2,2,0,0,Madison,2022-04-07
1,0,1,0,Madison,2022-04-08
0,0,0,0,Madison,2022-04-09
2,0,2,0,Madison,2022-04-10
4,2,2,0,Madison,2022-04-11
3,2,1,0,Madison,2022-04-12
3,0,3,0,Madison,2022-04-13
5,2,3,0,Madison,2022-04-14
0,0,0,0,Madison,2022-04-15
1,1,0,0,Madison,2022-04-16
1,0,1,0,Madison,2022-04-17
6,2,4,0,Madison,2022-04-18
2,1,1,0,Madison,2022-04-19
6,1,5,0,Madison,2022-04-20
3,0,3,0,Madison,2022-04-21
4,1,3,0,Madison,2022-04-22
2,2,0,0,Madison,2022-04-23
2,1,1,0,Madison,2022-04-24
3,2,1,0,Madison,2022-04-25
8,0,8,0,Madison,2022-04-26
5,0,5,0,Madison,2022-04-27
7,4,3,0,Madison,2022-04-28
2,1,1,0,Madison,2022-04-29
1,0,1,0,Madison,2022-04-30
0,0,0,0,Madison,2022-05-01
3,2,1,0,Madison,2022-05-02
1,0,1,0,Madison,2022-05-03
4,3,1,0,Madison,2022-05-04
4,3,1,0,Madison,2022-05-05
6,4,2,0,Madison,2022-05-06
1,1,0,0,Madison,2022-05-07
3,2,1,0,Madison,2022-05-08
8,2,6,0,Madison,2022-05-09
7,6,1,0,Madison,2022-05-10
6,4,2,0,Madison,2022-05-11
9,6,3,0,Madison,2022-05-12
11,6,5,0,Madison,2022-05-13
4,2,2,0,Madison,2022-05-14
0,0,0,0,Madison,2022-05-15
26,17,9,0,Madison,2022-05-16
13,4,9,0,Madison,2022-05-17
8,5,3,0,Madison,2022-05-18
11,8,3,0,Madison,2022-05-19
5,2,3,0,Madison,2022-05-20
6,4,2,0,Madison,2022-05-21
6,3,3,0,Madison,2022-05-22
13,9,4,0,Madison,2022-05-23
6,2,4,0,Madison,2022-05-24
6,2,4,0,Madison,2022-05-25
5,4,1,0,Madison,2022-05-26
3,0,3,0,Madison,2022-05-27
2,1,1,0,Madison,2022-05-28
1,0,1,0,Madison,2022-05-29
5,3,2,0,Madison,2022-05-30
13,6,7,0,Madison,2022-05-31
9,3,6,0,Madison,2022-06-01
4,0,4,0,Madison,2022-06-02
12,2,10,0,Madison,2022-06-03
2,0,2,0,Madison,2022-06-04
7,1,6,0,Martin,2021-12-07
6,0,6,0,Martin,2021-12-08
1,1,0,0,Martin,2021-12-09
3,0,3,0,Martin,2021-12-10
3,0,3,0,Martin,2021-12-11
1,0,1,0,Martin,2021-12-12
7,1,6,0,Martin,2021-12-13
2,1,1,0,Martin,2021-12-15
5,0,5,0,Martin,2021-12-16
3,0,3,0,Martin,2021-12-17
1,1,0,0,Martin,2021-12-18
3,0,3,0,Martin,2021-12-19
11,3,8,0,Martin,2021-12-20
5,2,3,0,Martin,2021-12-21
10,0,10,0,Martin,2021-12-22
3,0,3,0,Martin,2021-12-23
0,0,0,0,Martin,2021-12-24
0,0,0,0,Martin,2021-12-25
2,1,1,0,Martin,2021-12-26
16,5,11,0,Martin,2021-12-27
53,5,48,0,Martin,2021-12-29
57,8,49,0,Martin,2021-12-30
16,0,16,0,Martin,2021-12-31
10,3,7,0,Martin,2022-01-01
74,5,69,0,Martin,2022-01-03
105,9,96,0,Martin,2022-01-04
44,9,35,0,Martin,2022-01-08
20,6,14,0,Martin,2022-01-09
112,12,100,0,Martin,2022-01-10
127,8,119,0,Martin,2022-01-11
92,5,87,0,Martin,2022-01-13
94,23,71,0,Martin,2022-01-14
95,23,72,0,Martin,2022-01-17
4,0,4,0,Martin,2022-01-21
2,1,1,0,Martin,2022-01-22
46,13,33,0,Martin,2022-01-25
34,2,32,0,Martin,2022-01-28
2,0,2,0,Martin,2022-01-29
3,1,2,0,Martin,2022-01-30
41,2,39,0,Martin,2022-01-31
45,4,41,0,Martin,2022-02-01
21,1,20,0,Martin,2022-02-02
12,0,12,0,Martin,2022-02-04
11,2,9,0,Martin,2022-02-05
1,0,1,0,Martin,2022-02-06
19,1,18,0,Martin,2022-02-07
15,1,14,0,Martin,2022-02-08
10,1,9,0,Martin,2022-02-10
13,1,12,0,Martin,2022-02-11
9,2,7,0,Martin,2022-02-14
4,0,4,0,Martin,2022-02-15
4,1,3,0,Martin,2022-02-16
0,0,0,0,Martin,2022-02-17
4,0,4,0,Martin,2022-02-18
3,1,2,0,Martin,2022-02-19
1,0,1,0,Martin,2022-02-20
10,1,9,0,Martin,2022-02-21
3,0,3,0,Martin,2022-02-22
2,0,2,0,Martin,2022-02-23
2,0,2,0,Martin,2022-02-24
4,0,4,0,Martin,2022-03-01
1,0,1,0,Martin,2022-03-02
1,0,1,0,Martin,2022-03-03
1,0,1,0,Martin,2022-03-04
1,0,1,0,Martin,2022-03-05
0,0,0,0,Martin,2022-03-06
2,0,2,0,Martin,2022-03-07
0,0,0,0,Martin,2022-03-08
1,0,1,0,Martin,2022-03-09
1,0,1,0,Martin,2022-03-10
1,0,1,0,Martin,2022-03-11
0,0,0,0,Martin,2022-03-12
0,0,0,0,Martin,2022-03-13
0,0,0,0,Martin,2022-03-14
0,0,0,0,Martin,2022-03-15
1,0,1,0,Martin,2022-03-16
0,0,0,0,Martin,2022-03-17
0,0,0,0,Martin,2022-03-18
0,0,0,0,Martin,2022-03-19
0,0,0,0,Martin,2022-03-20
0,0,0,0,Martin,2022-03-21
0,0,0,0,Martin,2022-03-22
1,0,1,0,Martin,2022-03-23
0,0,0,0,Martin,2022-03-24
0,0,0,0,Martin,2022-03-25
0,0,0,0,Martin,2022-03-26
0,0,0,0,Martin,2022-03-27
0,0,0,0,Martin,2022-03-28
0,0,0,0,Martin,2022-03-29
0,0,0,0,Martin,2022-03-30
0,0,0,0,Martin,2022-03-31
1,0,1,0,Martin,2022-04-01
0,0,0,0,Martin,2022-04-02
0,0,0,0,Martin,2022-04-03
0,0,0,0,Martin,2022-04-04
0,0,0,0,Martin,2022-04-05
2,1,1,0,Martin,2022-04-06
1,0,1,0,Martin,2022-04-07
0,0,0,0,Martin,2022-04-08
0,0,0,0,Martin,2022-04-09
0,0,0,0,Martin,2022-04-10
0,0,0,0,Martin,2022-04-11
1,1,0,0,Martin,2022-04-12
1,0,1,0,Martin,2022-04-13
0,0,0,0,Martin,2022-04-14
0,0,0,0,Martin,2022-04-15
0,0,0,0,Martin,2022-04-16
0,0,0,0,Martin,2022-04-17
0,0,0,0,Martin,2022-04-18
0,0,0,0,Martin,2022-04-19
3,2,1,0,Martin,2022-04-20
2,1,1,0,Martin,2022-04-21
2,0,2,0,Martin,2022-04-22
0,0,0,0,Martin,2022-04-23
0,0,0,0,Martin,2022-04-24
4,3,1,0,Martin,2022-04-25
2,0,2,0,Martin,2022-04-27
2,0,2,0,Martin,2022-04-28
3,1,2,0,Martin,2022-04-29
0,0,0,0,Martin,2022-04-30
0,0,0,0,Martin,2022-05-01
6,2,4,0,Martin,2022-05-02
3,0,3,0,Martin,2022-05-03
5,2,3,0,Martin,2022-05-04
3,2,1,0,Martin,2022-05-05
2,1,1,0,Martin,2022-05-06
0,0,0,0,Martin,2022-05-07
1,0,1,0,Martin,2022-05-08
3,1,2,0,Martin,2022-05-09
2,1,1,0,Martin,2022-05-10
0,0,0,0,Martin,2022-05-11
4,1,3,0,Martin,2022-05-12
5,0,5,0,Martin,2022-05-13
4,1,3,0,Martin,2022-05-14
1,0,1,0,Martin,2022-05-15
9,2,7,0,Martin,2022-05-16
4,0,4,0,Martin,2022-05-17
9,2,7,0,Martin,2022-05-18
10,3,7,0,Martin,2022-05-19
10,3,7,0,Martin,2022-05-20
3,2,1,0,Martin,2022-05-21
4,0,4,0,Martin,2022-05-22
8,1,7,0,Martin,2022-05-23
12,3,9,0,Martin,2022-05-24
3,1,2,0,Martin,2022-05-25
6,1,5,0,Martin,2022-05-26
6,2,4,0,Martin,2022-05-27
3,1,2,0,Martin,2022-05-28
4,0,4,0,Martin,2022-05-29
2,1,1,0,Martin,2022-05-30
14,3,11,0,Martin,2022-05-31
9,3,6,0,Martin,2022-06-01
10,5,5,0,Martin,2022-06-02
6,2,4,0,Martin,2022-06-03
3,1,2,0,Martin,2022-06-04
8,1,7,0,McDowell,2021-12-07
13,3,10,0,McDowell,2021-12-08
17,3,14,0,McDowell,2021-12-09
7,0,7,0,McDowell,2021-12-10
11,3,8,0,McDowell,2021-12-11
9,2,7,0,McDowell,2021-12-12
29,7,22,0,McDowell,2021-12-16
14,9,5,0,McDowell,2021-12-17
10,6,4,0,McDowell,2021-12-19
29,6,23,0,McDowell,2021-12-22
16,5,11,0,McDowell,2021-12-23
17,3,14,0,McDowell,2021-12-24
3,0,3,0,McDowell,2021-12-25
13,1,12,0,McDowell,2021-12-26
73,16,57,0,McDowell,2021-12-27
58,9,49,0,McDowell,2021-12-28
70,17,53,0,McDowell,2021-12-29
69,13,56,0,McDowell,2021-12-30
45,8,37,0,McDowell,2021-12-31
38,6,32,0,McDowell,2022-01-02
110,30,80,0,McDowell,2022-01-04
110,25,85,0,McDowell,2022-01-05
98,32,66,0,McDowell,2022-01-06
102,30,72,0,McDowell,2022-01-07
51,14,37,0,McDowell,2022-01-08
162,33,129,0,McDowell,2022-01-10
120,39,81,0,McDowell,2022-01-14
41,8,33,0,McDowell,2022-01-17
111,54,57,0,McDowell,2022-01-21
56,16,40,0,McDowell,2022-01-22
118,33,85,0,McDowell,2022-01-26
109,31,78,0,McDowell,2022-01-27
125,45,80,0,McDowell,2022-01-28
56,26,30,0,McDowell,2022-01-29
41,16,25,0,McDowell,2022-01-30
103,42,61,0,McDowell,2022-01-31
42,21,21,0,McDowell,2022-02-05
36,16,20,0,McDowell,2022-02-09
21,9,12,0,McDowell,2022-02-12
19,6,13,0,McDowell,2022-02-13
41,15,26,0,McDowell,2022-02-15
28,4,24,0,McDowell,2022-02-18
6,2,4,0,McDowell,2022-02-19
13,1,12,0,McDowell,2022-02-20
17,4,13,0,McDowell,2022-02-22
15,3,12,0,McDowell,2022-02-23
13,2,11,0,McDowell,2022-02-24
6,1,5,0,McDowell,2022-02-25
3,2,1,0,McDowell,2022-02-26
7,1,6,0,McDowell,2022-02-27
10,1,9,0,McDowell,2022-02-28
12,1,11,0,McDowell,2022-03-01
4,0,4,0,McDowell,2022-03-04
5,2,3,0,McDowell,2022-03-05
6,1,5,0,McDowell,2022-03-07
3,1,2,0,McDowell,2022-03-09
4,3,1,0,McDowell,2022-03-10
2,0,2,0,McDowell,2022-03-11
0,0,0,0,McDowell,2022-03-12
1,1,0,0,McDowell,2022-03-13
2,0,2,0,McDowell,2022-03-14
3,0,3,0,McDowell,2022-03-15
5,1,4,0,McDowell,2022-03-16
1,1,0,0,McDowell,2022-03-17
1,0,1,0,McDowell,2022-03-18
0,0,0,0,McDowell,2022-03-19
1,1,0,0,McDowell,2022-03-20
2,1,1,0,McDowell,2022-03-21
0,0,0,0,McDowell,2022-03-23
0,0,0,0,McDowell,2022-03-24
2,0,2,0,McDowell,2022-03-25
0,0,0,0,McDowell,2022-03-26
0,0,0,0,McDowell,2022-03-27
2,0,2,0,McDowell,2022-03-28
3,0,3,0,McDowell,2022-03-29
1,0,1,0,McDowell,2022-03-30
0,0,0,0,McDowell,2022-03-31
5,0,5,0,McDowell,2022-04-01
2,0,2,0,McDowell,2022-04-02
0,0,0,0,McDowell,2022-04-03
3,2,1,0,McDowell,2022-04-04
1,0,1,0,McDowell,2022-04-05
2,2,0,0,McDowell,2022-04-06
4,0,4,0,McDowell,2022-04-07
2,1,1,0,McDowell,2022-04-08
2,0,2,0,McDowell,2022-04-09
1,0,1,0,McDowell,2022-04-10
3,0,3,0,McDowell,2022-04-11
2,0,2,0,McDowell,2022-04-12
2,0,2,0,McDowell,2022-04-13
4,2,2,0,McDowell,2022-04-14
0,0,0,0,McDowell,2022-04-15
1,0,1,0,McDowell,2022-04-16
0,0,0,0,McDowell,2022-04-17
4,1,3,0,McDowell,2022-04-18
5,2,3,0,McDowell,2022-04-19
7,1,6,0,McDowell,2022-04-20
6,3,3,0,McDowell,2022-04-21
5,2,3,0,McDowell,2022-04-22
3,1,2,0,McDowell,2022-04-23
0,0,0,0,McDowell,2022-04-24
5,0,5,0,McDowell,2022-04-25
6,0,6,0,McDowell,2022-04-26
5,1,4,0,McDowell,2022-04-27
3,1,2,0,McDowell,2022-04-28
7,4,3,0,McDowell,2022-04-29
1,0,1,0,McDowell,2022-04-30
1,0,1,0,McDowell,2022-05-01
9,2,7,0,McDowell,2022-05-02
7,0,7,0,McDowell,2022-05-03
9,2,7,0,McDowell,2022-05-04
8,2,6,0,McDowell,2022-05-05
9,0,9,0,McDowell,2022-05-06
3,0,3,0,McDowell,2022-05-07
5,1,4,0,McDowell,2022-05-08
17,4,13,0,McDowell,2022-05-09
3,0,3,0,McDowell,2022-05-10
13,0,13,0,McDowell,2022-05-11
3,2,1,0,McDowell,2022-05-12
9,0,9,0,McDowell,2022-05-13
7,0,7,0,McDowell,2022-05-14
6,0,6,0,McDowell,2022-05-15
12,0,12,0,McDowell,2022-05-16
15,3,12,0,McDowell,2022-05-17
20,4,16,0,McDowell,2022-05-18
8,1,7,0,McDowell,2022-05-19
12,0,12,0,McDowell,2022-05-20
10,0,10,0,McDowell,2022-05-21
8,1,7,0,McDowell,2022-05-22
26,3,23,0,McDowell,2022-05-23
18,1,17,0,McDowell,2022-05-24
12,1,11,0,McDowell,2022-05-25
12,0,12,0,McDowell,2022-05-26
14,1,13,0,McDowell,2022-05-27
8,0,8,0,McDowell,2022-05-28
10,0,10,0,McDowell,2022-05-29
14,1,13,0,McDowell,2022-05-31
20,0,20,0,McDowell,2022-06-01
21,1,20,0,McDowell,2022-06-02
7,1,6,0,McDowell,2022-06-03
13,0,13,0,McDowell,2022-06-04
366,59,307,0,Mecklenburg,2021-12-07
292,38,254,0,Mecklenburg,2021-12-10
353,73,280,0,Mecklenburg,2021-12-13
57,14,43,0,Mecklenburg,2022-02-26
95,24,71,0,Mecklenburg,2022-03-02
53,13,40,0,Mecklenburg,2022-03-09
28,8,20,0,Mecklenburg,2022-03-12
20,5,15,0,Mecklenburg,2022-03-13
52,9,43,0,Mecklenburg,2022-03-14
52,9,43,0,Mecklenburg,2022-03-15
37,7,30,0,Mecklenburg,2022-03-18
51,9,42,0,Mecklenburg,2022-03-22
66,18,48,0,Mecklenburg,2022-03-23
38,8,30,0,Mecklenburg,2022-03-26
39,5,34,0,Mecklenburg,2022-03-27
69,14,55,0,Mecklenburg,2022-03-30
69,17,52,0,Mecklenburg,2022-03-31
62,10,52,0,Mecklenburg,2022-04-01
92,24,68,0,Mecklenburg,2022-04-04
104,17,87,0,Mecklenburg,2022-04-05
108,19,89,0,Mecklenburg,2022-04-06
128,17,111,0,Mecklenburg,2022-04-07
46,4,42,0,Mecklenburg,2022-04-09
59,10,49,0,Mecklenburg,2022-04-10
151,22,129,0,Mecklenburg,2022-04-11
155,26,129,0,Mecklenburg,2022-04-12
182,23,159,0,Mecklenburg,2022-04-14
132,19,113,0,Mecklenburg,2022-04-15
111,16,95,0,Mecklenburg,2022-04-16
69,3,66,0,Mecklenburg,2022-04-17
226,34,192,0,Mecklenburg,2022-04-20
245,36,209,0,Mecklenburg,2022-04-21
175,30,145,0,Mecklenburg,2022-04-22
122,30,92,0,Mecklenburg,2022-04-23
141,27,114,0,Mecklenburg,2022-04-24
290,41,249,0,Mecklenburg,2022-04-25
270,54,216,0,Mecklenburg,2022-04-26
303,48,255,0,Mecklenburg,2022-04-27
263,51,212,0,Mecklenburg,2022-04-28
254,42,212,0,Mecklenburg,2022-04-29
158,35,123,0,Mecklenburg,2022-04-30
194,23,171,0,Mecklenburg,2022-05-01
394,67,327,0,Mecklenburg,2022-05-02
390,63,327,0,Mecklenburg,2022-05-03
369,67,302,0,Mecklenburg,2022-05-05
315,61,254,0,Mecklenburg,2022-05-06
233,28,205,0,Mecklenburg,2022-05-07
468,70,398,0,Mecklenburg,2022-05-09
485,57,428,0,Mecklenburg,2022-05-10
460,70,390,0,Mecklenburg,2022-05-13
309,27,282,0,Mecklenburg,2022-05-14
302,48,254,0,Mecklenburg,2022-05-15
468,90,378,0,Mecklenburg,2022-05-16
554,79,475,0,Mecklenburg,2022-05-17
522,77,445,0,Mecklenburg,2022-05-18
507,70,437,0,Mecklenburg,2022-05-19
415,67,348,0,Mecklenburg,2022-05-20
290,46,244,0,Mecklenburg,2022-05-21
319,45,274,0,Mecklenburg,2022-05-22
491,55,436,0,Mecklenburg,2022-05-24
510,76,434,0,Mecklenburg,2022-05-25
463,77,386,0,Mecklenburg,2022-05-26
275,39,236,0,Mecklenburg,2022-05-28
276,25,251,0,Mecklenburg,2022-05-29
220,38,182,0,Mecklenburg,2022-05-30
565,65,500,0,Mecklenburg,2022-06-01
411,62,349,0,Mecklenburg,2022-06-03
232,40,192,0,Mecklenburg,2022-06-04
12,8,4,0,Mitchell,2021-12-08
4,2,2,0,Mitchell,2021-12-09
12,5,7,0,Mitchell,2021-12-10
2,1,1,0,Mitchell,2021-12-11
2,1,1,0,Mitchell,2021-12-12
6,1,5,0,Mitchell,2021-12-13
11,8,3,0,Mitchell,2021-12-17
7,2,5,0,Mitchell,2021-12-18
2,1,1,0,Mitchell,2021-12-19
13,4,9,0,Mitchell,2021-12-20
8,5,3,0,Mitchell,2021-12-22
13,8,5,0,Mitchell,2021-12-23
4,1,3,0,Mitchell,2021-12-24
1,0,1,0,Mitchell,2021-12-25
34,23,11,0,Mitchell,2021-12-27
27,11,16,0,Mitchell,2021-12-29
9,2,7,0,Mitchell,2021-12-31
9,3,6,0,Mitchell,2022-01-01
5,2,3,0,Mitchell,2022-01-02
45,10,35,0,Mitchell,2022-01-04
15,6,9,0,Mitchell,2022-01-07
21,1,20,0,Mitchell,2022-01-08
8,1,7,0,Mitchell,2022-01-09
53,8,45,0,Mitchell,2022-01-10
29,1,28,0,Mitchell,2022-01-12
40,6,34,0,Mitchell,2022-01-14
20,6,14,0,Mitchell,2022-01-15
6,5,1,0,Mitchell,2022-01-17
21,6,15,0,Mitchell,2022-01-18
19,2,17,0,Mitchell,2022-01-20
25,3,22,0,Mitchell,2022-01-21
5,1,4,0,Mitchell,2022-01-23
26,11,15,0,Mitchell,2022-01-25
15,2,13,0,Mitchell,2022-01-26
18,7,11,0,Mitchell,2022-01-27
6,5,1,0,Mitchell,2022-01-29
7,4,3,0,Mitchell,2022-01-30
23,10,13,0,Mitchell,2022-01-31
30,15,15,0,Mitchell,2022-02-01
14,4,10,0,Mitchell,2022-02-02
22,2,20,0,Mitchell,2022-02-04
4,2,2,0,Mitchell,2022-02-05
3,1,2,0,Mitchell,2022-02-06
23,3,20,0,Mitchell,2022-02-07
22,6,16,0,Mitchell,2022-02-08
11,5,6,0,Mitchell,2022-02-09
11,5,6,0,Mitchell,2022-02-10
8,3,5,0,Mitchell,2022-02-11
6,4,2,0,Mitchell,2022-02-12
10,5,5,0,Mitchell,2022-02-14
8,6,2,0,Mitchell,2022-02-15
11,7,4,0,Mitchell,2022-02-16
0,0,0,0,Mitchell,2022-02-17
1,0,1,0,Mitchell,2022-02-19
1,0,1,0,Mitchell,2022-02-20
11,3,8,0,Mitchell,2022-02-21
4,1,3,0,Mitchell,2022-02-22
3,2,1,0,Mitchell,2022-02-23
3,1,2,0,Mitchell,2022-02-24
5,1,4,0,Mitchell,2022-02-25
3,1,2,0,Mitchell,2022-02-26
0,0,0,0,Mitchell,2022-02-27
3,1,2,0,Mitchell,2022-02-28
3,1,2,0,Mitchell,2022-03-01
3,2,1,0,Mitchell,2022-03-02
1,1,0,0,Mitchell,2022-03-03
1,1,0,0,Mitchell,2022-03-04
0,0,0,0,Mitchell,2022-03-05
0,0,0,0,Mitchell,2022-03-06
1,0,1,0,Mitchell,2022-03-07
1,0,1,0,Mitchell,2022-03-08
1,0,1,0,Mitchell,2022-03-09
0,0,0,0,Mitchell,2022-03-10
1,1,0,0,Mitchell,2022-03-11
0,0,0,0,Mitchell,2022-03-12
1,1,0,0,Mitchell,2022-03-13
0,0,0,0,Mitchell,2022-03-14
1,1,0,0,Mitchell,2022-03-15
0,0,0,0,Mitchell,2022-03-16
1,0,1,0,Mitchell,2022-03-17
0,0,0,0,Mitchell,2022-03-18
1,0,1,0,Mitchell,2022-03-19
1,1,0,0,Mitchell,2022-03-20
0,0,0,0,Mitchell,2022-03-22
0,0,0,0,Mitchell,2022-03-23
2,1,1,0,Mitchell,2022-03-24
1,0,1,0,Mitchell,2022-03-25
0,0,0,0,Mitchell,2022-03-26
0,0,0,0,Mitchell,2022-03-27
0,0,0,0,Mitchell,2022-03-28
1,0,1,0,Mitchell,2022-03-29
5,1,4,0,Mitchell,2022-03-30
2,1,1,0,Mitchell,2022-03-31
0,0,0,0,Mitchell,2022-04-01
0,0,0,0,Mitchell,2022-04-02
0,0,0,0,Mitchell,2022-04-03
0,0,0,0,Mitchell,2022-04-04
0,0,0,0,Mitchell,2022-04-05
0,0,0,0,Mitchell,2022-04-06
0,0,0,0,Mitchell,2022-04-07
1,1,0,0,Mitchell,2022-04-08
0,0,0,0,Mitchell,2022-04-09
0,0,0,0,Mitchell,2022-04-10
0,0,0,0,Mitchell,2022-04-11
1,1,0,0,Mitchell,2022-04-12
1,1,0,0,Mitchell,2022-04-13
0,0,0,0,Mitchell,2022-04-14
1,0,1,0,Mitchell,2022-04-15
0,0,0,0,Mitchell,2022-04-16
0,0,0,0,Mitchell,2022-04-17
0,0,0,0,Mitchell,2022-04-18
0,0,0,0,Mitchell,2022-04-19
1,0,1,0,Mitchell,2022-04-20
2,0,2,0,Mitchell,2022-04-21
2,0,2,0,Mitchell,2022-04-22
0,0,0,0,Mitchell,2022-04-23
0,0,0,0,Mitchell,2022-04-24
0,0,0,0,Mitchell,2022-04-25
1,0,1,0,Mitchell,2022-04-26
1,1,0,0,Mitchell,2022-04-27
0,0,0,0,Mitchell,2022-04-28
0,0,0,0,Mitchell,2022-04-29
0,0,0,0,Mitchell,2022-04-30
0,0,0,0,Mitchell,2022-05-01
0,0,0,0,Mitchell,2022-05-02
3,2,1,0,Mitchell,2022-05-03
3,2,1,0,Mitchell,2022-05-04
0,0,0,0,Mitchell,2022-05-05
1,1,0,0,Mitchell,2022-05-06
0,0,0,0,Mitchell,2022-05-07
0,0,0,0,Mitchell,2022-05-08
2,1,1,0,Mitchell,2022-05-09
1,0,1,0,Mitchell,2022-05-10
1,1,0,0,Mitchell,2022-05-11
4,3,1,0,Mitchell,2022-05-12
1,0,1,0,Mitchell,2022-05-13
6,5,1,0,Mitchell,2022-05-14
0,0,0,0,Mitchell,2022-05-15
5,3,2,0,Mitchell,2022-05-16
4,4,0,0,Mitchell,2022-05-17
3,3,0,0,Mitchell,2022-05-18
3,2,1,0,Mitchell,2022-05-19
5,1,4,0,Mitchell,2022-05-20
2,0,2,0,Mitchell,2022-05-21
3,0,3,0,Mitchell,2022-05-22
13,7,6,0,Mitchell,2022-05-23
1,0,1,0,Mitchell,2022-05-24
4,2,2,0,Mitchell,2022-05-25
5,3,2,0,Mitchell,2022-05-26
5,1,4,0,Mitchell,2022-05-27
0,0,0,0,Mitchell,2022-05-28
5,0,5,0,Mitchell,2022-05-29
5,0,5,0,Mitchell,2022-05-30
10,4,6,0,Mitchell,2022-05-31
4,2,2,0,Mitchell,2022-06-01
10,8,2,0,Mitchell,2022-06-02
12,8,4,0,Mitchell,2022-06-03
5,0,5,0,Mitchell,2022-06-04
6,1,5,0,Montgomery,2021-12-07
4,0,4,0,Montgomery,2021-12-09
6,0,6,0,Montgomery,2021-12-10
6,0,6,0,Montgomery,2021-12-11
3,0,3,0,Montgomery,2021-12-12
9,1,8,0,Montgomery,2021-12-13
10,0,10,0,Montgomery,2021-12-15
13,2,11,0,Montgomery,2021-12-16
5,0,5,0,Montgomery,2021-12-17
3,0,3,0,Montgomery,2021-12-18
2,1,1,0,Montgomery,2021-12-19
9,0,9,0,Montgomery,2021-12-20
13,3,10,0,Montgomery,2021-12-21
13,0,13,0,Montgomery,2021-12-22
10,2,8,0,Montgomery,2021-12-23
9,1,8,0,Montgomery,2021-12-24
1,0,1,0,Montgomery,2021-12-25
3,0,3,0,Montgomery,2021-12-26
25,5,20,0,Montgomery,2021-12-27
32,2,30,0,Montgomery,2021-12-29
28,6,22,0,Montgomery,2021-12-31
9,0,9,0,Montgomery,2022-01-01
20,2,18,0,Montgomery,2022-01-02
53,11,42,0,Montgomery,2022-01-03
83,9,74,0,Montgomery,2022-01-04
87,10,77,0,Montgomery,2022-01-06
139,17,122,0,Montgomery,2022-01-10
143,11,132,0,Montgomery,2022-01-11
98,12,86,0,Montgomery,2022-01-14
3,0,3,0,Montgomery,2022-01-16
61,17,44,0,Montgomery,2022-01-17
144,17,127,0,Montgomery,2022-01-18
55,12,43,0,Montgomery,2022-01-21
17,3,14,0,Montgomery,2022-01-22
17,3,14,0,Montgomery,2022-01-23
58,11,47,0,Montgomery,2022-01-25
56,3,53,0,Montgomery,2022-01-26
43,11,32,0,Montgomery,2022-01-27
37,5,32,0,Montgomery,2022-01-31
21,2,19,0,Montgomery,2022-02-01
12,2,10,0,Montgomery,2022-02-04
13,3,10,0,Montgomery,2022-02-10
16,1,15,0,Montgomery,2022-02-11
5,1,4,0,Montgomery,2022-02-13
8,0,8,0,Montgomery,2022-02-15
10,1,9,0,Montgomery,2022-02-16
7,1,6,0,Montgomery,2022-02-17
11,1,10,0,Montgomery,2022-02-18
2,0,2,0,Montgomery,2022-02-20
5,1,4,0,Montgomery,2022-02-21
7,3,4,0,Montgomery,2022-02-22
5,1,4,0,Montgomery,2022-02-23
4,1,3,0,Montgomery,2022-02-24
4,2,2,0,Montgomery,2022-02-25
0,0,0,0,Montgomery,2022-02-26
0,0,0,0,Montgomery,2022-02-27
2,1,1,0,Montgomery,2022-02-28
2,0,2,0,Montgomery,2022-03-01
1,0,1,0,Montgomery,2022-03-02
2,1,1,0,Montgomery,2022-03-03
2,0,2,0,Montgomery,2022-03-04
0,0,0,0,Montgomery,2022-03-05
0,0,0,0,Montgomery,2022-03-06
4,2,2,0,Montgomery,2022-03-07
1,0,1,0,Montgomery,2022-03-08
2,0,2,0,Montgomery,2022-03-09
0,0,0,0,Montgomery,2022-03-10
2,0,2,0,Montgomery,2022-03-11
0,0,0,0,Montgomery,2022-03-12
0,0,0,0,Montgomery,2022-03-13
1,1,0,0,Montgomery,2022-03-14
0,0,0,0,Montgomery,2022-03-15
0,0,0,0,Montgomery,2022-03-16
1,0,1,0,Montgomery,2022-03-17
0,0,0,0,Montgomery,2022-03-18
0,0,0,0,Montgomery,2022-03-19
0,0,0,0,Montgomery,2022-03-20
0,0,0,0,Montgomery,2022-03-21
1,0,1,0,Montgomery,2022-03-22
1,0,1,0,Montgomery,2022-03-23
0,0,0,0,Montgomery,2022-03-24
1,1,0,0,Montgomery,2022-03-25
1,0,1,0,Montgomery,2022-03-26
1,0,1,0,Montgomery,2022-03-27
0,0,0,0,Montgomery,2022-03-28
2,1,1,0,Montgomery,2022-03-29
0,0,0,0,Montgomery,2022-03-30
0,0,0,0,Montgomery,2022-03-31
0,0,0,0,Montgomery,2022-04-01
0,0,0,0,Montgomery,2022-04-02
0,0,0,0,Montgomery,2022-04-03
0,0,0,0,Montgomery,2022-04-04
1,0,1,0,Montgomery,2022-04-05
0,0,0,0,Montgomery,2022-04-06
0,0,0,0,Montgomery,2022-04-07
0,0,0,0,Montgomery,2022-04-08
0,0,0,0,Montgomery,2022-04-09
0,0,0,0,Montgomery,2022-04-10
0,0,0,0,Montgomery,2022-04-11
1,0,1,0,Montgomery,2022-04-12
0,0,0,0,Montgomery,2022-04-13
0,0,0,0,Montgomery,2022-04-14
0,0,0,0,Montgomery,2022-04-15
0,0,0,0,Montgomery,2022-04-16
0,0,0,0,Montgomery,2022-04-17
0,0,0,0,Montgomery,2022-04-18
0,0,0,0,Montgomery,2022-04-19
1,1,0,0,Montgomery,2022-04-20
0,0,0,0,Montgomery,2022-04-21
0,0,0,0,Montgomery,2022-04-22
0,0,0,0,Montgomery,2022-04-23
0,0,0,0,Montgomery,2022-04-24
5,5,0,0,Montgomery,2022-04-25
4,2,2,0,Montgomery,2022-04-26
4,1,3,0,Montgomery,2022-04-27
1,0,1,0,Montgomery,2022-04-28
2,1,1,0,Montgomery,2022-04-29
1,1,0,0,Montgomery,2022-04-30
0,0,0,0,Montgomery,2022-05-01
5,0,5,0,Montgomery,2022-05-02
5,1,4,0,Montgomery,2022-05-03
4,2,2,0,Montgomery,2022-05-04
4,1,3,0,Montgomery,2022-05-05
1,0,1,0,Montgomery,2022-05-06
0,0,0,0,Montgomery,2022-05-07
1,0,1,0,Montgomery,2022-05-08
2,0,2,0,Montgomery,2022-05-09
6,1,5,0,Montgomery,2022-05-10
1,0,1,0,Montgomery,2022-05-11
4,1,3,0,Montgomery,2022-05-12
4,0,4,0,Montgomery,2022-05-13
5,2,3,0,Montgomery,2022-05-14
6,0,6,0,Montgomery,2022-05-15
2,1,1,0,Montgomery,2022-05-17
2,0,2,0,Montgomery,2022-05-18
4,3,1,0,Montgomery,2022-05-19
5,2,3,0,Montgomery,2022-05-20
3,0,3,0,Montgomery,2022-05-21
2,0,2,0,Montgomery,2022-05-22
10,2,8,0,Montgomery,2022-05-23
2,1,1,0,Montgomery,2022-05-24
6,0,6,0,Montgomery,2022-05-25
6,2,4,0,Montgomery,2022-05-26
7,1,6,0,Montgomery,2022-05-27
6,4,2,0,Montgomery,2022-05-28
1,0,1,0,Montgomery,2022-05-29
5,2,3,0,Montgomery,2022-05-31
7,1,6,0,Montgomery,2022-06-01
3,1,2,0,Montgomery,2022-06-02
2,0,2,0,Montgomery,2022-06-03
3,1,2,0,Montgomery,2022-06-04
24,2,22,0,Moore,2021-12-10
22,0,22,0,Moore,2021-12-11
20,0,20,0,Moore,2021-12-12
28,2,26,0,Moore,2021-12-17
49,5,44,0,Moore,2021-12-20
75,13,62,0,Moore,2021-12-21
55,7,48,0,Moore,2021-12-23
40,1,39,0,Moore,2021-12-24
12,1,11,0,Moore,2021-12-25
100,7,93,0,Moore,2021-12-27
204,30,174,0,Moore,2021-12-29
179,24,155,0,Moore,2021-12-30
110,13,97,0,Moore,2021-12-31
80,12,68,0,Moore,2022-01-01
241,30,211,0,Moore,2022-01-03
268,15,253,0,Moore,2022-01-07
203,15,188,0,Moore,2022-01-08
427,41,386,0,Moore,2022-01-13
395,22,373,0,Moore,2022-01-14
206,20,186,0,Moore,2022-01-15
332,53,279,0,Moore,2022-01-17
168,33,135,0,Moore,2022-01-21
35,7,28,0,Moore,2022-01-22
104,10,94,0,Moore,2022-01-28
41,6,35,0,Moore,2022-01-29
155,24,131,0,Moore,2022-01-31
22,4,18,0,Moore,2022-02-05
27,6,21,0,Moore,2022-02-13
40,5,35,0,Moore,2022-02-17
20,6,14,0,Moore,2022-02-20
34,7,27,0,Moore,2022-02-21
31,5,26,0,Moore,2022-02-22
9,2,7,0,Moore,2022-02-25
7,3,4,0,Moore,2022-02-26
8,4,4,0,Moore,2022-02-27
17,3,14,0,Moore,2022-02-28
7,1,6,0,Moore,2022-03-02
10,1,9,0,Moore,2022-03-04
8,1,7,0,Moore,2022-03-07
4,1,3,0,Moore,2022-03-08
0,0,0,0,Moore,2022-03-12
3,1,2,0,Moore,2022-03-13
8,0,8,0,Moore,2022-03-14
6,0,6,0,Moore,2022-03-15
5,0,5,0,Moore,2022-03-16
3,0,3,0,Moore,2022-03-17
3,0,3,0,Moore,2022-03-18
1,0,1,0,Moore,2022-03-19
0,0,0,0,Moore,2022-03-20
2,0,2,0,Moore,2022-03-21
3,1,2,0,Moore,2022-03-22
1,0,1,0,Moore,2022-03-23
1,0,1,0,Moore,2022-03-24
1,0,1,0,Moore,2022-03-25
2,2,0,0,Moore,2022-03-26
2,1,1,0,Moore,2022-03-27
3,1,2,0,Moore,2022-03-28
0,0,0,0,Moore,2022-03-29
4,2,2,0,Moore,2022-03-30
3,1,2,0,Moore,2022-03-31
1,0,1,0,Moore,2022-04-01
1,1,0,0,Moore,2022-04-02
1,0,1,0,Moore,2022-04-03
3,1,2,0,Moore,2022-04-04
1,0,1,0,Moore,2022-04-05
6,2,4,0,Moore,2022-04-07
2,1,1,0,Moore,2022-04-08
2,0,2,0,Moore,2022-04-09
1,0,1,0,Moore,2022-04-10
9,2,7,0,Moore,2022-04-11
5,2,3,0,Moore,2022-04-12
10,5,5,0,Moore,2022-04-14
7,3,4,0,Moore,2022-04-15
12,3,9,0,Moore,2022-04-16
4,2,2,0,Moore,2022-04-17
10,2,8,0,Moore,2022-04-18
14,6,8,0,Moore,2022-04-19
11,2,9,0,Moore,2022-04-20
10,2,8,0,Moore,2022-04-21
7,3,4,0,Moore,2022-04-22
13,7,6,0,Moore,2022-04-23
10,3,7,0,Moore,2022-04-24
12,5,7,0,Moore,2022-04-25
10,3,7,0,Moore,2022-04-26
15,4,11,0,Moore,2022-04-27
13,4,9,0,Moore,2022-04-29
12,4,8,0,Moore,2022-04-30
8,6,2,0,Moore,2022-05-01
32,10,22,0,Moore,2022-05-02
24,11,13,0,Moore,2022-05-04
14,2,12,0,Moore,2022-05-05
23,10,13,0,Moore,2022-05-06
15,2,13,0,Moore,2022-05-07
13,2,11,0,Moore,2022-05-08
35,14,21,0,Moore,2022-05-09
15,1,14,0,Moore,2022-05-10
44,19,25,0,Moore,2022-05-12
23,10,13,0,Moore,2022-05-13
14,6,8,0,Moore,2022-05-14
17,7,10,0,Moore,2022-05-15
42,14,28,0,Moore,2022-05-16
35,13,22,0,Moore,2022-05-17
36,10,26,0,Moore,2022-05-18
30,9,21,0,Moore,2022-05-19
27,6,21,0,Moore,2022-05-20
23,9,14,0,Moore,2022-05-21
31,11,20,0,Moore,2022-05-22
45,14,31,0,Moore,2022-05-23
26,5,21,0,Moore,2022-05-24
42,12,30,0,Moore,2022-05-25
26,8,18,0,Moore,2022-05-26
32,14,18,0,Moore,2022-05-27
36,9,27,0,Moore,2022-05-28
29,10,19,0,Moore,2022-05-29
19,10,9,0,Moore,2022-05-30
48,19,29,0,Moore,2022-05-31
39,13,26,0,Moore,2022-06-01
37,14,23,0,Moore,2022-06-02
22,9,13,0,Moore,2022-06-03
12,4,8,0,Moore,2022-06-04
25,5,20,0,Nash,2021-12-07
29,2,27,0,Nash,2021-12-09
11,0,11,0,Nash,2021-12-11
12,1,11,0,Nash,2021-12-12
40,3,37,0,Nash,2021-12-13
29,4,25,0,Nash,2021-12-14
62,0,62,0,Nash,2021-12-20
66,13,53,0,Nash,2021-12-22
43,10,33,0,Nash,2021-12-24
29,5,24,0,Nash,2021-12-25
60,8,52,0,Nash,2021-12-26
294,39,255,0,Nash,2021-12-29
395,56,339,0,Nash,2021-12-30
64,7,57,0,Nash,2022-01-01
122,8,114,0,Nash,2022-01-02
99,12,87,0,Nash,2022-01-08
359,25,334,0,Nash,2022-01-11
295,22,273,0,Nash,2022-01-14
266,34,232,0,Nash,2022-01-17
271,27,244,0,Nash,2022-01-20
30,1,29,0,Nash,2022-01-22
96,12,84,0,Nash,2022-02-01
75,15,60,0,Nash,2022-02-03
33,12,21,0,Nash,2022-02-06
51,9,42,0,Nash,2022-02-09
10,2,8,0,Nash,2022-02-13
32,10,22,0,Nash,2022-02-14
21,2,19,0,Nash,2022-02-21
18,1,17,0,Nash,2022-02-24
15,1,14,0,Nash,2022-02-25
6,2,4,0,Nash,2022-02-27
11,4,7,0,Nash,2022-02-28
6,2,4,0,Nash,2022-03-01
6,4,2,0,Nash,2022-03-02
8,2,6,0,Nash,2022-03-03
4,0,4,0,Nash,2022-03-04
7,0,7,0,Nash,2022-03-05
5,0,5,0,Nash,2022-03-07
6,0,6,0,Nash,2022-03-08
4,0,4,0,Nash,2022-03-09
5,0,5,0,Nash,2022-03-10
3,1,2,0,Nash,2022-03-11
1,0,1,0,Nash,2022-03-12
3,0,3,0,Nash,2022-03-13
3,0,3,0,Nash,2022-03-15
3,0,3,0,Nash,2022-03-16
6,0,6,0,Nash,2022-03-17
2,0,2,0,Nash,2022-03-18
0,0,0,0,Nash,2022-03-19
1,0,1,0,Nash,2022-03-20
4,0,4,0,Nash,2022-03-21
6,0,6,0,Nash,2022-03-23
2,0,2,0,Nash,2022-03-25
0,0,0,0,Nash,2022-03-26
2,0,2,0,Nash,2022-03-27
3,1,2,0,Nash,2022-03-28
1,0,1,0,Nash,2022-03-29
1,0,1,0,Nash,2022-03-30
0,0,0,0,Nash,2022-03-31
1,0,1,0,Nash,2022-04-01
0,0,0,0,Nash,2022-04-03
2,0,2,0,Nash,2022-04-04
2,0,2,0,Nash,2022-04-05
3,0,3,0,Nash,2022-04-07
1,0,1,0,Nash,2022-04-08
2,0,2,0,Nash,2022-04-09
9,1,8,0,Nash,2022-04-11
7,0,7,0,Nash,2022-04-13
7,3,4,0,Nash,2022-04-14
4,0,4,0,Nash,2022-04-15
2,0,2,0,Nash,2022-04-17
5,1,4,0,Nash,2022-04-18
9,6,3,0,Nash,2022-04-19
13,2,11,0,Nash,2022-04-20
21,3,18,0,Nash,2022-04-21
6,1,5,0,Nash,2022-04-22
5,1,4,0,Nash,2022-04-23
6,2,4,0,Nash,2022-04-24
5,0,5,0,Nash,2022-04-25
8,3,5,0,Nash,2022-04-26
10,0,10,0,Nash,2022-04-28
12,5,7,0,Nash,2022-04-29
5,0,5,0,Nash,2022-04-30
2,0,2,0,Nash,2022-05-01
10,4,6,0,Nash,2022-05-02
10,0,10,0,Nash,2022-05-03
14,4,10,0,Nash,2022-05-04
9,1,8,0,Nash,2022-05-05
7,3,4,0,Nash,2022-05-06
7,1,6,0,Nash,2022-05-07
7,1,6,0,Nash,2022-05-08
21,3,18,0,Nash,2022-05-09
18,5,13,0,Nash,2022-05-10
22,7,15,0,Nash,2022-05-11
27,6,21,0,Nash,2022-05-12
11,5,6,0,Nash,2022-05-13
16,3,13,0,Nash,2022-05-14
8,3,5,0,Nash,2022-05-15
39,10,29,0,Nash,2022-05-16
33,6,27,0,Nash,2022-05-17
29,7,22,0,Nash,2022-05-18
31,8,23,0,Nash,2022-05-19
33,5,28,0,Nash,2022-05-20
22,4,18,0,Nash,2022-05-21
25,6,19,0,Nash,2022-05-22
29,10,19,0,Nash,2022-05-23
26,6,20,0,Nash,2022-05-25
31,5,26,0,Nash,2022-05-26
27,8,19,0,Nash,2022-05-27
14,6,8,0,Nash,2022-05-28
25,6,19,0,Nash,2022-05-29
55,20,35,0,Nash,2022-05-31
37,1,36,0,Nash,2022-06-01
35,6,29,0,Nash,2022-06-02
24,7,17,0,Nash,2022-06-03
14,7,7,0,Nash,2022-06-04
45,15,30,0,New Hanover,2021-12-09
33,8,25,0,New Hanover,2021-12-10
20,9,11,0,New Hanover,2021-12-12
49,10,39,0,New Hanover,2021-12-13
57,19,38,0,New Hanover,2021-12-15
68,14,54,0,New Hanover,2021-12-17
50,9,41,0,New Hanover,2021-12-18
37,10,27,0,New Hanover,2021-12-19
124,51,73,0,New Hanover,2021-12-20
154,33,121,0,New Hanover,2021-12-21
195,36,159,0,New Hanover,2021-12-22
200,53,147,0,New Hanover,2021-12-23
104,36,68,0,New Hanover,2021-12-24
104,20,84,0,New Hanover,2021-12-26
395,100,295,0,New Hanover,2021-12-27
472,95,377,0,New Hanover,2021-12-29
480,148,332,0,New Hanover,2021-12-30
191,59,132,0,New Hanover,2022-01-02
645,169,476,0,New Hanover,2022-01-03
716,243,473,0,New Hanover,2022-01-04
569,105,464,0,New Hanover,2022-01-07
682,129,553,0,New Hanover,2022-01-14
766,145,621,0,New Hanover,2022-01-17
257,69,188,0,New Hanover,2022-02-02
84,27,57,0,New Hanover,2022-02-11
37,8,29,0,New Hanover,2022-02-18
38,12,26,0,New Hanover,2022-02-23
32,5,27,0,New Hanover,2022-02-24
12,3,9,0,New Hanover,2022-03-01
10,0,10,0,New Hanover,2022-03-04
5,2,3,0,New Hanover,2022-03-06
14,4,10,0,New Hanover,2022-03-07
17,5,12,0,New Hanover,2022-03-09
6,3,3,0,New Hanover,2022-03-13
8,0,8,0,New Hanover,2022-03-14
11,3,8,0,New Hanover,2022-03-15
6,0,6,0,New Hanover,2022-03-16
3,1,2,0,New Hanover,2022-03-19
8,2,6,0,New Hanover,2022-03-20
6,1,5,0,New Hanover,2022-03-22
16,4,12,0,New Hanover,2022-03-23
8,3,5,0,New Hanover,2022-03-24
7,1,6,0,New Hanover,2022-03-25
0,0,0,0,New Hanover,2022-03-26
4,0,4,0,New Hanover,2022-03-27
5,1,4,0,New Hanover,2022-03-28
10,2,8,0,New Hanover,2022-03-29
10,4,6,0,New Hanover,2022-03-30
8,5,3,0,New Hanover,2022-03-31
9,5,4,0,New Hanover,2022-04-01
6,0,6,0,New Hanover,2022-04-02
5,1,4,0,New Hanover,2022-04-03
17,6,11,0,New Hanover,2022-04-04
14,3,11,0,New Hanover,2022-04-05
11,4,7,0,New Hanover,2022-04-08
8,1,7,0,New Hanover,2022-04-09
6,2,4,0,New Hanover,2022-04-10
16,8,8,0,New Hanover,2022-04-11
20,1,19,0,New Hanover,2022-04-12
36,11,25,0,New Hanover,2022-04-13
24,5,19,0,New Hanover,2022-04-14
18,4,14,0,New Hanover,2022-04-15
8,1,7,0,New Hanover,2022-04-16
5,1,4,0,New Hanover,2022-04-17
36,6,30,0,New Hanover,2022-04-18
26,7,19,0,New Hanover,2022-04-19
31,8,23,0,New Hanover,2022-04-20
24,5,19,0,New Hanover,2022-04-21
26,2,24,0,New Hanover,2022-04-22
27,6,21,0,New Hanover,2022-04-23
16,4,12,0,New Hanover,2022-04-24
50,9,41,0,New Hanover,2022-04-25
41,11,30,0,New Hanover,2022-04-26
39,15,24,0,New Hanover,2022-04-27
38,8,30,0,New Hanover,2022-04-28
41,12,29,0,New Hanover,2022-04-29
11,4,7,0,New Hanover,2022-04-30
56,17,39,0,New Hanover,2022-05-02
40,10,30,0,New Hanover,2022-05-03
61,10,51,0,New Hanover,2022-05-04
51,8,43,0,New Hanover,2022-05-05
48,15,33,0,New Hanover,2022-05-06
22,8,14,0,New Hanover,2022-05-07
19,1,18,0,New Hanover,2022-05-08
69,11,58,0,New Hanover,2022-05-09
48,12,36,0,New Hanover,2022-05-10
64,14,50,0,New Hanover,2022-05-11
52,7,45,0,New Hanover,2022-05-12
54,10,44,0,New Hanover,2022-05-13
32,6,26,0,New Hanover,2022-05-14
44,19,25,0,New Hanover,2022-05-15
76,17,59,0,New Hanover,2022-05-16
79,15,64,0,New Hanover,2022-05-17
69,12,57,0,New Hanover,2022-05-18
87,12,75,0,New Hanover,2022-05-19
77,21,56,0,New Hanover,2022-05-20
35,7,28,0,New Hanover,2022-05-21
31,10,21,0,New Hanover,2022-05-22
73,21,52,0,New Hanover,2022-05-23
89,15,74,0,New Hanover,2022-05-24
78,15,63,0,New Hanover,2022-05-26
55,14,41,0,New Hanover,2022-05-27
34,6,28,0,New Hanover,2022-05-28
29,3,26,0,New Hanover,2022-05-29
31,8,23,0,New Hanover,2022-05-30
104,11,93,0,New Hanover,2022-05-31
83,16,67,0,New Hanover,2022-06-01
82,11,71,0,New Hanover,2022-06-02
58,17,41,0,New Hanover,2022-06-03
42,4,38,0,New Hanover,2022-06-04
2,0,2,0,Northampton,2021-12-07
4,2,2,0,Northampton,2021-12-08
1,0,1,0,Northampton,2021-12-09
2,1,1,0,Northampton,2021-12-10
0,0,0,0,Northampton,2021-12-11
0,0,0,0,Northampton,2021-12-12
2,1,1,0,Northampton,2021-12-15
10,0,10,0,Northampton,2021-12-16
3,2,1,0,Northampton,2021-12-18
1,0,1,0,Northampton,2021-12-19
7,2,5,0,Northampton,2021-12-20
8,1,7,0,Northampton,2021-12-21
9,2,7,0,Northampton,2021-12-22
10,2,8,0,Northampton,2021-12-23
2,0,2,0,Northampton,2021-12-24
3,0,3,0,Northampton,2021-12-25
6,0,6,0,Northampton,2021-12-26
29,2,27,0,Northampton,2021-12-27
37,6,31,0,Northampton,2021-12-28
52,11,41,0,Northampton,2021-12-29
63,13,50,0,Northampton,2021-12-30
48,1,47,0,Northampton,2021-12-31
15,3,12,0,Northampton,2022-01-01
18,2,16,0,Northampton,2022-01-02
61,10,51,0,Northampton,2022-01-03
91,10,81,0,Northampton,2022-01-04
67,12,55,0,Northampton,2022-01-05
86,12,74,0,Northampton,2022-01-07
24,6,18,0,Northampton,2022-01-09
90,16,74,0,Northampton,2022-01-10
59,7,52,0,Northampton,2022-01-13
42,7,35,0,Northampton,2022-01-14
15,2,13,0,Northampton,2022-01-15
5,1,4,0,Northampton,2022-01-16
37,9,28,0,Northampton,2022-01-17
74,21,53,0,Northampton,2022-01-18
57,4,53,0,Northampton,2022-01-19
51,7,44,0,Northampton,2022-01-20
3,1,2,0,Northampton,2022-01-22
8,0,8,0,Northampton,2022-01-23
46,13,33,0,Northampton,2022-01-25
24,5,19,0,Northampton,2022-01-26
6,1,5,0,Northampton,2022-01-29
20,6,14,0,Northampton,2022-02-01
6,2,4,0,Northampton,2022-02-03
2,1,1,0,Northampton,2022-02-05
4,1,3,0,Northampton,2022-02-06
9,1,8,0,Northampton,2022-02-07
1,0,1,0,Northampton,2022-02-08
6,2,4,0,Northampton,2022-02-09
6,0,6,0,Northampton,2022-02-10
3,0,3,0,Northampton,2022-02-11
8,0,8,0,Northampton,2022-02-14
7,0,7,0,Northampton,2022-02-15
2,0,2,0,Northampton,2022-02-16
4,0,4,0,Northampton,2022-02-17
1,0,1,0,Northampton,2022-02-18
0,0,0,0,Northampton,2022-02-19
2,0,2,0,Northampton,2022-02-20
5,2,3,0,Northampton,2022-02-21
1,0,1,0,Northampton,2022-02-23
1,0,1,0,Northampton,2022-02-24
1,0,1,0,Northampton,2022-02-25
1,0,1,0,Northampton,2022-02-26
1,0,1,0,Northampton,2022-02-28
0,0,0,0,Northampton,2022-03-01
1,0,1,0,Northampton,2022-03-02
2,1,1,0,Northampton,2022-03-03
1,1,0,0,Northampton,2022-03-04
0,0,0,0,Northampton,2022-03-05
1,0,1,0,Northampton,2022-03-06
1,0,1,0,Northampton,2022-03-07
0,0,0,0,Northampton,2022-03-08
0,0,0,0,Northampton,2022-03-09
0,0,0,0,Northampton,2022-03-10
0,0,0,0,Northampton,2022-03-11
1,0,1,0,Northampton,2022-03-12
0,0,0,0,Northampton,2022-03-13
0,0,0,0,Northampton,2022-03-14
0,0,0,0,Northampton,2022-03-15
0,0,0,0,Northampton,2022-03-17
0,0,0,0,Northampton,2022-03-18
0,0,0,0,Northampton,2022-03-19
0,0,0,0,Northampton,2022-03-20
4,0,4,0,Northampton,2022-03-21
1,0,1,0,Northampton,2022-03-22
0,0,0,0,Northampton,2022-03-23
0,0,0,0,Northampton,2022-03-24
0,0,0,0,Northampton,2022-03-25
0,0,0,0,Northampton,2022-03-26
0,0,0,0,Northampton,2022-03-27
0,0,0,0,Northampton,2022-03-28
0,0,0,0,Northampton,2022-03-29
0,0,0,0,Northampton,2022-03-30
0,0,0,0,Northampton,2022-03-31
0,0,0,0,Northampton,2022-04-01
0,0,0,0,Northampton,2022-04-02
0,0,0,0,Northampton,2022-04-03
0,0,0,0,Northampton,2022-04-04
0,0,0,0,Northampton,2022-04-05
1,1,0,0,Northampton,2022-04-06
0,0,0,0,Northampton,2022-04-07
1,0,1,0,Northampton,2022-04-08
0,0,0,0,Northampton,2022-04-09
0,0,0,0,Northampton,2022-04-10
0,0,0,0,Northampton,2022-04-11
0,0,0,0,Northampton,2022-04-12
1,0,1,0,Northampton,2022-04-13
0,0,0,0,Northampton,2022-04-14
0,0,0,0,Northampton,2022-04-15
1,0,1,0,Northampton,2022-04-16
0,0,0,0,Northampton,2022-04-17
0,0,0,0,Northampton,2022-04-18
1,0,1,0,Northampton,2022-04-19
2,0,2,0,Northampton,2022-04-20
1,0,1,0,Northampton,2022-04-21
1,1,0,0,Northampton,2022-04-22
0,0,0,0,Northampton,2022-04-23
0,0,0,0,Northampton,2022-04-24
3,2,1,0,Northampton,2022-04-25
6,0,6,0,Northampton,2022-04-26
0,0,0,0,Northampton,2022-04-27
1,0,1,0,Northampton,2022-04-28
2,0,2,0,Northampton,2022-04-29
0,0,0,0,Northampton,2022-04-30
0,0,0,0,Northampton,2022-05-01
3,0,3,0,Northampton,2022-05-02
3,0,3,0,Northampton,2022-05-03
5,2,3,0,Northampton,2022-05-04
2,1,1,0,Northampton,2022-05-05
0,0,0,0,Northampton,2022-05-06
1,0,1,0,Northampton,2022-05-07
1,1,0,0,Northampton,2022-05-08
4,0,4,0,Northampton,2022-05-09
5,4,1,0,Northampton,2022-05-10
3,0,3,0,Northampton,2022-05-11
5,5,0,0,Northampton,2022-05-12
0,0,0,0,Northampton,2022-05-13
1,0,1,0,Northampton,2022-05-14
0,0,0,0,Northampton,2022-05-15
9,2,7,0,Northampton,2022-05-16
3,0,3,0,Northampton,2022-05-17
3,2,1,0,Northampton,2022-05-18
8,0,8,0,Northampton,2022-05-19
10,4,6,0,Northampton,2022-05-20
1,1,0,0,Northampton,2022-05-21
3,1,2,0,Northampton,2022-05-22
4,1,3,0,Northampton,2022-05-23
9,5,4,0,Northampton,2022-05-24
8,3,5,0,Northampton,2022-05-25
3,2,1,0,Northampton,2022-05-26
8,2,6,0,Northampton,2022-05-27
2,1,1,0,Northampton,2022-05-28
3,1,2,0,Northampton,2022-05-29
1,1,0,0,Northampton,2022-05-30
14,6,8,0,Northampton,2022-05-31
13,4,9,0,Northampton,2022-06-01
6,2,4,0,Northampton,2022-06-02
11,1,10,0,Northampton,2022-06-03
4,0,4,0,Northampton,2022-06-04
43,9,34,0,Onslow,2021-12-09
18,0,18,0,Onslow,2021-12-12
49,3,46,0,Onslow,2021-12-17
83,11,72,0,Onslow,2021-12-22
83,14,69,0,Onslow,2021-12-23
47,7,40,0,Onslow,2021-12-24
15,0,15,0,Onslow,2021-12-25
214,25,189,0,Onslow,2021-12-27
321,29,292,0,Onslow,2021-12-29
342,57,285,0,Onslow,2021-12-30
162,51,111,0,Onslow,2021-12-31
140,55,85,0,Onslow,2022-01-02
441,91,350,0,Onslow,2022-01-03
841,131,710,0,Onslow,2022-01-04
741,81,660,0,Onslow,2022-01-06
189,51,138,0,Onslow,2022-01-08
224,48,176,0,Onslow,2022-01-09
932,127,805,0,Onslow,2022-01-13
704,114,590,0,Onslow,2022-01-17
1154,91,1063,0,Onslow,2022-01-18
129,4,125,0,Onslow,2022-01-30
437,55,382,0,Onslow,2022-01-31
154,20,134,0,Onslow,2022-02-08
88,11,77,0,Onslow,2022-02-15
16,3,13,0,Onslow,2022-02-19
20,2,18,0,Onslow,2022-02-20
21,0,21,0,Onslow,2022-02-21
37,4,33,0,Onslow,2022-02-23
29,1,28,0,Onslow,2022-02-25
35,7,28,0,Onslow,2022-02-28
18,7,11,0,Onslow,2022-03-01
17,4,13,0,Onslow,2022-03-03
7,1,6,0,Onslow,2022-03-04
6,1,5,0,Onslow,2022-03-06
16,1,15,0,Onslow,2022-03-07
21,4,17,0,Onslow,2022-03-08
5,1,4,0,Onslow,2022-03-09
3,0,3,0,Onslow,2022-03-12
6,1,5,0,Onslow,2022-03-13
5,0,5,0,Onslow,2022-03-15
5,0,5,0,Onslow,2022-03-17
6,0,6,0,Onslow,2022-03-18
3,0,3,0,Onslow,2022-03-19
4,1,3,0,Onslow,2022-03-20
7,0,7,0,Onslow,2022-03-21
4,1,3,0,Onslow,2022-03-23
3,0,3,0,Onslow,2022-03-24
4,1,3,0,Onslow,2022-03-25
5,3,2,0,Onslow,2022-03-26
5,4,1,0,Onslow,2022-03-27
3,0,3,0,Onslow,2022-03-28
4,1,3,0,Onslow,2022-03-29
6,2,4,0,Onslow,2022-03-30
5,1,4,0,Onslow,2022-03-31
2,1,1,0,Onslow,2022-04-01
1,0,1,0,Onslow,2022-04-02
0,0,0,0,Onslow,2022-04-03
2,1,1,0,Onslow,2022-04-04
8,0,8,0,Onslow,2022-04-05
6,0,6,0,Onslow,2022-04-06
8,1,7,0,Onslow,2022-04-08
5,0,5,0,Onslow,2022-04-09
8,1,7,0,Onslow,2022-04-10
9,0,9,0,Onslow,2022-04-12
11,2,9,0,Onslow,2022-04-13
8,2,6,0,Onslow,2022-04-14
2,0,2,0,Onslow,2022-04-15
8,0,8,0,Onslow,2022-04-16
2,0,2,0,Onslow,2022-04-17
19,4,15,0,Onslow,2022-04-18
18,3,15,0,Onslow,2022-04-19
16,2,14,0,Onslow,2022-04-20
11,2,9,0,Onslow,2022-04-21
19,1,18,0,Onslow,2022-04-22
9,0,9,0,Onslow,2022-04-23
9,2,7,0,Onslow,2022-04-24
22,4,18,0,Onslow,2022-04-25
21,4,17,0,Onslow,2022-04-26
22,4,18,0,Onslow,2022-04-27
26,1,25,0,Onslow,2022-04-28
23,3,20,0,Onslow,2022-04-29
21,3,18,0,Onslow,2022-05-01
44,4,40,0,Onslow,2022-05-02
31,3,28,0,Onslow,2022-05-03
48,9,39,0,Onslow,2022-05-04
41,7,34,0,Onslow,2022-05-05
25,3,22,0,Onslow,2022-05-06
13,0,13,0,Onslow,2022-05-07
66,15,51,0,Onslow,2022-05-09
58,6,52,0,Onslow,2022-05-10
72,15,57,0,Onslow,2022-05-11
63,5,58,0,Onslow,2022-05-12
55,12,43,0,Onslow,2022-05-13
23,3,20,0,Onslow,2022-05-14
24,1,23,0,Onslow,2022-05-15
82,6,76,0,Onslow,2022-05-17
90,11,79,0,Onslow,2022-05-18
72,12,60,0,Onslow,2022-05-19
55,4,51,0,Onslow,2022-05-20
31,6,25,0,Onslow,2022-05-22
107,9,98,0,Onslow,2022-05-23
95,14,81,0,Onslow,2022-05-25
67,7,60,0,Onslow,2022-05-26
44,10,34,0,Onslow,2022-05-27
20,5,15,0,Onslow,2022-05-28
24,6,18,0,Onslow,2022-05-29
15,10,5,0,Onslow,2022-05-30
136,19,117,0,Onslow,2022-05-31
105,5,100,0,Onslow,2022-06-01
59,7,52,0,Onslow,2022-06-02
23,4,19,0,Onslow,2022-06-03
14,2,12,0,Onslow,2022-06-04
31,1,30,0,Orange,2021-12-07
25,0,25,0,Orange,2021-12-09
10,0,10,0,Orange,2021-12-12
44,1,43,0,Orange,2021-12-15
63,2,61,0,Orange,2021-12-16
30,1,29,0,Orange,2021-12-18
31,4,27,0,Orange,2021-12-19
94,2,92,0,Orange,2021-12-20
115,10,105,0,Orange,2021-12-21
120,2,118,0,Orange,2021-12-22
125,9,116,0,Orange,2021-12-23
53,9,44,0,Orange,2021-12-24
19,4,15,0,Orange,2021-12-25
113,1,112,0,Orange,2021-12-26
245,20,225,0,Orange,2021-12-27
309,14,295,0,Orange,2021-12-28
332,22,310,0,Orange,2021-12-29
287,14,273,0,Orange,2021-12-30
136,7,129,0,Orange,2021-12-31
94,8,86,0,Orange,2022-01-01
145,7,138,0,Orange,2022-01-02
481,29,452,0,Orange,2022-01-03
489,24,465,0,Orange,2022-01-05
354,15,339,0,Orange,2022-01-07
580,21,559,0,Orange,2022-01-10
586,25,561,0,Orange,2022-01-11
489,25,464,0,Orange,2022-01-12
521,25,496,0,Orange,2022-01-13
212,14,198,0,Orange,2022-01-17
515,25,490,0,Orange,2022-01-18
192,6,186,0,Orange,2022-01-21
49,6,43,0,Orange,2022-01-22
253,10,243,0,Orange,2022-01-26
170,11,159,0,Orange,2022-01-28
75,4,71,0,Orange,2022-01-29
226,11,215,0,Orange,2022-01-31
152,9,143,0,Orange,2022-02-01
127,7,120,0,Orange,2022-02-02
141,9,132,0,Orange,2022-02-03
53,3,50,0,Orange,2022-02-05
134,8,126,0,Orange,2022-02-07
91,3,88,0,Orange,2022-02-08
88,3,85,0,Orange,2022-02-09
58,3,55,0,Orange,2022-02-11
15,2,13,0,Orange,2022-02-13
76,3,73,0,Orange,2022-02-14
56,5,51,0,Orange,2022-02-15
43,2,41,0,Orange,2022-02-17
22,2,20,0,Orange,2022-02-19
14,3,11,0,Orange,2022-02-20
28,1,27,0,Orange,2022-02-22
32,2,30,0,Orange,2022-02-23
28,2,26,0,Orange,2022-02-24
17,1,16,0,Orange,2022-02-25
5,2,3,0,Orange,2022-02-26
4,1,3,0,Orange,2022-02-27
22,1,21,0,Orange,2022-02-28
16,1,15,0,Orange,2022-03-01
12,2,10,0,Orange,2022-03-02
13,3,10,0,Orange,2022-03-04
7,0,7,0,Orange,2022-03-05
7,0,7,0,Orange,2022-03-06
13,1,12,0,Orange,2022-03-08
20,3,17,0,Orange,2022-03-09
15,0,15,0,Orange,2022-03-10
9,1,8,0,Orange,2022-03-11
9,3,6,0,Orange,2022-03-12
6,0,6,0,Orange,2022-03-13
6,0,6,0,Orange,2022-03-14
10,2,8,0,Orange,2022-03-15
11,0,11,0,Orange,2022-03-16
9,1,8,0,Orange,2022-03-18
4,2,2,0,Orange,2022-03-20
21,4,17,0,Orange,2022-03-21
17,3,14,0,Orange,2022-03-22
19,1,18,0,Orange,2022-03-23
13,1,12,0,Orange,2022-03-24
19,6,13,0,Orange,2022-03-25
5,0,5,0,Orange,2022-03-26
10,0,10,0,Orange,2022-03-27
20,1,19,0,Orange,2022-03-28
21,1,20,0,Orange,2022-03-29
20,1,19,0,Orange,2022-03-30
22,2,20,0,Orange,2022-03-31
11,5,6,0,Orange,2022-04-01
7,1,6,0,Orange,2022-04-02
9,2,7,0,Orange,2022-04-03
29,3,26,0,Orange,2022-04-04
29,4,25,0,Orange,2022-04-05
57,2,55,0,Orange,2022-04-06
55,4,51,0,Orange,2022-04-07
97,2,95,0,Orange,2022-04-08
26,2,24,0,Orange,2022-04-10
135,6,129,0,Orange,2022-04-11
94,5,89,0,Orange,2022-04-12
75,4,71,0,Orange,2022-04-14
30,1,29,0,Orange,2022-04-16
9,1,8,0,Orange,2022-04-17
92,5,87,0,Orange,2022-04-18
83,3,80,0,Orange,2022-04-19
52,6,46,0,Orange,2022-04-20
61,7,54,0,Orange,2022-04-21
52,3,49,0,Orange,2022-04-22
31,3,28,0,Orange,2022-04-23
18,5,13,0,Orange,2022-04-24
57,5,52,0,Orange,2022-04-25
57,6,51,0,Orange,2022-04-26
53,3,50,0,Orange,2022-04-27
52,7,45,0,Orange,2022-04-28
51,4,47,0,Orange,2022-04-29
31,4,27,0,Orange,2022-04-30
25,2,23,0,Orange,2022-05-01
80,12,68,0,Orange,2022-05-02
92,10,82,0,Orange,2022-05-03
71,4,67,0,Orange,2022-05-04
77,6,71,0,Orange,2022-05-05
63,4,59,0,Orange,2022-05-06
32,7,25,0,Orange,2022-05-07
31,5,26,0,Orange,2022-05-08
103,8,95,0,Orange,2022-05-09
82,4,78,0,Orange,2022-05-10
91,8,83,0,Orange,2022-05-11
83,9,74,0,Orange,2022-05-12
85,11,74,0,Orange,2022-05-13
62,14,48,0,Orange,2022-05-14
38,4,34,0,Orange,2022-05-15
151,18,133,0,Orange,2022-05-16
105,11,94,0,Orange,2022-05-17
92,12,80,0,Orange,2022-05-18
87,13,74,0,Orange,2022-05-19
76,8,68,0,Orange,2022-05-20
42,4,38,0,Orange,2022-05-21
37,1,36,0,Orange,2022-05-22
122,16,106,0,Orange,2022-05-23
81,14,67,0,Orange,2022-05-24
111,17,94,0,Orange,2022-05-25
88,14,74,0,Orange,2022-05-26
55,5,50,0,Orange,2022-05-27
62,6,56,0,Orange,2022-05-28
43,3,40,0,Orange,2022-05-29
40,3,37,0,Orange,2022-05-30
141,13,128,0,Orange,2022-05-31
96,9,87,0,Orange,2022-06-01
75,6,69,0,Orange,2022-06-02
70,6,64,0,Orange,2022-06-03
43,1,42,0,Orange,2022-06-04
1,0,1,0,Pamlico,2021-12-07
2,0,2,0,Pamlico,2021-12-09
4,3,1,0,Pamlico,2021-12-10
0,0,0,0,Pamlico,2021-12-11
0,0,0,0,Pamlico,2021-12-12
3,1,2,0,Pamlico,2021-12-13
1,1,0,0,Pamlico,2021-12-15
1,1,0,0,Pamlico,2021-12-16
3,2,1,0,Pamlico,2021-12-17
4,1,3,0,Pamlico,2021-12-19
5,2,3,0,Pamlico,2021-12-20
4,0,4,0,Pamlico,2021-12-21
2,0,2,0,Pamlico,2021-12-22
2,0,2,0,Pamlico,2021-12-23
3,0,3,0,Pamlico,2021-12-24
0,0,0,0,Pamlico,2021-12-25
5,1,4,0,Pamlico,2021-12-26
10,4,6,0,Pamlico,2021-12-27
6,0,6,0,Pamlico,2021-12-28
5,3,2,0,Pamlico,2021-12-29
6,3,3,0,Pamlico,2021-12-30
5,0,5,0,Pamlico,2021-12-31
3,0,3,0,Pamlico,2022-01-01
7,2,5,0,Pamlico,2022-01-02
21,2,19,0,Pamlico,2022-01-04
18,2,16,0,Pamlico,2022-01-05
31,4,27,0,Pamlico,2022-01-07
5,0,5,0,Pamlico,2022-01-08
4,2,2,0,Pamlico,2022-01-09
34,5,29,0,Pamlico,2022-01-10
47,6,41,0,Pamlico,2022-01-11
36,2,34,0,Pamlico,2022-01-13
33,1,32,0,Pamlico,2022-01-14
9,0,9,0,Pamlico,2022-01-15
8,1,7,0,Pamlico,2022-01-16
24,2,22,0,Pamlico,2022-01-17
40,5,35,0,Pamlico,2022-01-18
45,4,41,0,Pamlico,2022-01-19
32,4,28,0,Pamlico,2022-01-20
5,0,5,0,Pamlico,2022-01-21
1,0,1,0,Pamlico,2022-01-22
5,0,5,0,Pamlico,2022-01-23
39,2,37,0,Pamlico,2022-01-24
22,1,21,0,Pamlico,2022-01-25
13,1,12,0,Pamlico,2022-01-26
17,3,14,0,Pamlico,2022-01-27
9,0,9,0,Pamlico,2022-01-28
5,0,5,0,Pamlico,2022-01-29
6,0,6,0,Pamlico,2022-01-30
18,4,14,0,Pamlico,2022-01-31
13,0,13,0,Pamlico,2022-02-02
9,0,9,0,Pamlico,2022-02-03
6,0,6,0,Pamlico,2022-02-04
2,0,2,0,Pamlico,2022-02-05
8,0,8,0,Pamlico,2022-02-06
11,1,10,0,Pamlico,2022-02-07
16,1,15,0,Pamlico,2022-02-08
4,0,4,0,Pamlico,2022-02-09
4,0,4,0,Pamlico,2022-02-10
5,1,4,0,Pamlico,2022-02-11
7,0,7,0,Pamlico,2022-02-12
2,0,2,0,Pamlico,2022-02-13
3,0,3,0,Pamlico,2022-02-14
6,0,6,0,Pamlico,2022-02-15
2,0,2,0,Pamlico,2022-02-18
1,0,1,0,Pamlico,2022-02-19
0,0,0,0,Pamlico,2022-02-20
4,0,4,0,Pamlico,2022-02-21
2,0,2,0,Pamlico,2022-02-22
3,0,3,0,Pamlico,2022-02-23
2,0,2,0,Pamlico,2022-02-24
2,0,2,0,Pamlico,2022-02-25
1,0,1,0,Pamlico,2022-02-26
0,0,0,0,Pamlico,2022-02-27
0,0,0,0,Pamlico,2022-02-28
2,0,2,0,Pamlico,2022-03-01
1,0,1,0,Pamlico,2022-03-02
1,0,1,0,Pamlico,2022-03-03
1,0,1,0,Pamlico,2022-03-04
0,0,0,0,Pamlico,2022-03-05
0,0,0,0,Pamlico,2022-03-06
1,0,1,0,Pamlico,2022-03-07
0,0,0,0,Pamlico,2022-03-08
2,0,2,0,Pamlico,2022-03-09
0,0,0,0,Pamlico,2022-03-10
0,0,0,0,Pamlico,2022-03-11
0,0,0,0,Pamlico,2022-03-12
0,0,0,0,Pamlico,2022-03-13
0,0,0,0,Pamlico,2022-03-14
0,0,0,0,Pamlico,2022-03-15
2,0,2,0,Pamlico,2022-03-16
0,0,0,0,Pamlico,2022-03-17
0,0,0,0,Pamlico,2022-03-18
0,0,0,0,Pamlico,2022-03-19
0,0,0,0,Pamlico,2022-03-20
1,1,0,0,Pamlico,2022-03-21
0,0,0,0,Pamlico,2022-03-22
0,0,0,0,Pamlico,2022-03-23
0,0,0,0,Pamlico,2022-03-24
0,0,0,0,Pamlico,2022-03-25
0,0,0,0,Pamlico,2022-03-26
0,0,0,0,Pamlico,2022-03-27
0,0,0,0,Pamlico,2022-03-28
0,0,0,0,Pamlico,2022-03-29
1,1,0,0,Pamlico,2022-03-30
0,0,0,0,Pamlico,2022-03-31
0,0,0,0,Pamlico,2022-04-01
0,0,0,0,Pamlico,2022-04-02
0,0,0,0,Pamlico,2022-04-03
0,0,0,0,Pamlico,2022-04-04
1,1,0,0,Pamlico,2022-04-05
0,0,0,0,Pamlico,2022-04-06
0,0,0,0,Pamlico,2022-04-07
3,2,1,0,Pamlico,2022-04-08
0,0,0,0,Pamlico,2022-04-09
0,0,0,0,Pamlico,2022-04-10
0,0,0,0,Pamlico,2022-04-11
0,0,0,0,Pamlico,2022-04-12
2,0,2,0,Pamlico,2022-04-13
3,0,3,0,Pamlico,2022-04-14
0,0,0,0,Pamlico,2022-04-15
0,0,0,0,Pamlico,2022-04-16
1,1,0,0,Pamlico,2022-04-17
3,1,2,0,Pamlico,2022-04-18
3,2,1,0,Pamlico,2022-04-19
1,0,1,0,Pamlico,2022-04-20
0,0,0,0,Pamlico,2022-04-21
2,1,1,0,Pamlico,2022-04-22
0,0,0,0,Pamlico,2022-04-23
0,0,0,0,Pamlico,2022-04-24
2,1,1,0,Pamlico,2022-04-25
0,0,0,0,Pamlico,2022-04-26
0,0,0,0,Pamlico,2022-04-27
1,1,0,0,Pamlico,2022-04-28
0,0,0,0,Pamlico,2022-04-29
1,0,1,0,Pamlico,2022-04-30
2,0,2,0,Pamlico,2022-05-01
6,4,2,0,Pamlico,2022-05-02
0,0,0,0,Pamlico,2022-05-03
1,1,0,0,Pamlico,2022-05-04
2,1,1,0,Pamlico,2022-05-05
1,0,1,0,Pamlico,2022-05-06
2,1,1,0,Pamlico,2022-05-07
4,0,4,0,Pamlico,2022-05-09
4,1,3,0,Pamlico,2022-05-10
6,0,6,0,Pamlico,2022-05-11
7,1,6,0,Pamlico,2022-05-12
2,0,2,0,Pamlico,2022-05-13
0,0,0,0,Pamlico,2022-05-14
1,0,1,0,Pamlico,2022-05-15
4,2,2,0,Pamlico,2022-05-16
2,0,2,0,Pamlico,2022-05-17
2,0,2,0,Pamlico,2022-05-18
4,1,3,0,Pamlico,2022-05-19
2,0,2,0,Pamlico,2022-05-20
2,0,2,0,Pamlico,2022-05-21
8,0,8,0,Pamlico,2022-05-22
5,0,5,0,Pamlico,2022-05-23
7,0,7,0,Pamlico,2022-05-24
2,1,1,0,Pamlico,2022-05-25
3,0,3,0,Pamlico,2022-05-26
4,0,4,0,Pamlico,2022-05-27
4,2,2,0,Pamlico,2022-05-28
1,0,1,0,Pamlico,2022-05-29
0,0,0,0,Pamlico,2022-05-30
4,2,2,0,Pamlico,2022-05-31
2,0,2,0,Pamlico,2022-06-01
4,2,2,0,Pamlico,2022-06-02
2,0,2,0,Pamlico,2022-06-03
1,0,1,0,Pamlico,2022-06-04
12,3,9,0,Pasquotank,2021-12-07
7,2,5,0,Pasquotank,2021-12-08
10,3,7,0,Pasquotank,2021-12-09
11,4,7,0,Pasquotank,2021-12-10
3,0,3,0,Pasquotank,2021-12-12
8,3,5,0,Pasquotank,2021-12-13
6,1,5,0,Pasquotank,2021-12-16
6,2,4,0,Pasquotank,2021-12-17
4,1,3,0,Pasquotank,2021-12-18
5,2,3,0,Pasquotank,2021-12-19
14,3,11,0,Pasquotank,2021-12-20
6,2,4,0,Pasquotank,2021-12-22
10,5,5,0,Pasquotank,2021-12-23
12,4,8,0,Pasquotank,2021-12-24
6,2,4,0,Pasquotank,2021-12-25
17,3,14,0,Pasquotank,2021-12-26
48,13,35,0,Pasquotank,2021-12-27
57,12,45,0,Pasquotank,2021-12-29
58,12,46,0,Pasquotank,2021-12-30
46,5,41,0,Pasquotank,2021-12-31
35,3,32,0,Pasquotank,2022-01-01
38,7,31,0,Pasquotank,2022-01-02
118,15,103,0,Pasquotank,2022-01-03
107,23,84,0,Pasquotank,2022-01-04
100,25,75,0,Pasquotank,2022-01-06
68,25,43,0,Pasquotank,2022-01-07
35,3,32,0,Pasquotank,2022-01-08
33,2,31,0,Pasquotank,2022-01-09
135,38,97,0,Pasquotank,2022-01-10
72,34,38,0,Pasquotank,2022-01-11
68,19,49,0,Pasquotank,2022-01-12
65,33,32,0,Pasquotank,2022-01-13
75,31,44,0,Pasquotank,2022-01-14
40,16,24,0,Pasquotank,2022-01-15
87,21,66,0,Pasquotank,2022-01-17
138,19,119,0,Pasquotank,2022-01-19
101,13,88,0,Pasquotank,2022-01-20
9,0,9,0,Pasquotank,2022-01-22
94,16,78,0,Pasquotank,2022-01-24
67,6,61,0,Pasquotank,2022-01-26
63,12,51,0,Pasquotank,2022-01-27
16,2,14,0,Pasquotank,2022-01-29
45,9,36,0,Pasquotank,2022-01-31
33,9,24,0,Pasquotank,2022-02-01
4,0,4,0,Pasquotank,2022-02-06
34,6,28,0,Pasquotank,2022-02-07
6,4,2,0,Pasquotank,2022-02-08
6,0,6,0,Pasquotank,2022-02-09
8,1,7,0,Pasquotank,2022-02-10
6,2,4,0,Pasquotank,2022-02-12
2,1,1,0,Pasquotank,2022-02-13
9,2,7,0,Pasquotank,2022-02-14
8,5,3,0,Pasquotank,2022-02-15
13,4,9,0,Pasquotank,2022-02-17
5,1,4,0,Pasquotank,2022-02-18
2,1,1,0,Pasquotank,2022-02-19
4,0,4,0,Pasquotank,2022-02-20
4,0,4,0,Pasquotank,2022-02-21
5,0,5,0,Pasquotank,2022-02-22
7,5,2,0,Pasquotank,2022-02-23
9,2,7,0,Pasquotank,2022-02-24
0,0,0,0,Pasquotank,2022-02-25
2,0,2,0,Pasquotank,2022-02-26
1,0,1,0,Pasquotank,2022-02-27
5,1,4,0,Pasquotank,2022-02-28
5,3,2,0,Pasquotank,2022-03-01
2,0,2,0,Pasquotank,2022-03-02
1,0,1,0,Pasquotank,2022-03-03
2,0,2,0,Pasquotank,2022-03-04
0,0,0,0,Pasquotank,2022-03-05
0,0,0,0,Pasquotank,2022-03-06
3,1,2,0,Pasquotank,2022-03-07
1,1,0,0,Pasquotank,2022-03-08
0,0,0,0,Pasquotank,2022-03-09
1,0,1,0,Pasquotank,2022-03-10
2,0,2,0,Pasquotank,2022-03-11
0,0,0,0,Pasquotank,2022-03-12
2,1,1,0,Pasquotank,2022-03-13
0,0,0,0,Pasquotank,2022-03-14
0,0,0,0,Pasquotank,2022-03-15
2,0,2,0,Pasquotank,2022-03-16
3,2,1,0,Pasquotank,2022-03-17
1,0,1,0,Pasquotank,2022-03-19
0,0,0,0,Pasquotank,2022-03-21
2,2,0,0,Pasquotank,2022-03-23
0,0,0,0,Pasquotank,2022-03-24
4,2,2,0,Pasquotank,2022-03-25
1,0,1,0,Pasquotank,2022-03-26
0,0,0,0,Pasquotank,2022-03-27
2,1,1,0,Pasquotank,2022-03-28
0,0,0,0,Pasquotank,2022-03-29
1,1,0,0,Pasquotank,2022-03-30
0,0,0,0,Pasquotank,2022-03-31
0,0,0,0,Pasquotank,2022-04-01
0,0,0,0,Pasquotank,2022-04-02
0,0,0,0,Pasquotank,2022-04-03
0,0,0,0,Pasquotank,2022-04-04
1,0,1,0,Pasquotank,2022-04-05
1,0,1,0,Pasquotank,2022-04-06
2,0,2,0,Pasquotank,2022-04-07
1,0,1,0,Pasquotank,2022-04-08
0,0,0,0,Pasquotank,2022-04-09
1,0,1,0,Pasquotank,2022-04-10
2,0,2,0,Pasquotank,2022-04-11
3,0,3,0,Pasquotank,2022-04-12
0,0,0,0,Pasquotank,2022-04-13
0,0,0,0,Pasquotank,2022-04-14
1,1,0,0,Pasquotank,2022-04-15
1,0,1,0,Pasquotank,2022-04-16
1,1,0,0,Pasquotank,2022-04-17
1,0,1,0,Pasquotank,2022-04-18
1,0,1,0,Pasquotank,2022-04-19
2,1,1,0,Pasquotank,2022-04-20
0,0,0,0,Pasquotank,2022-04-21
2,1,1,0,Pasquotank,2022-04-22
1,0,1,0,Pasquotank,2022-04-23
2,0,2,0,Pasquotank,2022-04-24
2,0,2,0,Pasquotank,2022-04-25
2,1,1,0,Pasquotank,2022-04-26
2,1,1,0,Pasquotank,2022-04-27
9,3,6,0,Pasquotank,2022-04-28
3,1,2,0,Pasquotank,2022-04-29
0,0,0,0,Pasquotank,2022-04-30
2,1,1,0,Pasquotank,2022-05-01
1,1,0,0,Pasquotank,2022-05-02
3,2,1,0,Pasquotank,2022-05-03
8,1,7,0,Pasquotank,2022-05-04
5,1,4,0,Pasquotank,2022-05-05
8,2,6,0,Pasquotank,2022-05-06
4,2,2,0,Pasquotank,2022-05-07
2,0,2,0,Pasquotank,2022-05-08
3,2,1,0,Pasquotank,2022-05-09
8,3,5,0,Pasquotank,2022-05-10
7,4,3,0,Pasquotank,2022-05-11
6,2,4,0,Pasquotank,2022-05-12
9,5,4,0,Pasquotank,2022-05-13
5,1,4,0,Pasquotank,2022-05-14
3,0,3,0,Pasquotank,2022-05-15
10,3,7,0,Pasquotank,2022-05-16
14,5,9,0,Pasquotank,2022-05-17
9,4,5,0,Pasquotank,2022-05-18
16,7,9,0,Pasquotank,2022-05-19
9,5,4,0,Pasquotank,2022-05-20
5,2,3,0,Pasquotank,2022-05-21
3,3,0,0,Pasquotank,2022-05-22
8,6,2,0,Pasquotank,2022-05-23
8,5,3,0,Pasquotank,2022-05-24
17,9,8,0,Pasquotank,2022-05-25
12,6,6,0,Pasquotank,2022-05-26
3,0,3,0,Pasquotank,2022-05-27
4,1,3,0,Pasquotank,2022-05-28
1,1,0,0,Pasquotank,2022-05-29
5,3,2,0,Pasquotank,2022-05-30
13,6,7,0,Pasquotank,2022-05-31
21,7,14,0,Pasquotank,2022-06-01
13,5,8,0,Pasquotank,2022-06-02
13,5,8,0,Pasquotank,2022-06-03
5,1,4,0,Pasquotank,2022-06-04
14,3,11,0,Pender,2021-12-08
13,2,11,0,Pender,2021-12-09
18,6,12,0,Pender,2021-12-10
6,0,6,0,Pender,2021-12-11
8,5,3,0,Pender,2021-12-12
23,4,19,0,Pender,2021-12-13
27,7,20,0,Pender,2021-12-14
37,4,33,0,Pender,2021-12-20
31,5,26,0,Pender,2021-12-22
40,7,33,0,Pender,2021-12-23
20,9,11,0,Pender,2021-12-24
13,0,13,0,Pender,2021-12-25
36,10,26,0,Pender,2021-12-26
92,5,87,0,Pender,2021-12-29
110,19,91,0,Pender,2021-12-30
47,10,37,0,Pender,2021-12-31
26,7,19,0,Pender,2022-01-01
44,10,34,0,Pender,2022-01-02
200,18,182,0,Pender,2022-01-03
156,37,119,0,Pender,2022-01-04
155,17,138,0,Pender,2022-01-06
129,14,115,0,Pender,2022-01-07
249,32,217,0,Pender,2022-01-10
220,27,193,0,Pender,2022-01-13
345,53,292,0,Pender,2022-01-18
224,26,198,0,Pender,2022-01-20
36,5,31,0,Pender,2022-01-22
56,17,39,0,Pender,2022-01-23
267,45,222,0,Pender,2022-01-24
104,18,86,0,Pender,2022-01-27
102,14,88,0,Pender,2022-01-28
33,2,31,0,Pender,2022-01-30
78,6,72,0,Pender,2022-02-01
62,14,48,0,Pender,2022-02-02
15,4,11,0,Pender,2022-02-05
83,14,69,0,Pender,2022-02-07
35,2,33,0,Pender,2022-02-08
24,1,23,0,Pender,2022-02-10
12,1,11,0,Pender,2022-02-12
4,1,3,0,Pender,2022-02-13
14,0,14,0,Pender,2022-02-15
16,1,15,0,Pender,2022-02-16
5,0,5,0,Pender,2022-02-17
9,3,6,0,Pender,2022-02-18
4,1,3,0,Pender,2022-02-20
7,0,7,0,Pender,2022-02-21
12,1,11,0,Pender,2022-02-22
5,0,5,0,Pender,2022-02-23
5,1,4,0,Pender,2022-02-24
1,0,1,0,Pender,2022-02-26
5,1,4,0,Pender,2022-02-27
1,0,1,0,Pender,2022-02-28
5,1,4,0,Pender,2022-03-01
1,0,1,0,Pender,2022-03-02
5,2,3,0,Pender,2022-03-03
2,0,2,0,Pender,2022-03-04
1,0,1,0,Pender,2022-03-05
2,0,2,0,Pender,2022-03-06
3,0,3,0,Pender,2022-03-07
3,0,3,0,Pender,2022-03-08
1,0,1,0,Pender,2022-03-09
0,0,0,0,Pender,2022-03-10
1,0,1,0,Pender,2022-03-11
1,0,1,0,Pender,2022-03-12
0,0,0,0,Pender,2022-03-13
5,4,1,0,Pender,2022-03-14
7,1,6,0,Pender,2022-03-15
2,0,2,0,Pender,2022-03-16
5,0,5,0,Pender,2022-03-17
0,0,0,0,Pender,2022-03-18
1,0,1,0,Pender,2022-03-19
0,0,0,0,Pender,2022-03-20
2,0,2,0,Pender,2022-03-21
1,0,1,0,Pender,2022-03-22
0,0,0,0,Pender,2022-03-23
1,0,1,0,Pender,2022-03-24
0,0,0,0,Pender,2022-03-25
0,0,0,0,Pender,2022-03-27
2,0,2,0,Pender,2022-03-28
1,0,1,0,Pender,2022-03-29
2,0,2,0,Pender,2022-03-30
2,0,2,0,Pender,2022-03-31
2,0,2,0,Pender,2022-04-01
0,0,0,0,Pender,2022-04-02
0,0,0,0,Pender,2022-04-03
4,0,4,0,Pender,2022-04-04
0,0,0,0,Pender,2022-04-05
2,0,2,0,Pender,2022-04-06
5,0,5,0,Pender,2022-04-07
9,0,9,0,Pender,2022-04-08
2,0,2,0,Pender,2022-04-09
0,0,0,0,Pender,2022-04-10
9,2,7,0,Pender,2022-04-11
6,1,5,0,Pender,2022-04-12
8,1,7,0,Pender,2022-04-13
5,2,3,0,Pender,2022-04-14
7,1,6,0,Pender,2022-04-15
1,0,1,0,Pender,2022-04-16
2,0,2,0,Pender,2022-04-17
3,1,2,0,Pender,2022-04-18
3,3,0,0,Pender,2022-04-19
2,0,2,0,Pender,2022-04-20
7,1,6,0,Pender,2022-04-21
5,1,4,0,Pender,2022-04-22
3,0,3,0,Pender,2022-04-23
6,2,4,0,Pender,2022-04-24
13,4,9,0,Pender,2022-04-25
4,1,3,0,Pender,2022-04-26
9,3,6,0,Pender,2022-04-27
5,0,5,0,Pender,2022-04-28
4,1,3,0,Pender,2022-04-29
1,0,1,0,Pender,2022-04-30
0,0,0,0,Pender,2022-05-01
7,2,5,0,Pender,2022-05-02
10,1,9,0,Pender,2022-05-03
11,2,9,0,Pender,2022-05-04
10,1,9,0,Pender,2022-05-05
5,1,4,0,Pender,2022-05-06
3,0,3,0,Pender,2022-05-07
6,0,6,0,Pender,2022-05-08
13,1,12,0,Pender,2022-05-09
23,2,21,0,Pender,2022-05-10
12,3,9,0,Pender,2022-05-11
16,4,12,0,Pender,2022-05-12
13,1,12,0,Pender,2022-05-13
9,1,8,0,Pender,2022-05-14
7,0,7,0,Pender,2022-05-15
26,3,23,0,Pender,2022-05-16
13,1,12,0,Pender,2022-05-18
20,1,19,0,Pender,2022-05-19
12,2,10,0,Pender,2022-05-20
12,0,12,0,Pender,2022-05-21
6,1,5,0,Pender,2022-05-22
18,2,16,0,Pender,2022-05-23
17,1,16,0,Pender,2022-05-24
18,4,14,0,Pender,2022-05-25
15,1,14,0,Pender,2022-05-26
11,1,10,0,Pender,2022-05-28
6,1,5,0,Pender,2022-05-29
6,1,5,0,Pender,2022-05-30
23,4,19,0,Pender,2022-05-31
18,1,17,0,Pender,2022-06-01
13,2,11,0,Pender,2022-06-02
13,1,12,0,Pender,2022-06-03
11,1,10,0,Pender,2022-06-04
7,0,7,0,Perquimans,2021-12-07
3,1,2,0,Perquimans,2021-12-08
0,0,0,0,Perquimans,2021-12-10
1,0,1,0,Perquimans,2021-12-12
0,0,0,0,Perquimans,2021-12-13
2,0,2,0,Perquimans,2021-12-15
9,3,6,0,Perquimans,2021-12-16
6,1,5,0,Perquimans,2021-12-18
0,0,0,0,Perquimans,2021-12-19
10,5,5,0,Perquimans,2021-12-20
3,1,2,0,Perquimans,2021-12-21
15,6,9,0,Perquimans,2021-12-22
6,0,6,0,Perquimans,2021-12-23
3,0,3,0,Perquimans,2021-12-24
0,0,0,0,Perquimans,2021-12-25
5,1,4,0,Perquimans,2021-12-26
12,1,11,0,Perquimans,2021-12-27
26,0,26,0,Perquimans,2021-12-28
17,1,16,0,Perquimans,2021-12-29
18,5,13,0,Perquimans,2021-12-30
9,0,9,0,Perquimans,2021-12-31
8,0,8,0,Perquimans,2022-01-01
3,0,3,0,Perquimans,2022-01-02
30,3,27,0,Perquimans,2022-01-03
55,10,45,0,Perquimans,2022-01-04
32,4,28,0,Perquimans,2022-01-05
13,0,13,0,Perquimans,2022-01-09
52,19,33,0,Perquimans,2022-01-10
35,7,28,0,Perquimans,2022-01-11
21,6,15,0,Perquimans,2022-01-13
34,6,28,0,Perquimans,2022-01-14
18,2,16,0,Perquimans,2022-01-15
32,4,28,0,Perquimans,2022-01-17
10,1,9,0,Perquimans,2022-01-21
6,1,5,0,Perquimans,2022-01-22
6,0,6,0,Perquimans,2022-01-23
29,4,25,0,Perquimans,2022-01-24
23,4,19,0,Perquimans,2022-01-25
21,7,14,0,Perquimans,2022-01-26
22,6,16,0,Perquimans,2022-01-27
11,1,10,0,Perquimans,2022-01-28
4,0,4,0,Perquimans,2022-01-29
5,0,5,0,Perquimans,2022-01-30
19,3,16,0,Perquimans,2022-01-31
12,4,8,0,Perquimans,2022-02-01
8,1,7,0,Perquimans,2022-02-02
13,0,13,0,Perquimans,2022-02-03
5,3,2,0,Perquimans,2022-02-05
5,1,4,0,Perquimans,2022-02-06
12,3,9,0,Perquimans,2022-02-07
5,1,4,0,Perquimans,2022-02-08
17,0,17,0,Perquimans,2022-02-09
4,2,2,0,Perquimans,2022-02-10
3,0,3,0,Perquimans,2022-02-11
1,0,1,0,Perquimans,2022-02-12
6,1,5,0,Perquimans,2022-02-13
7,3,4,0,Perquimans,2022-02-14
2,0,2,0,Perquimans,2022-02-15
2,0,2,0,Perquimans,2022-02-17
2,0,2,0,Perquimans,2022-02-18
0,0,0,0,Perquimans,2022-02-19
2,0,2,0,Perquimans,2022-02-20
4,0,4,0,Perquimans,2022-02-21
2,2,0,0,Perquimans,2022-02-22
1,1,0,0,Perquimans,2022-02-23
0,0,0,0,Perquimans,2022-02-24
0,0,0,0,Perquimans,2022-02-25
1,0,1,0,Perquimans,2022-02-26
0,0,0,0,Perquimans,2022-02-27
1,0,1,0,Perquimans,2022-02-28
1,0,1,0,Perquimans,2022-03-01
2,0,2,0,Perquimans,2022-03-02
1,0,1,0,Perquimans,2022-03-03
1,1,0,0,Perquimans,2022-03-04
0,0,0,0,Perquimans,2022-03-05
1,0,1,0,Perquimans,2022-03-06
0,0,0,0,Perquimans,2022-03-07
2,0,2,0,Perquimans,2022-03-08
0,0,0,0,Perquimans,2022-03-09
0,0,0,0,Perquimans,2022-03-10
3,0,3,0,Perquimans,2022-03-11
0,0,0,0,Perquimans,2022-03-12
1,0,1,0,Perquimans,2022-03-13
0,0,0,0,Perquimans,2022-03-14
0,0,0,0,Perquimans,2022-03-15
0,0,0,0,Perquimans,2022-03-16
0,0,0,0,Perquimans,2022-03-17
1,1,0,0,Perquimans,2022-03-18
0,0,0,0,Perquimans,2022-03-19
0,0,0,0,Perquimans,2022-03-20
0,0,0,0,Perquimans,2022-03-22
0,0,0,0,Perquimans,2022-03-23
1,0,1,0,Perquimans,2022-03-24
0,0,0,0,Perquimans,2022-03-25
0,0,0,0,Perquimans,2022-03-26
1,1,0,0,Perquimans,2022-03-27
0,0,0,0,Perquimans,2022-03-28
0,0,0,0,Perquimans,2022-03-29
0,0,0,0,Perquimans,2022-03-30
0,0,0,0,Perquimans,2022-03-31
0,0,0,0,Perquimans,2022-04-01
0,0,0,0,Perquimans,2022-04-02
0,0,0,0,Perquimans,2022-04-03
1,0,1,0,Perquimans,2022-04-04
0,0,0,0,Perquimans,2022-04-05
3,2,1,0,Perquimans,2022-04-06
0,0,0,0,Perquimans,2022-04-07
0,0,0,0,Perquimans,2022-04-08
0,0,0,0,Perquimans,2022-04-09
0,0,0,0,Perquimans,2022-04-10
1,1,0,0,Perquimans,2022-04-11
0,0,0,0,Perquimans,2022-04-12
0,0,0,0,Perquimans,2022-04-13
0,0,0,0,Perquimans,2022-04-14
0,0,0,0,Perquimans,2022-04-15
0,0,0,0,Perquimans,2022-04-16
0,0,0,0,Perquimans,2022-04-17
0,0,0,0,Perquimans,2022-04-18
0,0,0,0,Perquimans,2022-04-19
0,0,0,0,Perquimans,2022-04-20
0,0,0,0,Perquimans,2022-04-21
0,0,0,0,Perquimans,2022-04-22
0,0,0,0,Perquimans,2022-04-23
2,2,0,0,Perquimans,2022-04-24
1,0,1,0,Perquimans,2022-04-25
3,0,3,0,Perquimans,2022-04-26
2,2,0,0,Perquimans,2022-04-27
2,1,1,0,Perquimans,2022-04-28
1,0,1,0,Perquimans,2022-04-29
0,0,0,0,Perquimans,2022-04-30
2,0,2,0,Perquimans,2022-05-01
2,1,1,0,Perquimans,2022-05-02
1,0,1,0,Perquimans,2022-05-03
5,0,5,0,Perquimans,2022-05-04
6,5,1,0,Perquimans,2022-05-05
3,1,2,0,Perquimans,2022-05-06
0,0,0,0,Perquimans,2022-05-07
0,0,0,0,Perquimans,2022-05-08
3,0,3,0,Perquimans,2022-05-09
0,0,0,0,Perquimans,2022-05-10
2,1,1,0,Perquimans,2022-05-11
0,0,0,0,Perquimans,2022-05-12
0,0,0,0,Perquimans,2022-05-13
4,1,3,0,Perquimans,2022-05-14
2,0,2,0,Perquimans,2022-05-15
2,1,1,0,Perquimans,2022-05-16
4,2,2,0,Perquimans,2022-05-17
2,0,2,0,Perquimans,2022-05-18
5,2,3,0,Perquimans,2022-05-19
4,1,3,0,Perquimans,2022-05-20
2,2,0,0,Perquimans,2022-05-21
2,0,2,0,Perquimans,2022-05-22
4,2,2,0,Perquimans,2022-05-23
5,2,3,0,Perquimans,2022-05-24
5,0,5,0,Perquimans,2022-05-25
5,2,3,0,Perquimans,2022-05-26
4,1,3,0,Perquimans,2022-05-27
3,2,1,0,Perquimans,2022-05-28
2,0,2,0,Perquimans,2022-05-29
2,1,1,0,Perquimans,2022-05-30
8,5,3,0,Perquimans,2022-05-31
5,1,4,0,Perquimans,2022-06-01
3,1,2,0,Perquimans,2022-06-02
2,0,2,0,Perquimans,2022-06-03
2,0,2,0,Perquimans,2022-06-04
21,3,18,0,Person,2021-12-07
19,4,15,0,Person,2021-12-08
16,6,10,0,Person,2021-12-09
14,2,12,0,Person,2021-12-10
24,3,21,0,Person,2021-12-13
17,1,16,0,Person,2021-12-14
21,9,12,0,Person,2021-12-16
19,2,17,0,Person,2021-12-20
17,2,15,0,Person,2021-12-22
30,4,26,0,Person,2021-12-23
6,1,5,0,Person,2021-12-24
7,0,7,0,Person,2021-12-25
15,4,11,0,Person,2021-12-26
49,17,32,0,Person,2021-12-27
82,11,71,0,Person,2021-12-28
83,16,67,0,Person,2021-12-29
52,13,39,0,Person,2021-12-31
36,10,26,0,Person,2022-01-01
32,12,20,0,Person,2022-01-02
59,27,32,0,Person,2022-01-03
144,16,128,0,Person,2022-01-04
118,23,95,0,Person,2022-01-05
79,15,64,0,Person,2022-01-07
39,6,33,0,Person,2022-01-09
153,12,141,0,Person,2022-01-10
138,23,115,0,Person,2022-01-11
110,6,104,0,Person,2022-01-13
91,5,86,0,Person,2022-01-14
63,3,60,0,Person,2022-01-17
61,15,46,0,Person,2022-01-21
24,1,23,0,Person,2022-01-22
51,3,48,0,Person,2022-01-23
73,12,61,0,Person,2022-01-26
66,8,58,0,Person,2022-01-27
58,16,42,0,Person,2022-01-28
33,11,22,0,Person,2022-01-30
72,14,58,0,Person,2022-01-31
43,5,38,0,Person,2022-02-02
30,6,24,0,Person,2022-02-04
15,3,12,0,Person,2022-02-05
15,1,14,0,Person,2022-02-06
27,4,23,0,Person,2022-02-07
31,6,25,0,Person,2022-02-08
22,6,16,0,Person,2022-02-10
9,2,7,0,Person,2022-02-11
9,2,7,0,Person,2022-02-12
4,0,4,0,Person,2022-02-13
18,4,14,0,Person,2022-02-14
11,2,9,0,Person,2022-02-15
10,2,8,0,Person,2022-02-16
14,2,12,0,Person,2022-02-17
8,2,6,0,Person,2022-02-18
2,0,2,0,Person,2022-02-20
10,3,7,0,Person,2022-02-22
13,2,11,0,Person,2022-02-23
5,2,3,0,Person,2022-02-25
2,1,1,0,Person,2022-02-26
4,0,4,0,Person,2022-02-27
3,1,2,0,Person,2022-02-28
7,2,5,0,Person,2022-03-01
11,3,8,0,Person,2022-03-02
4,0,4,0,Person,2022-03-03
3,0,3,0,Person,2022-03-04
1,0,1,0,Person,2022-03-05
3,3,0,0,Person,2022-03-06
2,1,1,0,Person,2022-03-07
2,1,1,0,Person,2022-03-08
6,1,5,0,Person,2022-03-09
0,0,0,0,Person,2022-03-10
0,0,0,0,Person,2022-03-11
0,0,0,0,Person,2022-03-12
1,0,1,0,Person,2022-03-13
5,0,5,0,Person,2022-03-14
1,1,0,0,Person,2022-03-15
3,0,3,0,Person,2022-03-17
1,1,0,0,Person,2022-03-18
1,0,1,0,Person,2022-03-19
1,1,0,0,Person,2022-03-20
3,0,3,0,Person,2022-03-21
2,0,2,0,Person,2022-03-22
1,1,0,0,Person,2022-03-23
0,0,0,0,Person,2022-03-24
0,0,0,0,Person,2022-03-25
1,0,1,0,Person,2022-03-26
0,0,0,0,Person,2022-03-27
0,0,0,0,Person,2022-03-28
2,0,2,0,Person,2022-03-30
2,1,1,0,Person,2022-03-31
2,0,2,0,Person,2022-04-01
1,1,0,0,Person,2022-04-02
0,0,0,0,Person,2022-04-03
3,0,3,0,Person,2022-04-04
2,1,1,0,Person,2022-04-05
1,0,1,0,Person,2022-04-06
3,0,3,0,Person,2022-04-07
0,0,0,0,Person,2022-04-08
2,1,1,0,Person,2022-04-09
1,0,1,0,Person,2022-04-10
3,0,3,0,Person,2022-04-11
4,1,3,0,Person,2022-04-12
4,1,3,0,Person,2022-04-13
2,0,2,0,Person,2022-04-14
3,0,3,0,Person,2022-04-15
1,0,1,0,Person,2022-04-16
1,0,1,0,Person,2022-04-17
1,1,0,0,Person,2022-04-18
2,2,0,0,Person,2022-04-19
2,0,2,0,Person,2022-04-20
0,0,0,0,Person,2022-04-21
5,3,2,0,Person,2022-04-22
3,1,2,0,Person,2022-04-23
2,1,1,0,Person,2022-04-24
13,3,10,0,Person,2022-04-25
3,1,2,0,Person,2022-04-26
4,3,1,0,Person,2022-04-27
11,1,10,0,Person,2022-04-28
7,2,5,0,Person,2022-04-29
5,1,4,0,Person,2022-04-30
6,3,3,0,Person,2022-05-01
16,6,10,0,Person,2022-05-02
6,2,4,0,Person,2022-05-03
14,2,12,0,Person,2022-05-04
8,3,5,0,Person,2022-05-05
10,2,8,0,Person,2022-05-06
2,1,1,0,Person,2022-05-07
6,4,2,0,Person,2022-05-08
13,3,10,0,Person,2022-05-09
9,1,8,0,Person,2022-05-10
16,4,12,0,Person,2022-05-11
19,7,12,0,Person,2022-05-12
19,4,15,0,Person,2022-05-13
16,3,13,0,Person,2022-05-14
8,5,3,0,Person,2022-05-15
15,6,9,0,Person,2022-05-16
21,3,18,0,Person,2022-05-17
13,4,9,0,Person,2022-05-18
15,5,10,0,Person,2022-05-19
13,3,10,0,Person,2022-05-20
12,3,9,0,Person,2022-05-21
7,1,6,0,Person,2022-05-22
23,8,15,0,Person,2022-05-23
24,7,17,0,Person,2022-05-24
12,5,7,0,Person,2022-05-25
16,4,12,0,Person,2022-05-26
12,3,9,0,Person,2022-05-27
13,3,10,0,Person,2022-05-28
13,5,8,0,Person,2022-05-29
7,4,3,0,Person,2022-05-30
13,1,12,0,Person,2022-05-31
18,5,13,0,Person,2022-06-01
11,4,7,0,Person,2022-06-02
13,3,10,0,Person,2022-06-03
5,4,1,0,Person,2022-06-04
70,9,61,0,Pitt,2021-12-07
66,7,59,0,Pitt,2021-12-09
17,2,15,0,Pitt,2021-12-11
34,3,31,0,Pitt,2021-12-12
70,8,62,0,Pitt,2021-12-13
70,8,62,0,Pitt,2021-12-15
54,5,49,0,Pitt,2021-12-16
86,8,78,0,Pitt,2021-12-20
130,10,120,0,Pitt,2021-12-22
146,8,138,0,Pitt,2021-12-23
21,5,16,0,Pitt,2021-12-25
52,7,45,0,Pitt,2021-12-26
428,23,405,0,Pitt,2021-12-27
496,34,462,0,Pitt,2021-12-29
522,41,481,0,Pitt,2021-12-30
348,11,337,0,Pitt,2021-12-31
85,12,73,0,Pitt,2022-01-01
217,21,196,0,Pitt,2022-01-02
657,75,582,0,Pitt,2022-01-03
923,74,849,0,Pitt,2022-01-04
356,15,341,0,Pitt,2022-01-09
978,58,920,0,Pitt,2022-01-11
852,78,774,0,Pitt,2022-01-13
716,65,651,0,Pitt,2022-01-20
109,0,109,0,Pitt,2022-01-21
71,12,59,0,Pitt,2022-01-29
129,5,124,0,Pitt,2022-01-30
157,8,149,0,Pitt,2022-02-04
61,2,59,0,Pitt,2022-02-06
134,14,120,0,Pitt,2022-02-08
93,8,85,0,Pitt,2022-02-10
41,3,38,0,Pitt,2022-02-13
62,13,49,0,Pitt,2022-02-15
42,5,37,0,Pitt,2022-02-21
42,6,36,0,Pitt,2022-02-22
7,0,7,0,Pitt,2022-02-27
28,2,26,0,Pitt,2022-02-28
11,1,10,0,Pitt,2022-03-01
20,4,16,0,Pitt,2022-03-03
15,3,12,0,Pitt,2022-03-07
10,3,7,0,Pitt,2022-03-09
9,2,7,0,Pitt,2022-03-10
5,1,4,0,Pitt,2022-03-11
1,0,1,0,Pitt,2022-03-12
1,0,1,0,Pitt,2022-03-13
4,1,3,0,Pitt,2022-03-15
6,1,5,0,Pitt,2022-03-18
2,0,2,0,Pitt,2022-03-20
3,0,3,0,Pitt,2022-03-21
4,1,3,0,Pitt,2022-03-22
5,0,5,0,Pitt,2022-03-23
3,1,2,0,Pitt,2022-03-24
4,0,4,0,Pitt,2022-03-26
0,0,0,0,Pitt,2022-03-27
7,0,7,0,Pitt,2022-03-28
3,1,2,0,Pitt,2022-03-29
4,1,3,0,Pitt,2022-03-30
2,0,2,0,Pitt,2022-03-31
4,0,4,0,Pitt,2022-04-01
3,0,3,0,Pitt,2022-04-02
4,0,4,0,Pitt,2022-04-03
10,3,7,0,Pitt,2022-04-04
13,1,12,0,Pitt,2022-04-05
13,0,13,0,Pitt,2022-04-06
11,1,10,0,Pitt,2022-04-07
11,0,11,0,Pitt,2022-04-08
6,0,6,0,Pitt,2022-04-09
5,0,5,0,Pitt,2022-04-10
22,2,20,0,Pitt,2022-04-11
17,4,13,0,Pitt,2022-04-12
16,0,16,0,Pitt,2022-04-13
15,2,13,0,Pitt,2022-04-14
4,0,4,0,Pitt,2022-04-16
4,2,2,0,Pitt,2022-04-17
11,0,11,0,Pitt,2022-04-18
16,0,16,0,Pitt,2022-04-19
12,5,7,0,Pitt,2022-04-20
11,0,11,0,Pitt,2022-04-21
11,1,10,0,Pitt,2022-04-22
12,4,8,0,Pitt,2022-04-23
2,0,2,0,Pitt,2022-04-24
25,2,23,0,Pitt,2022-04-25
25,7,18,0,Pitt,2022-04-26
28,2,26,0,Pitt,2022-04-27
24,3,21,0,Pitt,2022-04-28
16,4,12,0,Pitt,2022-04-29
9,0,9,0,Pitt,2022-04-30
11,1,10,0,Pitt,2022-05-01
30,2,28,0,Pitt,2022-05-02
33,5,28,0,Pitt,2022-05-03
38,2,36,0,Pitt,2022-05-04
37,1,36,0,Pitt,2022-05-05
28,5,23,0,Pitt,2022-05-06
15,3,12,0,Pitt,2022-05-07
20,3,17,0,Pitt,2022-05-08
55,7,48,0,Pitt,2022-05-09
65,15,50,0,Pitt,2022-05-10
63,11,52,0,Pitt,2022-05-11
58,8,50,0,Pitt,2022-05-12
56,10,46,0,Pitt,2022-05-13
22,2,20,0,Pitt,2022-05-14
34,2,32,0,Pitt,2022-05-15
95,15,80,0,Pitt,2022-05-16
71,14,57,0,Pitt,2022-05-17
90,15,75,0,Pitt,2022-05-18
76,18,58,0,Pitt,2022-05-19
56,6,50,0,Pitt,2022-05-20
25,4,21,0,Pitt,2022-05-21
41,1,40,0,Pitt,2022-05-22
94,14,80,0,Pitt,2022-05-23
85,12,73,0,Pitt,2022-05-24
79,13,66,0,Pitt,2022-05-25
87,9,78,0,Pitt,2022-05-26
65,9,56,0,Pitt,2022-05-27
24,5,19,0,Pitt,2022-05-28
29,2,27,0,Pitt,2022-05-29
16,3,13,0,Pitt,2022-05-30
140,17,123,0,Pitt,2022-05-31
88,3,85,0,Pitt,2022-06-01
57,7,50,0,Pitt,2022-06-02
57,2,55,0,Pitt,2022-06-03
26,1,25,0,Pitt,2022-06-04
3,2,1,0,Polk,2021-12-07
1,1,0,0,Polk,2021-12-08
3,2,1,0,Polk,2021-12-09
2,2,0,0,Polk,2021-12-10
3,1,2,0,Polk,2021-12-11
1,1,0,0,Polk,2021-12-12
5,2,3,0,Polk,2021-12-13
3,2,1,0,Polk,2021-12-14
3,1,2,0,Polk,2021-12-15
8,1,7,0,Polk,2021-12-16
5,2,3,0,Polk,2021-12-17
3,0,3,0,Polk,2021-12-18
3,3,0,0,Polk,2021-12-19
11,7,4,0,Polk,2021-12-20
3,1,2,0,Polk,2021-12-21
5,3,2,0,Polk,2021-12-22
3,2,1,0,Polk,2021-12-23
5,2,3,0,Polk,2021-12-24
1,0,1,0,Polk,2021-12-25
4,1,3,0,Polk,2021-12-26
21,10,11,0,Polk,2021-12-27
17,3,14,0,Polk,2021-12-28
26,18,8,0,Polk,2021-12-29
12,2,10,0,Polk,2021-12-30
12,7,5,0,Polk,2021-12-31
8,6,2,0,Polk,2022-01-01
10,6,4,0,Polk,2022-01-02
35,16,19,0,Polk,2022-01-03
41,17,24,0,Polk,2022-01-04
27,8,19,0,Polk,2022-01-06
33,18,15,0,Polk,2022-01-07
24,4,20,0,Polk,2022-01-08
10,1,9,0,Polk,2022-01-09
66,15,51,0,Polk,2022-01-10
71,38,33,0,Polk,2022-01-13
52,27,25,0,Polk,2022-01-14
24,15,9,0,Polk,2022-01-15
1,1,0,0,Polk,2022-01-16
46,29,17,0,Polk,2022-01-18
41,23,18,0,Polk,2022-01-19
35,15,20,0,Polk,2022-01-21
16,7,9,0,Polk,2022-01-22
12,6,6,0,Polk,2022-01-23
61,23,38,0,Polk,2022-01-24
29,13,16,0,Polk,2022-01-25
28,13,15,0,Polk,2022-01-26
26,15,11,0,Polk,2022-01-27
10,3,7,0,Polk,2022-01-29
29,12,17,0,Polk,2022-01-31
28,14,14,0,Polk,2022-02-01
15,10,5,0,Polk,2022-02-02
9,6,3,0,Polk,2022-02-05
3,1,2,0,Polk,2022-02-06
23,15,8,0,Polk,2022-02-07
14,8,6,0,Polk,2022-02-10
9,4,5,0,Polk,2022-02-11
4,1,3,0,Polk,2022-02-12
1,1,0,0,Polk,2022-02-13
8,3,5,0,Polk,2022-02-14
4,3,1,0,Polk,2022-02-15
5,2,3,0,Polk,2022-02-16
3,1,2,0,Polk,2022-02-18
2,0,2,0,Polk,2022-02-19
5,2,3,0,Polk,2022-02-21
1,0,1,0,Polk,2022-02-22
3,2,1,0,Polk,2022-02-23
4,4,0,0,Polk,2022-02-24
2,1,1,0,Polk,2022-02-25
5,0,5,0,Polk,2022-02-26
2,1,1,0,Polk,2022-02-27
1,1,0,0,Polk,2022-02-28
2,2,0,0,Polk,2022-03-01
1,1,0,0,Polk,2022-03-02
3,1,2,0,Polk,2022-03-04
2,1,1,0,Polk,2022-03-05
0,0,0,0,Polk,2022-03-06
1,1,0,0,Polk,2022-03-07
0,0,0,0,Polk,2022-03-09
1,0,1,0,Polk,2022-03-10
0,0,0,0,Polk,2022-03-11
0,0,0,0,Polk,2022-03-12
0,0,0,0,Polk,2022-03-13
0,0,0,0,Polk,2022-03-15
0,0,0,0,Polk,2022-03-16
0,0,0,0,Polk,2022-03-17
1,1,0,0,Polk,2022-03-18
2,2,0,0,Polk,2022-03-19
0,0,0,0,Polk,2022-03-20
1,0,1,0,Polk,2022-03-21
3,0,3,0,Polk,2022-03-22
2,0,2,0,Polk,2022-03-23
4,1,3,0,Polk,2022-03-24
5,1,4,0,Polk,2022-03-25
2,2,0,0,Polk,2022-03-26
1,1,0,0,Polk,2022-03-27
5,2,3,0,Polk,2022-03-28
10,4,6,0,Polk,2022-03-30
6,4,2,0,Polk,2022-03-31
3,1,2,0,Polk,2022-04-01
0,0,0,0,Polk,2022-04-02
0,0,0,0,Polk,2022-04-03
5,4,1,0,Polk,2022-04-04
0,0,0,0,Polk,2022-04-05
0,0,0,0,Polk,2022-04-06
2,2,0,0,Polk,2022-04-07
0,0,0,0,Polk,2022-04-08
1,1,0,0,Polk,2022-04-09
0,0,0,0,Polk,2022-04-10
0,0,0,0,Polk,2022-04-12
1,0,1,0,Polk,2022-04-13
0,0,0,0,Polk,2022-04-14
1,1,0,0,Polk,2022-04-15
1,0,1,0,Polk,2022-04-16
0,0,0,0,Polk,2022-04-17
1,1,0,0,Polk,2022-04-18
0,0,0,0,Polk,2022-04-20
0,0,0,0,Polk,2022-04-21
1,0,1,0,Polk,2022-04-22
0,0,0,0,Polk,2022-04-23
0,0,0,0,Polk,2022-04-24
1,1,0,0,Polk,2022-04-25
1,0,1,0,Polk,2022-04-26
0,0,0,0,Polk,2022-04-27
1,0,1,0,Polk,2022-04-28
1,0,1,0,Polk,2022-04-29
2,1,1,0,Polk,2022-04-30
1,0,1,0,Polk,2022-05-01
5,3,2,0,Polk,2022-05-02
3,3,0,0,Polk,2022-05-03
0,0,0,0,Polk,2022-05-04
2,2,0,0,Polk,2022-05-05
0,0,0,0,Polk,2022-05-06
1,0,1,0,Polk,2022-05-07
1,1,0,0,Polk,2022-05-08
2,1,1,0,Polk,2022-05-09
2,0,2,0,Polk,2022-05-10
2,2,0,0,Polk,2022-05-11
3,1,2,0,Polk,2022-05-12
2,0,2,0,Polk,2022-05-13
3,2,1,0,Polk,2022-05-14
0,0,0,0,Polk,2022-05-15
8,3,5,0,Polk,2022-05-16
4,4,0,0,Polk,2022-05-17
3,2,1,0,Polk,2022-05-18
3,1,2,0,Polk,2022-05-19
3,2,1,0,Polk,2022-05-20
2,1,1,0,Polk,2022-05-21
1,1,0,0,Polk,2022-05-22
1,1,0,0,Polk,2022-05-23
1,0,1,0,Polk,2022-05-24
5,2,3,0,Polk,2022-05-25
0,0,0,0,Polk,2022-05-26
7,2,5,0,Polk,2022-05-27
3,1,2,0,Polk,2022-05-28
3,2,1,0,Polk,2022-05-29
2,1,1,0,Polk,2022-05-30
4,4,0,0,Polk,2022-05-31
4,2,2,0,Polk,2022-06-01
7,4,3,0,Polk,2022-06-02
2,2,0,0,Polk,2022-06-03
1,1,0,0,Polk,2022-06-04
51,24,27,0,Randolph,2021-12-09
36,15,21,0,Randolph,2021-12-12
91,33,58,0,Randolph,2021-12-23
21,0,21,0,Randolph,2021-12-25
61,28,33,0,Randolph,2021-12-26
188,79,109,0,Randolph,2021-12-27
198,72,126,0,Randolph,2021-12-30
117,53,64,0,Randolph,2021-12-31
312,114,198,0,Randolph,2022-01-04
511,63,448,0,Randolph,2022-01-11
97,19,78,0,Randolph,2022-01-17
29,8,21,0,Randolph,2022-02-23
23,11,12,0,Randolph,2022-02-24
21,4,17,0,Randolph,2022-02-25
8,1,7,0,Randolph,2022-02-27
24,9,15,0,Randolph,2022-02-28
16,5,11,0,Randolph,2022-03-01
9,3,6,0,Randolph,2022-03-04
11,5,6,0,Randolph,2022-03-05
13,4,9,0,Randolph,2022-03-06
11,1,10,0,Randolph,2022-03-09
5,1,4,0,Randolph,2022-03-10
2,0,2,0,Randolph,2022-03-12
5,3,2,0,Randolph,2022-03-13
7,1,6,0,Randolph,2022-03-14
3,0,3,0,Randolph,2022-03-15
3,1,2,0,Randolph,2022-03-18
3,3,0,0,Randolph,2022-03-19
4,0,4,0,Randolph,2022-03-21
5,1,4,0,Randolph,2022-03-22
1,0,1,0,Randolph,2022-03-23
2,0,2,0,Randolph,2022-03-24
2,0,2,0,Randolph,2022-03-25
2,1,1,0,Randolph,2022-03-26
1,0,1,0,Randolph,2022-03-27
3,1,2,0,Randolph,2022-03-28
4,1,3,0,Randolph,2022-03-29
5,1,4,0,Randolph,2022-03-30
2,2,0,0,Randolph,2022-03-31
2,1,1,0,Randolph,2022-04-01
3,0,3,0,Randolph,2022-04-02
3,0,3,0,Randolph,2022-04-03
3,1,2,0,Randolph,2022-04-04
8,2,6,0,Randolph,2022-04-05
7,4,3,0,Randolph,2022-04-06
3,0,3,0,Randolph,2022-04-07
8,4,4,0,Randolph,2022-04-09
2,0,2,0,Randolph,2022-04-10
9,6,3,0,Randolph,2022-04-11
12,1,11,0,Randolph,2022-04-13
11,2,9,0,Randolph,2022-04-14
4,1,3,0,Randolph,2022-04-16
2,1,1,0,Randolph,2022-04-17
11,7,4,0,Randolph,2022-04-18
4,1,3,0,Randolph,2022-04-20
11,3,8,0,Randolph,2022-04-21
9,1,8,0,Randolph,2022-04-22
3,1,2,0,Randolph,2022-04-23
4,2,2,0,Randolph,2022-04-24
34,11,23,0,Randolph,2022-04-25
18,8,10,0,Randolph,2022-04-26
22,10,12,0,Randolph,2022-04-27
21,15,6,0,Randolph,2022-04-28
17,7,10,0,Randolph,2022-04-29
5,3,2,0,Randolph,2022-04-30
13,4,9,0,Randolph,2022-05-01
18,8,10,0,Randolph,2022-05-03
11,4,7,0,Randolph,2022-05-04
19,8,11,0,Randolph,2022-05-05
14,5,9,0,Randolph,2022-05-06
14,8,6,0,Randolph,2022-05-07
16,10,6,0,Randolph,2022-05-08
23,8,15,0,Randolph,2022-05-09
35,20,15,0,Randolph,2022-05-10
23,9,14,0,Randolph,2022-05-11
26,14,12,0,Randolph,2022-05-12
27,14,13,0,Randolph,2022-05-13
14,5,9,0,Randolph,2022-05-14
50,27,23,0,Randolph,2022-05-16
29,12,17,0,Randolph,2022-05-17
34,16,18,0,Randolph,2022-05-18
39,20,19,0,Randolph,2022-05-19
22,12,10,0,Randolph,2022-05-20
28,14,14,0,Randolph,2022-05-21
25,14,11,0,Randolph,2022-05-22
69,44,25,0,Randolph,2022-05-23
33,14,19,0,Randolph,2022-05-24
45,30,15,0,Randolph,2022-05-25
30,18,12,0,Randolph,2022-05-26
43,20,23,0,Randolph,2022-05-27
17,7,10,0,Randolph,2022-05-28
15,5,10,0,Randolph,2022-05-29
16,12,4,0,Randolph,2022-05-30
29,8,21,0,Randolph,2022-06-01
33,14,19,0,Randolph,2022-06-02
20,6,14,0,Randolph,2022-06-04
15,3,12,0,Richmond,2021-12-09
12,2,10,0,Richmond,2021-12-10
5,0,5,0,Richmond,2021-12-12
24,7,17,0,Richmond,2021-12-13
19,5,14,0,Richmond,2021-12-14
12,4,8,0,Richmond,2021-12-15
8,4,4,0,Richmond,2021-12-17
19,5,14,0,Richmond,2021-12-20
35,10,25,0,Richmond,2021-12-21
20,6,14,0,Richmond,2021-12-22
32,3,29,0,Richmond,2021-12-26
107,8,99,0,Richmond,2021-12-28
107,4,103,0,Richmond,2021-12-29
93,7,86,0,Richmond,2021-12-30
69,3,66,0,Richmond,2021-12-31
64,3,61,0,Richmond,2022-01-01
204,21,183,0,Richmond,2022-01-04
202,35,167,0,Richmond,2022-01-06
167,14,153,0,Richmond,2022-01-07
320,66,254,0,Richmond,2022-01-10
282,46,236,0,Richmond,2022-01-11
95,14,81,0,Richmond,2022-01-17
352,61,291,0,Richmond,2022-01-18
41,4,37,0,Richmond,2022-01-23
68,8,60,0,Richmond,2022-01-28
23,5,18,0,Richmond,2022-01-30
78,26,52,0,Richmond,2022-01-31
55,21,34,0,Richmond,2022-02-01
12,2,10,0,Richmond,2022-02-05
23,7,16,0,Richmond,2022-02-09
23,10,13,0,Richmond,2022-02-10
7,1,6,0,Richmond,2022-02-12
33,9,24,0,Richmond,2022-02-14
14,6,8,0,Richmond,2022-02-16
12,4,8,0,Richmond,2022-02-17
11,1,10,0,Richmond,2022-02-18
8,3,5,0,Richmond,2022-02-19
2,1,1,0,Richmond,2022-02-20
11,1,10,0,Richmond,2022-02-21
12,0,12,0,Richmond,2022-02-22
1,0,1,0,Richmond,2022-02-24
2,0,2,0,Richmond,2022-02-26
9,1,8,0,Richmond,2022-02-28
1,0,1,0,Richmond,2022-03-01
5,2,3,0,Richmond,2022-03-02
2,1,1,0,Richmond,2022-03-03
0,0,0,0,Richmond,2022-03-06
4,0,4,0,Richmond,2022-03-07
3,0,3,0,Richmond,2022-03-08
4,1,3,0,Richmond,2022-03-09
2,0,2,0,Richmond,2022-03-10
1,0,1,0,Richmond,2022-03-11
0,0,0,0,Richmond,2022-03-12
3,0,3,0,Richmond,2022-03-13
2,0,2,0,Richmond,2022-03-14
0,0,0,0,Richmond,2022-03-15
1,1,0,0,Richmond,2022-03-16
0,0,0,0,Richmond,2022-03-17
0,0,0,0,Richmond,2022-03-18
0,0,0,0,Richmond,2022-03-19
0,0,0,0,Richmond,2022-03-20
1,0,1,0,Richmond,2022-03-21
0,0,0,0,Richmond,2022-03-22
1,0,1,0,Richmond,2022-03-23
4,1,3,0,Richmond,2022-03-24
1,0,1,0,Richmond,2022-03-25
0,0,0,0,Richmond,2022-03-26
0,0,0,0,Richmond,2022-03-27
0,0,0,0,Richmond,2022-03-28
0,0,0,0,Richmond,2022-03-29
0,0,0,0,Richmond,2022-03-30
0,0,0,0,Richmond,2022-03-31
1,1,0,0,Richmond,2022-04-01
0,0,0,0,Richmond,2022-04-02
0,0,0,0,Richmond,2022-04-03
1,0,1,0,Richmond,2022-04-04
1,0,1,0,Richmond,2022-04-05
0,0,0,0,Richmond,2022-04-06
0,0,0,0,Richmond,2022-04-07
0,0,0,0,Richmond,2022-04-08
0,0,0,0,Richmond,2022-04-09
1,0,1,0,Richmond,2022-04-10
1,0,1,0,Richmond,2022-04-11
2,0,2,0,Richmond,2022-04-12
6,4,2,0,Richmond,2022-04-13
4,1,3,0,Richmond,2022-04-14
3,0,3,0,Richmond,2022-04-15
1,1,0,0,Richmond,2022-04-16
0,0,0,0,Richmond,2022-04-17
4,0,4,0,Richmond,2022-04-18
4,1,3,0,Richmond,2022-04-19
7,1,6,0,Richmond,2022-04-20
6,2,4,0,Richmond,2022-04-21
5,3,2,0,Richmond,2022-04-22
1,0,1,0,Richmond,2022-04-23
5,1,4,0,Richmond,2022-04-24
3,2,1,0,Richmond,2022-04-25
3,1,2,0,Richmond,2022-04-26
6,0,6,0,Richmond,2022-04-27
7,1,6,0,Richmond,2022-04-28
5,2,3,0,Richmond,2022-04-29
4,1,3,0,Richmond,2022-04-30
4,0,4,0,Richmond,2022-05-01
14,3,11,0,Richmond,2022-05-02
5,1,4,0,Richmond,2022-05-03
5,3,2,0,Richmond,2022-05-04
10,4,6,0,Richmond,2022-05-05
12,6,6,0,Richmond,2022-05-06
2,0,2,0,Richmond,2022-05-07
2,0,2,0,Richmond,2022-05-08
13,7,6,0,Richmond,2022-05-09
7,4,3,0,Richmond,2022-05-10
14,3,11,0,Richmond,2022-05-11
10,6,4,0,Richmond,2022-05-12
12,3,9,0,Richmond,2022-05-13
6,2,4,0,Richmond,2022-05-14
9,3,6,0,Richmond,2022-05-15
17,6,11,0,Richmond,2022-05-16
12,9,3,0,Richmond,2022-05-17
14,5,9,0,Richmond,2022-05-18
14,7,7,0,Richmond,2022-05-19
11,5,6,0,Richmond,2022-05-20
7,1,6,0,Richmond,2022-05-21
6,0,6,0,Richmond,2022-05-22
24,7,17,0,Richmond,2022-05-23
22,14,8,0,Richmond,2022-05-24
21,12,9,0,Richmond,2022-05-25
18,10,8,0,Richmond,2022-05-26
14,0,14,0,Richmond,2022-05-27
4,2,2,0,Richmond,2022-05-28
12,6,6,0,Richmond,2022-05-29
7,1,6,0,Richmond,2022-05-30
26,8,18,0,Richmond,2022-05-31
17,6,11,0,Richmond,2022-06-01
12,4,8,0,Richmond,2022-06-02
12,5,7,0,Richmond,2022-06-03
6,3,3,0,Richmond,2022-06-04
57,26,31,0,Robeson,2021-12-08
48,18,30,0,Robeson,2021-12-14
38,12,26,0,Robeson,2021-12-16
47,14,33,0,Robeson,2021-12-17
55,17,38,0,Robeson,2021-12-20
52,19,33,0,Robeson,2021-12-22
64,28,36,0,Robeson,2021-12-26
52,20,32,0,Robeson,2022-01-01
140,61,79,0,Robeson,2022-01-02
471,202,269,0,Robeson,2022-01-03
496,152,344,0,Robeson,2022-01-04
197,90,107,0,Robeson,2022-01-09
746,279,467,0,Robeson,2022-01-10
760,287,473,0,Robeson,2022-01-11
667,253,414,0,Robeson,2022-01-13
43,26,17,0,Robeson,2022-01-22
501,186,315,0,Robeson,2022-01-24
236,80,156,0,Robeson,2022-01-31
155,61,94,0,Robeson,2022-02-01
22,5,17,0,Robeson,2022-02-12
33,16,17,0,Robeson,2022-02-14
34,6,28,0,Robeson,2022-02-15
34,12,22,0,Robeson,2022-02-22
4,1,3,0,Robeson,2022-02-26
9,2,7,0,Robeson,2022-02-28
13,7,6,0,Robeson,2022-03-02
12,3,9,0,Robeson,2022-03-03
7,0,7,0,Robeson,2022-03-04
7,3,4,0,Robeson,2022-03-05
3,2,1,0,Robeson,2022-03-06
6,5,1,0,Robeson,2022-03-07
8,4,4,0,Robeson,2022-03-08
5,4,1,0,Robeson,2022-03-10
3,1,2,0,Robeson,2022-03-11
3,2,1,0,Robeson,2022-03-12
8,2,6,0,Robeson,2022-03-14
6,2,4,0,Robeson,2022-03-15
3,3,0,0,Robeson,2022-03-16
8,3,5,0,Robeson,2022-03-17
2,1,1,0,Robeson,2022-03-18
0,0,0,0,Robeson,2022-03-19
2,0,2,0,Robeson,2022-03-20
4,1,3,0,Robeson,2022-03-21
0,0,0,0,Robeson,2022-03-22
7,3,4,0,Robeson,2022-03-23
3,1,2,0,Robeson,2022-03-24
1,1,0,0,Robeson,2022-03-25
3,0,3,0,Robeson,2022-03-26
1,0,1,0,Robeson,2022-03-27
7,3,4,0,Robeson,2022-03-29
4,0,4,0,Robeson,2022-03-30
3,1,2,0,Robeson,2022-03-31
3,3,0,0,Robeson,2022-04-01
1,1,0,0,Robeson,2022-04-02
2,1,1,0,Robeson,2022-04-03
11,8,3,0,Robeson,2022-04-04
6,2,4,0,Robeson,2022-04-05
10,5,5,0,Robeson,2022-04-06
4,2,2,0,Robeson,2022-04-07
10,5,5,0,Robeson,2022-04-08
3,3,0,0,Robeson,2022-04-09
2,2,0,0,Robeson,2022-04-10
9,6,3,0,Robeson,2022-04-11
11,4,7,0,Robeson,2022-04-12
7,4,3,0,Robeson,2022-04-14
9,3,6,0,Robeson,2022-04-15
5,4,1,0,Robeson,2022-04-16
5,1,4,0,Robeson,2022-04-17
8,3,5,0,Robeson,2022-04-18
10,5,5,0,Robeson,2022-04-19
3,1,2,0,Robeson,2022-04-20
16,13,3,0,Robeson,2022-04-21
7,5,2,0,Robeson,2022-04-22
6,5,1,0,Robeson,2022-04-23
4,1,3,0,Robeson,2022-04-24
22,11,11,0,Robeson,2022-04-25
18,10,8,0,Robeson,2022-04-26
13,8,5,0,Robeson,2022-04-27
15,9,6,0,Robeson,2022-04-28
18,14,4,0,Robeson,2022-04-29
9,3,6,0,Robeson,2022-04-30
11,7,4,0,Robeson,2022-05-01
22,14,8,0,Robeson,2022-05-02
23,14,9,0,Robeson,2022-05-03
26,11,15,0,Robeson,2022-05-04
33,23,10,0,Robeson,2022-05-05
24,11,13,0,Robeson,2022-05-06
11,5,6,0,Robeson,2022-05-08
41,17,24,0,Robeson,2022-05-09
33,14,19,0,Robeson,2022-05-10
52,30,22,0,Robeson,2022-05-11
39,21,18,0,Robeson,2022-05-12
49,18,31,0,Robeson,2022-05-13
29,15,14,0,Robeson,2022-05-14
25,12,13,0,Robeson,2022-05-15
68,29,39,0,Robeson,2022-05-16
83,42,41,0,Robeson,2022-05-17
57,29,28,0,Robeson,2022-05-18
80,44,36,0,Robeson,2022-05-19
39,21,18,0,Robeson,2022-05-20
23,10,13,0,Robeson,2022-05-21
22,11,11,0,Robeson,2022-05-22
71,35,36,0,Robeson,2022-05-23
64,35,29,0,Robeson,2022-05-24
68,43,25,0,Robeson,2022-05-25
74,38,36,0,Robeson,2022-05-26
44,23,21,0,Robeson,2022-05-27
27,18,9,0,Robeson,2022-05-28
23,15,8,0,Robeson,2022-05-29
27,17,10,0,Robeson,2022-05-30
90,51,39,0,Robeson,2022-05-31
79,41,38,0,Robeson,2022-06-01
58,34,24,0,Robeson,2022-06-02
51,26,25,0,Robeson,2022-06-03
26,13,13,0,Robeson,2022-06-04
47,7,40,0,Rockingham,2021-12-07
25,4,21,0,Rockingham,2021-12-10
23,1,22,0,Rockingham,2021-12-12
31,8,23,0,Rockingham,2021-12-15
29,5,24,0,Rockingham,2021-12-16
68,15,53,0,Rockingham,2021-12-20
48,4,44,0,Rockingham,2021-12-21
50,9,41,0,Rockingham,2021-12-22
48,9,39,0,Rockingham,2021-12-23
162,35,127,0,Rockingham,2021-12-27
59,6,53,0,Rockingham,2022-01-02
190,57,133,0,Rockingham,2022-01-03
264,56,208,0,Rockingham,2022-01-04
328,79,249,0,Rockingham,2022-01-05
316,25,291,0,Rockingham,2022-01-12
83,32,51,0,Rockingham,2022-01-17
42,5,37,0,Rockingham,2022-01-30
105,6,99,0,Rockingham,2022-02-01
29,4,25,0,Rockingham,2022-02-06
60,4,56,0,Rockingham,2022-02-10
11,2,9,0,Rockingham,2022-02-12
27,6,21,0,Rockingham,2022-02-17
10,2,8,0,Rockingham,2022-02-19
27,3,24,0,Rockingham,2022-02-22
11,2,9,0,Rockingham,2022-02-23
12,2,10,0,Rockingham,2022-02-24
9,0,9,0,Rockingham,2022-02-26
9,0,9,0,Rockingham,2022-02-27
23,3,20,0,Rockingham,2022-02-28
11,2,9,0,Rockingham,2022-03-01
8,1,7,0,Rockingham,2022-03-03
4,0,4,0,Rockingham,2022-03-05
3,0,3,0,Rockingham,2022-03-06
12,1,11,0,Rockingham,2022-03-07
5,1,4,0,Rockingham,2022-03-08
6,0,6,0,Rockingham,2022-03-10
2,0,2,0,Rockingham,2022-03-11
1,0,1,0,Rockingham,2022-03-13
3,0,3,0,Rockingham,2022-03-14
4,0,4,0,Rockingham,2022-03-15
1,0,1,0,Rockingham,2022-03-16
0,0,0,0,Rockingham,2022-03-17
7,1,6,0,Rockingham,2022-03-18
5,0,5,0,Rockingham,2022-03-19
1,0,1,0,Rockingham,2022-03-20
3,0,3,0,Rockingham,2022-03-21
3,0,3,0,Rockingham,2022-03-23
3,1,2,0,Rockingham,2022-03-24
3,0,3,0,Rockingham,2022-03-25
1,0,1,0,Rockingham,2022-03-27
6,0,6,0,Rockingham,2022-03-29
2,0,2,0,Rockingham,2022-03-30
3,3,0,0,Rockingham,2022-03-31
1,0,1,0,Rockingham,2022-04-01
0,0,0,0,Rockingham,2022-04-02
2,0,2,0,Rockingham,2022-04-03
4,0,4,0,Rockingham,2022-04-04
4,0,4,0,Rockingham,2022-04-05
4,0,4,0,Rockingham,2022-04-06
1,0,1,0,Rockingham,2022-04-07
3,0,3,0,Rockingham,2022-04-08
3,1,2,0,Rockingham,2022-04-09
6,0,6,0,Rockingham,2022-04-10
10,3,7,0,Rockingham,2022-04-11
5,1,4,0,Rockingham,2022-04-12
1,1,0,0,Rockingham,2022-04-14
4,0,4,0,Rockingham,2022-04-15
1,0,1,0,Rockingham,2022-04-16
1,0,1,0,Rockingham,2022-04-17
12,4,8,0,Rockingham,2022-04-18
6,1,5,0,Rockingham,2022-04-19
5,2,3,0,Rockingham,2022-04-20
6,0,6,0,Rockingham,2022-04-21
7,1,6,0,Rockingham,2022-04-22
3,0,3,0,Rockingham,2022-04-23
6,1,5,0,Rockingham,2022-04-24
13,3,10,0,Rockingham,2022-04-25
8,3,5,0,Rockingham,2022-04-26
6,0,6,0,Rockingham,2022-04-27
13,1,12,0,Rockingham,2022-04-28
6,1,5,0,Rockingham,2022-04-29
5,0,5,0,Rockingham,2022-04-30
7,1,6,0,Rockingham,2022-05-01
15,1,14,0,Rockingham,2022-05-02
9,0,9,0,Rockingham,2022-05-03
14,5,9,0,Rockingham,2022-05-04
18,1,17,0,Rockingham,2022-05-05
16,4,12,0,Rockingham,2022-05-06
7,1,6,0,Rockingham,2022-05-07
9,2,7,0,Rockingham,2022-05-08
20,6,14,0,Rockingham,2022-05-09
31,6,25,0,Rockingham,2022-05-10
20,5,15,0,Rockingham,2022-05-11
28,8,20,0,Rockingham,2022-05-12
15,7,8,0,Rockingham,2022-05-13
18,2,16,0,Rockingham,2022-05-14
11,5,6,0,Rockingham,2022-05-15
30,5,25,0,Rockingham,2022-05-16
30,5,25,0,Rockingham,2022-05-17
40,6,34,0,Rockingham,2022-05-18
28,5,23,0,Rockingham,2022-05-19
25,7,18,0,Rockingham,2022-05-20
15,3,12,0,Rockingham,2022-05-21
18,0,18,0,Rockingham,2022-05-22
35,6,29,0,Rockingham,2022-05-23
23,8,15,0,Rockingham,2022-05-24
25,2,23,0,Rockingham,2022-05-25
31,11,20,0,Rockingham,2022-05-26
9,5,4,0,Rockingham,2022-05-27
11,3,8,0,Rockingham,2022-05-28
13,7,6,0,Rockingham,2022-05-29
15,4,11,0,Rockingham,2022-05-30
34,3,31,0,Rockingham,2022-05-31
25,3,22,0,Rockingham,2022-06-01
17,7,10,0,Rockingham,2022-06-02
14,1,13,0,Rockingham,2022-06-03
9,2,7,0,Rockingham,2022-06-04
22,4,18,0,Rowan,2021-12-11
32,5,27,0,Rowan,2021-12-12
59,5,54,0,Rowan,2021-12-14
52,7,45,0,Rowan,2021-12-16
30,5,25,0,Rowan,2021-12-18
92,16,76,0,Rowan,2021-12-23
253,39,214,0,Rowan,2021-12-27
296,25,271,0,Rowan,2021-12-29
301,44,257,0,Rowan,2021-12-30
71,14,57,0,Rowan,2022-01-01
108,43,65,0,Rowan,2022-01-02
409,63,346,0,Rowan,2022-01-06
475,65,410,0,Rowan,2022-01-14
317,54,263,0,Rowan,2022-01-25
66,17,49,0,Rowan,2022-01-29
247,36,211,0,Rowan,2022-01-31
178,16,162,0,Rowan,2022-02-01
119,15,104,0,Rowan,2022-02-03
55,6,49,0,Rowan,2022-02-14
53,5,48,0,Rowan,2022-02-15
48,2,46,0,Rowan,2022-02-16
46,6,40,0,Rowan,2022-02-17
9,0,9,0,Rowan,2022-02-20
31,6,25,0,Rowan,2022-02-22
8,0,8,0,Rowan,2022-02-26
21,3,18,0,Rowan,2022-02-28
36,23,13,0,Rowan,2022-03-01
16,1,15,0,Rowan,2022-03-02
2,0,2,0,Rowan,2022-03-03
6,0,6,0,Rowan,2022-03-04
11,3,8,0,Rowan,2022-03-06
2,1,1,0,Rowan,2022-03-12
2,0,2,0,Rowan,2022-03-13
10,0,10,0,Rowan,2022-03-14
7,1,6,0,Rowan,2022-03-16
4,0,4,0,Rowan,2022-03-17
9,1,8,0,Rowan,2022-03-18
3,1,2,0,Rowan,2022-03-21
11,3,8,0,Rowan,2022-03-22
4,0,4,0,Rowan,2022-03-23
5,2,3,0,Rowan,2022-03-24
5,2,3,0,Rowan,2022-03-25
3,1,2,0,Rowan,2022-03-26
0,0,0,0,Rowan,2022-03-27
2,0,2,0,Rowan,2022-03-28
3,1,2,0,Rowan,2022-03-30
2,1,1,0,Rowan,2022-03-31
3,0,3,0,Rowan,2022-04-01
0,0,0,0,Rowan,2022-04-02
4,2,2,0,Rowan,2022-04-03
6,2,4,0,Rowan,2022-04-04
6,1,5,0,Rowan,2022-04-05
6,3,3,0,Rowan,2022-04-06
9,4,5,0,Rowan,2022-04-07
3,0,3,0,Rowan,2022-04-09
4,1,3,0,Rowan,2022-04-10
6,0,6,0,Rowan,2022-04-11
12,2,10,0,Rowan,2022-04-12
14,3,11,0,Rowan,2022-04-13
9,1,8,0,Rowan,2022-04-14
11,1,10,0,Rowan,2022-04-15
3,1,2,0,Rowan,2022-04-16
7,2,5,0,Rowan,2022-04-17
11,3,8,0,Rowan,2022-04-18
12,4,8,0,Rowan,2022-04-19
12,1,11,0,Rowan,2022-04-20
12,3,9,0,Rowan,2022-04-21
15,3,12,0,Rowan,2022-04-22
14,3,11,0,Rowan,2022-04-23
13,1,12,0,Rowan,2022-04-24
25,10,15,0,Rowan,2022-04-25
20,2,18,0,Rowan,2022-04-27
16,2,14,0,Rowan,2022-04-28
12,1,11,0,Rowan,2022-04-29
6,3,3,0,Rowan,2022-05-01
31,2,29,0,Rowan,2022-05-02
36,4,32,0,Rowan,2022-05-03
28,5,23,0,Rowan,2022-05-04
23,8,15,0,Rowan,2022-05-05
19,6,13,0,Rowan,2022-05-06
14,3,11,0,Rowan,2022-05-07
31,6,25,0,Rowan,2022-05-09
36,9,27,0,Rowan,2022-05-10
32,3,29,0,Rowan,2022-05-11
27,2,25,0,Rowan,2022-05-12
32,8,24,0,Rowan,2022-05-13
20,0,20,0,Rowan,2022-05-14
28,8,20,0,Rowan,2022-05-15
42,4,38,0,Rowan,2022-05-16
43,9,34,0,Rowan,2022-05-17
31,6,25,0,Rowan,2022-05-18
41,8,33,0,Rowan,2022-05-19
36,6,30,0,Rowan,2022-05-20
9,0,9,0,Rowan,2022-05-21
11,2,9,0,Rowan,2022-05-22
51,10,41,0,Rowan,2022-05-23
50,10,40,0,Rowan,2022-05-24
40,9,31,0,Rowan,2022-05-25
50,9,41,0,Rowan,2022-05-26
25,7,18,0,Rowan,2022-05-27
28,10,18,0,Rowan,2022-05-28
25,5,20,0,Rowan,2022-05-29
25,10,15,0,Rowan,2022-05-30
73,18,55,0,Rowan,2022-05-31
56,16,40,0,Rowan,2022-06-01
63,22,41,0,Rowan,2022-06-02
13,3,10,0,Rowan,2022-06-04
25,7,18,0,Rutherford,2021-12-09
11,6,5,0,Rutherford,2021-12-10
14,4,10,0,Rutherford,2021-12-12
5,2,3,0,Rutherford,2021-12-18
20,2,18,0,Rutherford,2021-12-20
23,3,20,0,Rutherford,2021-12-22
31,13,18,0,Rutherford,2021-12-23
14,1,13,0,Rutherford,2021-12-24
6,2,4,0,Rutherford,2021-12-25
17,3,14,0,Rutherford,2021-12-26
50,12,38,0,Rutherford,2021-12-27
127,63,64,0,Rutherford,2021-12-29
83,28,55,0,Rutherford,2021-12-30
53,16,37,0,Rutherford,2021-12-31
49,19,30,0,Rutherford,2022-01-02
122,54,68,0,Rutherford,2022-01-03
114,26,88,0,Rutherford,2022-01-04
172,45,127,0,Rutherford,2022-01-06
152,74,78,0,Rutherford,2022-01-07
52,22,30,0,Rutherford,2022-01-08
46,23,23,0,Rutherford,2022-01-09
259,137,122,0,Rutherford,2022-01-10
309,79,230,0,Rutherford,2022-01-11
231,107,124,0,Rutherford,2022-01-12
44,13,31,0,Rutherford,2022-01-17
182,66,116,0,Rutherford,2022-01-19
192,69,123,0,Rutherford,2022-01-20
149,50,99,0,Rutherford,2022-01-21
122,50,72,0,Rutherford,2022-01-26
124,31,93,0,Rutherford,2022-01-27
33,12,21,0,Rutherford,2022-01-30
75,23,52,0,Rutherford,2022-02-02
13,0,13,0,Rutherford,2022-02-06
76,34,42,0,Rutherford,2022-02-07
44,18,26,0,Rutherford,2022-02-10
32,8,24,0,Rutherford,2022-02-16
6,0,6,0,Rutherford,2022-02-20
13,3,10,0,Rutherford,2022-02-21
10,2,8,0,Rutherford,2022-02-22
3,0,3,0,Rutherford,2022-02-25
3,0,3,0,Rutherford,2022-02-26
4,0,4,0,Rutherford,2022-02-27
7,2,5,0,Rutherford,2022-02-28
3,1,2,0,Rutherford,2022-03-03
5,1,4,0,Rutherford,2022-03-04
4,0,4,0,Rutherford,2022-03-05
1,1,0,0,Rutherford,2022-03-06
1,0,1,0,Rutherford,2022-03-07
1,0,1,0,Rutherford,2022-03-08
2,0,2,0,Rutherford,2022-03-09
4,3,1,0,Rutherford,2022-03-10
4,4,0,0,Rutherford,2022-03-11
3,0,3,0,Rutherford,2022-03-12
0,0,0,0,Rutherford,2022-03-13
0,0,0,0,Rutherford,2022-03-14
6,1,5,0,Rutherford,2022-03-16
0,0,0,0,Rutherford,2022-03-17
1,0,1,0,Rutherford,2022-03-18
1,0,1,0,Rutherford,2022-03-19
0,0,0,0,Rutherford,2022-03-20
2,1,1,0,Rutherford,2022-03-21
1,1,0,0,Rutherford,2022-03-22
1,1,0,0,Rutherford,2022-03-23
0,0,0,0,Rutherford,2022-03-24
3,1,2,0,Rutherford,2022-03-25
0,0,0,0,Rutherford,2022-03-26
2,0,2,0,Rutherford,2022-03-27
2,0,2,0,Rutherford,2022-03-28
1,1,0,0,Rutherford,2022-03-29
3,1,2,0,Rutherford,2022-03-30
1,0,1,0,Rutherford,2022-03-31
0,0,0,0,Rutherford,2022-04-01
1,0,1,0,Rutherford,2022-04-02
0,0,0,0,Rutherford,2022-04-03
2,0,2,0,Rutherford,2022-04-04
1,0,1,0,Rutherford,2022-04-05
1,0,1,0,Rutherford,2022-04-06
0,0,0,0,Rutherford,2022-04-07
3,0,3,0,Rutherford,2022-04-08
0,0,0,0,Rutherford,2022-04-09
1,0,1,0,Rutherford,2022-04-10
0,0,0,0,Rutherford,2022-04-11
3,2,1,0,Rutherford,2022-04-12
3,0,3,0,Rutherford,2022-04-13
4,0,4,0,Rutherford,2022-04-14
1,0,1,0,Rutherford,2022-04-15
2,0,2,0,Rutherford,2022-04-16
1,0,1,0,Rutherford,2022-04-17
5,1,4,0,Rutherford,2022-04-18
1,0,1,0,Rutherford,2022-04-19
6,0,6,0,Rutherford,2022-04-20
4,0,4,0,Rutherford,2022-04-21
7,2,5,0,Rutherford,2022-04-22
3,1,2,0,Rutherford,2022-04-23
3,1,2,0,Rutherford,2022-04-24
4,1,3,0,Rutherford,2022-04-25
8,4,4,0,Rutherford,2022-04-27
2,1,1,0,Rutherford,2022-04-28
3,1,2,0,Rutherford,2022-04-29
0,0,0,0,Rutherford,2022-04-30
2,0,2,0,Rutherford,2022-05-01
3,0,3,0,Rutherford,2022-05-03
12,1,11,0,Rutherford,2022-05-04
5,1,4,0,Rutherford,2022-05-05
11,2,9,0,Rutherford,2022-05-06
6,2,4,0,Rutherford,2022-05-07
5,1,4,0,Rutherford,2022-05-08
5,0,5,0,Rutherford,2022-05-09
11,5,6,0,Rutherford,2022-05-12
13,3,10,0,Rutherford,2022-05-13
6,1,5,0,Rutherford,2022-05-14
4,2,2,0,Rutherford,2022-05-15
16,2,14,0,Rutherford,2022-05-16
13,3,10,0,Rutherford,2022-05-17
25,8,17,0,Rutherford,2022-05-18
17,3,14,0,Rutherford,2022-05-19
9,5,4,0,Rutherford,2022-05-20
8,4,4,0,Rutherford,2022-05-21
10,7,3,0,Rutherford,2022-05-22
21,9,12,0,Rutherford,2022-05-23
26,9,17,0,Rutherford,2022-05-24
13,4,9,0,Rutherford,2022-05-25
10,6,4,0,Rutherford,2022-05-26
11,3,8,0,Rutherford,2022-05-27
5,2,3,0,Rutherford,2022-05-28
8,2,6,0,Rutherford,2022-05-29
8,5,3,0,Rutherford,2022-05-30
16,3,13,0,Rutherford,2022-05-31
15,5,10,0,Rutherford,2022-06-01
21,5,16,0,Rutherford,2022-06-02
11,3,8,0,Rutherford,2022-06-03
7,1,6,0,Rutherford,2022-06-04
15,8,7,0,Sampson,2021-12-08
25,11,14,0,Sampson,2021-12-09
8,4,4,0,Sampson,2021-12-12
13,7,6,0,Sampson,2021-12-17
5,4,1,0,Sampson,2021-12-18
19,11,8,0,Sampson,2021-12-19
27,14,13,0,Sampson,2021-12-20
26,12,14,0,Sampson,2021-12-22
24,10,14,0,Sampson,2021-12-23
7,2,5,0,Sampson,2021-12-24
5,2,3,0,Sampson,2021-12-25
13,2,11,0,Sampson,2021-12-26
91,48,43,0,Sampson,2021-12-28
97,48,49,0,Sampson,2021-12-29
113,56,57,0,Sampson,2021-12-30
69,39,30,0,Sampson,2021-12-31
25,12,13,0,Sampson,2022-01-01
45,23,22,0,Sampson,2022-01-02
207,107,100,0,Sampson,2022-01-03
191,92,99,0,Sampson,2022-01-07
86,29,57,0,Sampson,2022-01-09
390,142,248,0,Sampson,2022-01-10
385,130,255,0,Sampson,2022-01-11
282,68,214,0,Sampson,2022-01-13
259,80,179,0,Sampson,2022-01-14
125,59,66,0,Sampson,2022-01-15
48,17,31,0,Sampson,2022-01-16
59,22,37,0,Sampson,2022-01-21
26,10,16,0,Sampson,2022-01-22
42,6,36,0,Sampson,2022-01-23
111,45,66,0,Sampson,2022-01-27
101,36,65,0,Sampson,2022-01-28
75,22,53,0,Sampson,2022-02-01
54,17,37,0,Sampson,2022-02-04
43,18,25,0,Sampson,2022-02-09
31,16,15,0,Sampson,2022-02-10
10,4,6,0,Sampson,2022-02-12
16,7,9,0,Sampson,2022-02-15
3,1,2,0,Sampson,2022-02-19
25,11,14,0,Sampson,2022-02-21
12,5,7,0,Sampson,2022-02-22
15,5,10,0,Sampson,2022-02-25
4,3,1,0,Sampson,2022-02-26
3,1,2,0,Sampson,2022-02-27
8,0,8,0,Sampson,2022-02-28
7,5,2,0,Sampson,2022-03-01
4,1,3,0,Sampson,2022-03-02
3,1,2,0,Sampson,2022-03-04
1,1,0,0,Sampson,2022-03-05
3,1,2,0,Sampson,2022-03-08
1,1,0,0,Sampson,2022-03-09
0,0,0,0,Sampson,2022-03-10
1,0,1,0,Sampson,2022-03-11
1,0,1,0,Sampson,2022-03-12
1,0,1,0,Sampson,2022-03-13
4,3,1,0,Sampson,2022-03-14
6,4,2,0,Sampson,2022-03-15
4,2,2,0,Sampson,2022-03-16
3,1,2,0,Sampson,2022-03-17
2,1,1,0,Sampson,2022-03-18
3,1,2,0,Sampson,2022-03-19
3,1,2,0,Sampson,2022-03-21
3,1,2,0,Sampson,2022-03-22
1,0,1,0,Sampson,2022-03-23
5,3,2,0,Sampson,2022-03-24
1,0,1,0,Sampson,2022-03-25
1,0,1,0,Sampson,2022-03-26
0,0,0,0,Sampson,2022-03-27
2,0,2,0,Sampson,2022-03-28
3,3,0,0,Sampson,2022-03-29
7,5,2,0,Sampson,2022-03-30
10,0,10,0,Sampson,2022-03-31
0,0,0,0,Sampson,2022-04-01
1,1,0,0,Sampson,2022-04-02
2,1,1,0,Sampson,2022-04-04
6,6,0,0,Sampson,2022-04-05
11,7,4,0,Sampson,2022-04-06
4,2,2,0,Sampson,2022-04-07
1,0,1,0,Sampson,2022-04-08
0,0,0,0,Sampson,2022-04-10
4,1,3,0,Sampson,2022-04-11
2,1,1,0,Sampson,2022-04-12
0,0,0,0,Sampson,2022-04-13
9,3,6,0,Sampson,2022-04-14
4,1,3,0,Sampson,2022-04-15
0,0,0,0,Sampson,2022-04-17
10,4,6,0,Sampson,2022-04-18
10,4,6,0,Sampson,2022-04-19
6,5,1,0,Sampson,2022-04-20
6,4,2,0,Sampson,2022-04-21
9,6,3,0,Sampson,2022-04-22
1,0,1,0,Sampson,2022-04-23
2,1,1,0,Sampson,2022-04-24
6,4,2,0,Sampson,2022-04-25
10,3,7,0,Sampson,2022-04-26
1,1,0,0,Sampson,2022-04-27
4,2,2,0,Sampson,2022-04-28
4,2,2,0,Sampson,2022-04-29
1,1,0,0,Sampson,2022-04-30
3,2,1,0,Sampson,2022-05-01
12,8,4,0,Sampson,2022-05-02
9,5,4,0,Sampson,2022-05-03
8,5,3,0,Sampson,2022-05-04
13,9,4,0,Sampson,2022-05-05
1,0,1,0,Sampson,2022-05-06
5,1,4,0,Sampson,2022-05-07
3,2,1,0,Sampson,2022-05-08
3,2,1,0,Sampson,2022-05-09
4,1,3,0,Sampson,2022-05-10
3,1,2,0,Sampson,2022-05-11
11,4,7,0,Sampson,2022-05-12
7,3,4,0,Sampson,2022-05-13
5,3,2,0,Sampson,2022-05-14
2,2,0,0,Sampson,2022-05-15
25,17,8,0,Sampson,2022-05-16
15,9,6,0,Sampson,2022-05-17
18,8,10,0,Sampson,2022-05-18
12,6,6,0,Sampson,2022-05-19
16,11,5,0,Sampson,2022-05-20
8,7,1,0,Sampson,2022-05-21
5,3,2,0,Sampson,2022-05-22
19,10,9,0,Sampson,2022-05-23
17,11,6,0,Sampson,2022-05-24
16,8,8,0,Sampson,2022-05-25
9,7,2,0,Sampson,2022-05-26
9,5,4,0,Sampson,2022-05-27
4,1,3,0,Sampson,2022-05-28
9,6,3,0,Sampson,2022-05-29
6,6,0,0,Sampson,2022-05-30
29,21,8,0,Sampson,2022-05-31
23,12,11,0,Sampson,2022-06-01
19,14,5,0,Sampson,2022-06-02
14,10,4,0,Sampson,2022-06-03
6,5,1,0,Sampson,2022-06-04
12,2,10,0,Scotland,2021-12-07
9,1,8,0,Scotland,2021-12-09
8,3,5,0,Scotland,2021-12-10
1,0,1,0,Scotland,2021-12-11
3,1,2,0,Scotland,2021-12-12
19,3,16,0,Scotland,2021-12-14
4,2,2,0,Scotland,2021-12-18
7,6,1,0,Scotland,2021-12-19
9,2,7,0,Scotland,2021-12-20
16,5,11,0,Scotland,2021-12-21
17,4,13,0,Scotland,2021-12-22
24,9,15,0,Scotland,2021-12-23
8,1,7,0,Scotland,2021-12-24
10,6,4,0,Scotland,2021-12-25
27,10,17,0,Scotland,2021-12-26
63,15,48,0,Scotland,2021-12-27
116,20,96,0,Scotland,2021-12-30
46,11,35,0,Scotland,2021-12-31
46,8,38,0,Scotland,2022-01-01
49,14,35,0,Scotland,2022-01-02
126,21,105,0,Scotland,2022-01-03
215,40,175,0,Scotland,2022-01-10
215,42,173,0,Scotland,2022-01-11
214,49,165,0,Scotland,2022-01-12
158,47,111,0,Scotland,2022-01-13
134,35,99,0,Scotland,2022-01-14
62,23,39,0,Scotland,2022-01-17
197,55,142,0,Scotland,2022-01-18
29,10,19,0,Scotland,2022-01-23
82,28,54,0,Scotland,2022-01-25
59,19,40,0,Scotland,2022-01-26
62,16,46,0,Scotland,2022-01-27
50,17,33,0,Scotland,2022-01-31
38,10,28,0,Scotland,2022-02-03
12,5,7,0,Scotland,2022-02-05
32,11,21,0,Scotland,2022-02-07
16,2,14,0,Scotland,2022-02-08
22,7,15,0,Scotland,2022-02-09
7,2,5,0,Scotland,2022-02-11
6,3,3,0,Scotland,2022-02-13
7,3,4,0,Scotland,2022-02-15
10,1,9,0,Scotland,2022-02-16
12,6,6,0,Scotland,2022-02-17
4,2,2,0,Scotland,2022-02-18
2,1,1,0,Scotland,2022-02-19
5,1,4,0,Scotland,2022-02-20
10,5,5,0,Scotland,2022-02-21
2,1,1,0,Scotland,2022-02-22
1,0,1,0,Scotland,2022-02-23
3,2,1,0,Scotland,2022-02-24
6,1,5,0,Scotland,2022-02-25
1,1,0,0,Scotland,2022-02-26
1,1,0,0,Scotland,2022-02-27
6,1,5,0,Scotland,2022-02-28
1,0,1,0,Scotland,2022-03-01
1,0,1,0,Scotland,2022-03-02
1,0,1,0,Scotland,2022-03-04
1,1,0,0,Scotland,2022-03-05
1,1,0,0,Scotland,2022-03-06
9,5,4,0,Scotland,2022-03-07
1,1,0,0,Scotland,2022-03-08
2,0,2,0,Scotland,2022-03-09
1,0,1,0,Scotland,2022-03-10
2,0,2,0,Scotland,2022-03-11
0,0,0,0,Scotland,2022-03-12
0,0,0,0,Scotland,2022-03-13
2,1,1,0,Scotland,2022-03-14
2,1,1,0,Scotland,2022-03-15
2,1,1,0,Scotland,2022-03-16
1,0,1,0,Scotland,2022-03-17
1,0,1,0,Scotland,2022-03-18
1,0,1,0,Scotland,2022-03-19
1,1,0,0,Scotland,2022-03-20
2,1,1,0,Scotland,2022-03-21
1,0,1,0,Scotland,2022-03-22
0,0,0,0,Scotland,2022-03-23
2,2,0,0,Scotland,2022-03-24
2,0,2,0,Scotland,2022-03-25
0,0,0,0,Scotland,2022-03-26
0,0,0,0,Scotland,2022-03-27
1,1,0,0,Scotland,2022-03-28
1,0,1,0,Scotland,2022-03-29
3,1,2,0,Scotland,2022-03-30
0,0,0,0,Scotland,2022-03-31
0,0,0,0,Scotland,2022-04-01
0,0,0,0,Scotland,2022-04-02
0,0,0,0,Scotland,2022-04-03
2,2,0,0,Scotland,2022-04-04
1,1,0,0,Scotland,2022-04-05
0,0,0,0,Scotland,2022-04-06
0,0,0,0,Scotland,2022-04-07
5,0,5,0,Scotland,2022-04-08
1,1,0,0,Scotland,2022-04-09
0,0,0,0,Scotland,2022-04-10
4,2,2,0,Scotland,2022-04-11
3,2,1,0,Scotland,2022-04-12
9,0,9,0,Scotland,2022-04-13
1,1,0,0,Scotland,2022-04-14
8,1,7,0,Scotland,2022-04-15
1,1,0,0,Scotland,2022-04-16
0,0,0,0,Scotland,2022-04-17
2,2,0,0,Scotland,2022-04-18
2,1,1,0,Scotland,2022-04-19
8,2,6,0,Scotland,2022-04-20
2,1,1,0,Scotland,2022-04-21
9,6,3,0,Scotland,2022-04-22
4,3,1,0,Scotland,2022-04-23
3,1,2,0,Scotland,2022-04-24
4,1,3,0,Scotland,2022-04-25
4,3,1,0,Scotland,2022-04-26
6,3,3,0,Scotland,2022-04-27
5,2,3,0,Scotland,2022-04-28
0,0,0,0,Scotland,2022-04-29
3,3,0,0,Scotland,2022-04-30
3,3,0,0,Scotland,2022-05-01
3,0,3,0,Scotland,2022-05-02
14,6,8,0,Scotland,2022-05-03
8,3,5,0,Scotland,2022-05-04
4,1,3,0,Scotland,2022-05-05
10,4,6,0,Scotland,2022-05-06
7,3,4,0,Scotland,2022-05-07
9,5,4,0,Scotland,2022-05-08
8,2,6,0,Scotland,2022-05-09
4,1,3,0,Scotland,2022-05-10
9,2,7,0,Scotland,2022-05-11
8,4,4,0,Scotland,2022-05-12
15,4,11,0,Scotland,2022-05-13
6,1,5,0,Scotland,2022-05-14
4,4,0,0,Scotland,2022-05-15
17,4,13,0,Scotland,2022-05-16
13,8,5,0,Scotland,2022-05-17
5,2,3,0,Scotland,2022-05-18
13,9,4,0,Scotland,2022-05-19
17,8,9,0,Scotland,2022-05-20
6,3,3,0,Scotland,2022-05-21
13,5,8,0,Scotland,2022-05-22
20,12,8,0,Scotland,2022-05-23
14,10,4,0,Scotland,2022-05-24
21,8,13,0,Scotland,2022-05-25
12,8,4,0,Scotland,2022-05-26
14,7,7,0,Scotland,2022-05-27
12,4,8,0,Scotland,2022-05-28
9,7,2,0,Scotland,2022-05-29
9,7,2,0,Scotland,2022-05-30
11,6,5,0,Scotland,2022-05-31
17,9,8,0,Scotland,2022-06-01
26,18,8,0,Scotland,2022-06-02
19,13,6,0,Scotland,2022-06-03
15,14,1,0,Scotland,2022-06-04
46,7,39,0,Stanly,2021-12-07
26,2,24,0,Stanly,2021-12-09
15,0,15,0,Stanly,2021-12-11
17,0,17,0,Stanly,2021-12-12
17,2,15,0,Stanly,2021-12-18
13,1,12,0,Stanly,2021-12-19
36,10,26,0,Stanly,2021-12-20
43,6,37,0,Stanly,2021-12-21
36,2,34,0,Stanly,2021-12-22
37,5,32,0,Stanly,2021-12-23
16,4,12,0,Stanly,2021-12-24
12,3,9,0,Stanly,2021-12-25
16,2,14,0,Stanly,2021-12-26
81,11,70,0,Stanly,2021-12-27
114,14,100,0,Stanly,2021-12-29
168,54,114,0,Stanly,2021-12-30
41,14,27,0,Stanly,2022-01-01
180,44,136,0,Stanly,2022-01-06
85,35,50,0,Stanly,2022-01-09
353,85,268,0,Stanly,2022-01-11
106,29,77,0,Stanly,2022-01-17
110,7,103,0,Stanly,2022-01-28
34,9,25,0,Stanly,2022-01-29
67,11,56,0,Stanly,2022-02-01
57,3,54,0,Stanly,2022-02-03
20,0,20,0,Stanly,2022-02-06
53,7,46,0,Stanly,2022-02-07
11,0,11,0,Stanly,2022-02-12
6,0,6,0,Stanly,2022-02-13
25,2,23,0,Stanly,2022-02-14
13,1,12,0,Stanly,2022-02-16
13,1,12,0,Stanly,2022-02-18
5,0,5,0,Stanly,2022-02-20
22,1,21,0,Stanly,2022-02-21
15,2,13,0,Stanly,2022-02-22
6,1,5,0,Stanly,2022-02-23
9,0,9,0,Stanly,2022-02-24
9,1,8,0,Stanly,2022-02-25
1,1,0,0,Stanly,2022-02-26
10,0,10,0,Stanly,2022-03-02
3,1,2,0,Stanly,2022-03-04
0,0,0,0,Stanly,2022-03-06
3,0,3,0,Stanly,2022-03-07
3,0,3,0,Stanly,2022-03-08
0,0,0,0,Stanly,2022-03-09
0,0,0,0,Stanly,2022-03-10
0,0,0,0,Stanly,2022-03-11
1,0,1,0,Stanly,2022-03-12
0,0,0,0,Stanly,2022-03-13
1,0,1,0,Stanly,2022-03-14
2,0,2,0,Stanly,2022-03-17
2,0,2,0,Stanly,2022-03-18
1,0,1,0,Stanly,2022-03-19
1,0,1,0,Stanly,2022-03-20
1,0,1,0,Stanly,2022-03-21
1,0,1,0,Stanly,2022-03-22
2,0,2,0,Stanly,2022-03-25
0,0,0,0,Stanly,2022-03-26
3,1,2,0,Stanly,2022-03-27
0,0,0,0,Stanly,2022-03-28
1,0,1,0,Stanly,2022-03-31
0,0,0,0,Stanly,2022-04-01
0,0,0,0,Stanly,2022-04-02
1,0,1,0,Stanly,2022-04-03
0,0,0,0,Stanly,2022-04-04
2,0,2,0,Stanly,2022-04-05
1,0,1,0,Stanly,2022-04-06
2,0,2,0,Stanly,2022-04-07
0,0,0,0,Stanly,2022-04-08
1,0,1,0,Stanly,2022-04-09
1,0,1,0,Stanly,2022-04-10
0,0,0,0,Stanly,2022-04-11
1,0,1,0,Stanly,2022-04-12
2,0,2,0,Stanly,2022-04-13
4,1,3,0,Stanly,2022-04-14
0,0,0,0,Stanly,2022-04-15
3,0,3,0,Stanly,2022-04-16
0,0,0,0,Stanly,2022-04-17
4,0,4,0,Stanly,2022-04-18
4,0,4,0,Stanly,2022-04-19
3,0,3,0,Stanly,2022-04-20
2,0,2,0,Stanly,2022-04-21
2,0,2,0,Stanly,2022-04-22
0,0,0,0,Stanly,2022-04-23
2,1,1,0,Stanly,2022-04-24
4,0,4,0,Stanly,2022-04-25
2,0,2,0,Stanly,2022-04-26
8,0,8,0,Stanly,2022-04-27
2,0,2,0,Stanly,2022-04-28
4,1,3,0,Stanly,2022-04-29
2,1,1,0,Stanly,2022-04-30
1,0,1,0,Stanly,2022-05-01
11,4,7,0,Stanly,2022-05-02
6,0,6,0,Stanly,2022-05-03
8,0,8,0,Stanly,2022-05-04
5,1,4,0,Stanly,2022-05-05
2,0,2,0,Stanly,2022-05-06
2,0,2,0,Stanly,2022-05-07
3,2,1,0,Stanly,2022-05-08
10,1,9,0,Stanly,2022-05-09
6,1,5,0,Stanly,2022-05-10
17,2,15,0,Stanly,2022-05-12
17,7,10,0,Stanly,2022-05-13
12,2,10,0,Stanly,2022-05-14
10,5,5,0,Stanly,2022-05-15
16,0,16,0,Stanly,2022-05-17
25,4,21,0,Stanly,2022-05-18
16,3,13,0,Stanly,2022-05-19
22,2,20,0,Stanly,2022-05-20
4,0,4,0,Stanly,2022-05-21
11,0,11,0,Stanly,2022-05-22
37,8,29,0,Stanly,2022-05-23
32,2,30,0,Stanly,2022-05-24
21,6,15,0,Stanly,2022-05-25
15,4,11,0,Stanly,2022-05-26
24,3,21,0,Stanly,2022-05-27
12,0,12,0,Stanly,2022-05-28
12,0,12,0,Stanly,2022-05-29
10,4,6,0,Stanly,2022-05-30
25,2,23,0,Stanly,2022-05-31
15,2,13,0,Stanly,2022-06-01
19,4,15,0,Stanly,2022-06-02
19,2,17,0,Stanly,2022-06-03
12,0,12,0,Stanly,2022-06-04
34,4,30,0,Stokes,2021-12-07
36,11,25,0,Stokes,2021-12-08
24,3,21,0,Stokes,2021-12-10
8,2,6,0,Stokes,2021-12-11
11,1,10,0,Stokes,2021-12-12
41,7,34,0,Stokes,2021-12-14
35,8,27,0,Stokes,2021-12-15
34,11,23,0,Stokes,2021-12-16
35,4,31,0,Stokes,2021-12-17
43,11,32,0,Stokes,2021-12-20
40,5,35,0,Stokes,2021-12-21
24,1,23,0,Stokes,2021-12-23
15,2,13,0,Stokes,2021-12-24
3,0,3,0,Stokes,2021-12-25
9,1,8,0,Stokes,2021-12-26
70,16,54,0,Stokes,2021-12-27
91,13,78,0,Stokes,2021-12-29
74,12,62,0,Stokes,2021-12-30
65,30,35,0,Stokes,2021-12-31
13,6,7,0,Stokes,2022-01-01
28,8,20,0,Stokes,2022-01-02
112,37,75,0,Stokes,2022-01-03
91,20,71,0,Stokes,2022-01-07
33,8,25,0,Stokes,2022-01-09
187,31,156,0,Stokes,2022-01-11
140,33,107,0,Stokes,2022-01-13
138,21,117,0,Stokes,2022-01-19
33,7,26,0,Stokes,2022-01-23
80,12,68,0,Stokes,2022-01-27
90,16,74,0,Stokes,2022-01-31
45,9,36,0,Stokes,2022-02-01
46,6,40,0,Stokes,2022-02-02
17,1,16,0,Stokes,2022-02-05
15,3,12,0,Stokes,2022-02-06
29,5,24,0,Stokes,2022-02-08
32,4,28,0,Stokes,2022-02-09
13,2,11,0,Stokes,2022-02-13
30,7,23,0,Stokes,2022-02-14
5,1,4,0,Stokes,2022-02-19
6,3,3,0,Stokes,2022-02-20
8,3,5,0,Stokes,2022-02-23
8,1,7,0,Stokes,2022-02-25
3,0,3,0,Stokes,2022-02-26
2,0,2,0,Stokes,2022-02-27
7,1,6,0,Stokes,2022-02-28
2,0,2,0,Stokes,2022-03-02
4,1,3,0,Stokes,2022-03-04
2,0,2,0,Stokes,2022-03-06
5,0,5,0,Stokes,2022-03-07
5,0,5,0,Stokes,2022-03-08
3,1,2,0,Stokes,2022-03-09
2,2,0,0,Stokes,2022-03-10
2,0,2,0,Stokes,2022-03-12
0,0,0,0,Stokes,2022-03-13
3,0,3,0,Stokes,2022-03-14
1,0,1,0,Stokes,2022-03-15
0,0,0,0,Stokes,2022-03-16
0,0,0,0,Stokes,2022-03-17
0,0,0,0,Stokes,2022-03-18
1,0,1,0,Stokes,2022-03-19
0,0,0,0,Stokes,2022-03-20
3,2,1,0,Stokes,2022-03-21
0,0,0,0,Stokes,2022-03-22
2,1,1,0,Stokes,2022-03-23
0,0,0,0,Stokes,2022-03-24
0,0,0,0,Stokes,2022-03-25
4,4,0,0,Stokes,2022-03-26
1,0,1,0,Stokes,2022-03-27
3,1,2,0,Stokes,2022-03-28
2,2,0,0,Stokes,2022-03-29
4,0,4,0,Stokes,2022-03-30
3,3,0,0,Stokes,2022-03-31
1,1,0,0,Stokes,2022-04-01
0,0,0,0,Stokes,2022-04-03
5,2,3,0,Stokes,2022-04-04
1,1,0,0,Stokes,2022-04-05
3,0,3,0,Stokes,2022-04-06
0,0,0,0,Stokes,2022-04-07
2,0,2,0,Stokes,2022-04-08
1,1,0,0,Stokes,2022-04-09
2,0,2,0,Stokes,2022-04-11
0,0,0,0,Stokes,2022-04-12
3,1,2,0,Stokes,2022-04-13
2,0,2,0,Stokes,2022-04-14
1,0,1,0,Stokes,2022-04-15
0,0,0,0,Stokes,2022-04-16
0,0,0,0,Stokes,2022-04-17
1,0,1,0,Stokes,2022-04-18
1,0,1,0,Stokes,2022-04-19
4,3,1,0,Stokes,2022-04-20
4,0,4,0,Stokes,2022-04-21
3,1,2,0,Stokes,2022-04-22
2,1,1,0,Stokes,2022-04-23
3,0,3,0,Stokes,2022-04-24
4,1,3,0,Stokes,2022-04-25
6,1,5,0,Stokes,2022-04-26
4,1,3,0,Stokes,2022-04-27
5,1,4,0,Stokes,2022-04-28
5,2,3,0,Stokes,2022-04-29
4,1,3,0,Stokes,2022-04-30
10,2,8,0,Stokes,2022-05-02
4,0,4,0,Stokes,2022-05-03
8,0,8,0,Stokes,2022-05-04
17,6,11,0,Stokes,2022-05-05
8,2,6,0,Stokes,2022-05-06
6,1,5,0,Stokes,2022-05-07
6,4,2,0,Stokes,2022-05-08
23,8,15,0,Stokes,2022-05-09
16,4,12,0,Stokes,2022-05-10
17,5,12,0,Stokes,2022-05-11
11,3,8,0,Stokes,2022-05-12
12,4,8,0,Stokes,2022-05-13
10,2,8,0,Stokes,2022-05-14
8,2,6,0,Stokes,2022-05-15
21,6,15,0,Stokes,2022-05-16
20,5,15,0,Stokes,2022-05-17
25,4,21,0,Stokes,2022-05-18
19,4,15,0,Stokes,2022-05-19
14,1,13,0,Stokes,2022-05-20
14,2,12,0,Stokes,2022-05-21
5,2,3,0,Stokes,2022-05-22
26,8,18,0,Stokes,2022-05-23
18,5,13,0,Stokes,2022-05-24
11,3,8,0,Stokes,2022-05-25
13,2,11,0,Stokes,2022-05-26
17,2,15,0,Stokes,2022-05-27
7,1,6,0,Stokes,2022-05-28
6,3,3,0,Stokes,2022-05-29
4,2,2,0,Stokes,2022-05-30
17,2,15,0,Stokes,2022-05-31
17,5,12,0,Stokes,2022-06-01
13,4,9,0,Stokes,2022-06-02
8,3,5,0,Stokes,2022-06-03
9,1,8,0,Stokes,2022-06-04
53,25,28,0,Surry,2021-12-09
20,5,15,0,Surry,2021-12-18
61,21,40,0,Surry,2021-12-23
47,23,24,0,Surry,2021-12-24
8,5,3,0,Surry,2021-12-25
57,18,39,0,Surry,2021-12-26
118,42,76,0,Surry,2021-12-27
126,42,84,0,Surry,2021-12-29
69,30,39,0,Surry,2021-12-31
180,78,102,0,Surry,2022-01-03
154,49,105,0,Surry,2022-01-04
194,88,106,0,Surry,2022-01-05
154,58,96,0,Surry,2022-01-07
292,105,187,0,Surry,2022-01-11
219,75,144,0,Surry,2022-01-20
233,86,147,0,Surry,2022-01-24
149,51,98,0,Surry,2022-01-31
142,81,61,0,Surry,2022-02-02
80,27,53,0,Surry,2022-02-03
72,36,36,0,Surry,2022-02-07
62,20,42,0,Surry,2022-02-09
64,29,35,0,Surry,2022-02-10
15,1,14,0,Surry,2022-02-13
58,27,31,0,Surry,2022-02-14
37,10,27,0,Surry,2022-02-16
20,10,10,0,Surry,2022-02-19
30,12,18,0,Surry,2022-02-21
21,7,14,0,Surry,2022-02-23
20,5,15,0,Surry,2022-02-24
13,4,9,0,Surry,2022-02-25
7,3,4,0,Surry,2022-02-26
4,2,2,0,Surry,2022-02-27
16,6,10,0,Surry,2022-02-28
9,3,6,0,Surry,2022-03-01
6,2,4,0,Surry,2022-03-04
3,1,2,0,Surry,2022-03-05
2,1,1,0,Surry,2022-03-06
6,3,3,0,Surry,2022-03-07
5,2,3,0,Surry,2022-03-08
10,2,8,0,Surry,2022-03-09
4,2,2,0,Surry,2022-03-10
6,2,4,0,Surry,2022-03-12
2,1,1,0,Surry,2022-03-13
1,0,1,0,Surry,2022-03-15
2,0,2,0,Surry,2022-03-16
2,0,2,0,Surry,2022-03-17
2,1,1,0,Surry,2022-03-18
4,0,4,0,Surry,2022-03-21
1,1,0,0,Surry,2022-03-23
2,0,2,0,Surry,2022-03-24
0,0,0,0,Surry,2022-03-25
1,1,0,0,Surry,2022-03-26
2,1,1,0,Surry,2022-03-27
1,0,1,0,Surry,2022-03-28
1,0,1,0,Surry,2022-03-29
1,0,1,0,Surry,2022-03-30
1,0,1,0,Surry,2022-03-31
0,0,0,0,Surry,2022-04-01
1,1,0,0,Surry,2022-04-02
1,0,1,0,Surry,2022-04-03
4,1,3,0,Surry,2022-04-04
4,2,2,0,Surry,2022-04-05
3,1,2,0,Surry,2022-04-06
1,0,1,0,Surry,2022-04-08
4,1,3,0,Surry,2022-04-09
1,0,1,0,Surry,2022-04-10
4,0,4,0,Surry,2022-04-11
2,1,1,0,Surry,2022-04-12
4,0,4,0,Surry,2022-04-13
2,0,2,0,Surry,2022-04-14
1,1,0,0,Surry,2022-04-15
3,1,2,0,Surry,2022-04-16
3,1,2,0,Surry,2022-04-17
7,1,6,0,Surry,2022-04-18
7,0,7,0,Surry,2022-04-19
4,2,2,0,Surry,2022-04-20
11,3,8,0,Surry,2022-04-21
5,0,5,0,Surry,2022-04-22
1,1,0,0,Surry,2022-04-24
11,4,7,0,Surry,2022-04-25
12,4,8,0,Surry,2022-04-26
9,3,6,0,Surry,2022-04-27
9,4,5,0,Surry,2022-04-28
2,0,2,0,Surry,2022-04-29
2,0,2,0,Surry,2022-04-30
7,5,2,0,Surry,2022-05-01
16,6,10,0,Surry,2022-05-02
16,4,12,0,Surry,2022-05-03
9,3,6,0,Surry,2022-05-04
7,2,5,0,Surry,2022-05-05
9,3,6,0,Surry,2022-05-06
8,4,4,0,Surry,2022-05-07
7,3,4,0,Surry,2022-05-08
25,10,15,0,Surry,2022-05-09
17,4,13,0,Surry,2022-05-10
16,9,7,0,Surry,2022-05-11
18,10,8,0,Surry,2022-05-12
13,1,12,0,Surry,2022-05-13
4,0,4,0,Surry,2022-05-14
18,5,13,0,Surry,2022-05-15
17,5,12,0,Surry,2022-05-16
34,11,23,0,Surry,2022-05-17
14,4,10,0,Surry,2022-05-18
30,11,19,0,Surry,2022-05-19
22,9,13,0,Surry,2022-05-20
10,1,9,0,Surry,2022-05-21
17,4,13,0,Surry,2022-05-22
36,15,21,0,Surry,2022-05-23
17,6,11,0,Surry,2022-05-25
20,3,17,0,Surry,2022-05-26
15,4,11,0,Surry,2022-05-27
18,3,15,0,Surry,2022-05-28
11,3,8,0,Surry,2022-05-29
17,4,13,0,Surry,2022-05-30
40,12,28,0,Surry,2022-05-31
37,9,28,0,Surry,2022-06-01
22,10,12,0,Surry,2022-06-02
15,3,12,0,Surry,2022-06-03
17,8,9,0,Surry,2022-06-04
8,5,3,0,Swain,2021-12-08
9,2,7,0,Swain,2021-12-09
7,0,7,0,Swain,2021-12-10
4,0,4,0,Swain,2021-12-12
8,4,4,0,Swain,2021-12-13
7,3,4,0,Swain,2021-12-16
4,3,1,0,Swain,2021-12-17
1,1,0,0,Swain,2021-12-18
1,1,0,0,Swain,2021-12-19
4,2,2,0,Swain,2021-12-20
6,2,4,0,Swain,2021-12-22
5,5,0,0,Swain,2021-12-23
4,2,2,0,Swain,2021-12-24
5,4,1,0,Swain,2021-12-25
7,3,4,0,Swain,2021-12-26
28,15,13,0,Swain,2021-12-28
24,14,10,0,Swain,2021-12-29
32,29,3,0,Swain,2021-12-30
24,16,8,0,Swain,2021-12-31
22,13,9,0,Swain,2022-01-02
45,16,29,0,Swain,2022-01-03
60,23,37,0,Swain,2022-01-04
42,15,27,0,Swain,2022-01-07
20,12,8,0,Swain,2022-01-09
47,24,23,0,Swain,2022-01-10
43,9,34,0,Swain,2022-01-11
39,15,24,0,Swain,2022-01-13
14,10,4,0,Swain,2022-01-17
40,27,13,0,Swain,2022-01-18
44,23,21,0,Swain,2022-01-21
15,8,7,0,Swain,2022-01-22
19,10,9,0,Swain,2022-01-23
46,23,23,0,Swain,2022-01-24
38,15,23,0,Swain,2022-01-25
30,16,14,0,Swain,2022-01-26
28,16,12,0,Swain,2022-01-27
11,8,3,0,Swain,2022-01-29
34,21,13,0,Swain,2022-01-31
30,10,20,0,Swain,2022-02-01
24,10,14,0,Swain,2022-02-02
14,13,1,0,Swain,2022-02-03
12,3,9,0,Swain,2022-02-04
4,3,1,0,Swain,2022-02-05
12,5,7,0,Swain,2022-02-07
16,7,9,0,Swain,2022-02-08
6,2,4,0,Swain,2022-02-10
13,7,6,0,Swain,2022-02-11
3,3,0,0,Swain,2022-02-12
2,2,0,0,Swain,2022-02-13
9,8,1,0,Swain,2022-02-15
5,3,2,0,Swain,2022-02-16
17,15,2,0,Swain,2022-02-17
6,4,2,0,Swain,2022-02-18
7,4,3,0,Swain,2022-02-19
5,5,0,0,Swain,2022-02-20
10,6,4,0,Swain,2022-02-21
12,5,7,0,Swain,2022-02-22
3,3,0,0,Swain,2022-02-23
7,2,5,0,Swain,2022-02-24
6,3,3,0,Swain,2022-02-25
1,1,0,0,Swain,2022-02-26
2,2,0,0,Swain,2022-02-27
4,3,1,0,Swain,2022-02-28
2,0,2,0,Swain,2022-03-01
4,3,1,0,Swain,2022-03-02
3,0,3,0,Swain,2022-03-03
1,0,1,0,Swain,2022-03-04
2,0,2,0,Swain,2022-03-05
2,0,2,0,Swain,2022-03-06
0,0,0,0,Swain,2022-03-09
3,3,0,0,Swain,2022-03-10
1,1,0,0,Swain,2022-03-11
1,1,0,0,Swain,2022-03-12
1,0,1,0,Swain,2022-03-13
0,0,0,0,Swain,2022-03-14
1,1,0,0,Swain,2022-03-15
0,0,0,0,Swain,2022-03-16
1,1,0,0,Swain,2022-03-17
0,0,0,0,Swain,2022-03-18
0,0,0,0,Swain,2022-03-19
0,0,0,0,Swain,2022-03-20
0,0,0,0,Swain,2022-03-21
1,0,1,0,Swain,2022-03-22
1,0,1,0,Swain,2022-03-23
2,1,1,0,Swain,2022-03-24
0,0,0,0,Swain,2022-03-25
0,0,0,0,Swain,2022-03-26
1,1,0,0,Swain,2022-03-27
0,0,0,0,Swain,2022-03-28
3,1,2,0,Swain,2022-03-29
2,2,0,0,Swain,2022-03-30
1,1,0,0,Swain,2022-03-31
0,0,0,0,Swain,2022-04-01
1,1,0,0,Swain,2022-04-02
0,0,0,0,Swain,2022-04-03
0,0,0,0,Swain,2022-04-04
0,0,0,0,Swain,2022-04-05
1,1,0,0,Swain,2022-04-06
2,0,2,0,Swain,2022-04-07
0,0,0,0,Swain,2022-04-08
2,2,0,0,Swain,2022-04-09
0,0,0,0,Swain,2022-04-10
0,0,0,0,Swain,2022-04-11
2,1,1,0,Swain,2022-04-12
0,0,0,0,Swain,2022-04-13
3,1,2,0,Swain,2022-04-14
1,0,1,0,Swain,2022-04-15
0,0,0,0,Swain,2022-04-16
0,0,0,0,Swain,2022-04-17
1,1,0,0,Swain,2022-04-18
2,2,0,0,Swain,2022-04-19
1,1,0,0,Swain,2022-04-20
1,0,1,0,Swain,2022-04-21
4,2,2,0,Swain,2022-04-22
3,2,1,0,Swain,2022-04-24
2,1,1,0,Swain,2022-04-25
2,1,1,0,Swain,2022-04-26
4,0,4,0,Swain,2022-04-27
1,0,1,0,Swain,2022-04-28
2,1,1,0,Swain,2022-04-29
2,2,0,0,Swain,2022-04-30
2,1,1,0,Swain,2022-05-01
3,3,0,0,Swain,2022-05-02
2,0,2,0,Swain,2022-05-03
4,3,1,0,Swain,2022-05-04
3,2,1,0,Swain,2022-05-05
4,4,0,0,Swain,2022-05-06
2,0,2,0,Swain,2022-05-07
2,1,1,0,Swain,2022-05-08
3,1,2,0,Swain,2022-05-09
6,4,2,0,Swain,2022-05-10
5,2,3,0,Swain,2022-05-11
2,1,1,0,Swain,2022-05-12
1,1,0,0,Swain,2022-05-13
3,0,3,0,Swain,2022-05-14
3,1,2,0,Swain,2022-05-15
3,2,1,0,Swain,2022-05-16
2,2,0,0,Swain,2022-05-17
6,4,2,0,Swain,2022-05-18
10,2,8,0,Swain,2022-05-19
1,0,1,0,Swain,2022-05-21
4,0,4,0,Swain,2022-05-22
4,2,2,0,Swain,2022-05-23
5,1,4,0,Swain,2022-05-24
4,0,4,0,Swain,2022-05-25
2,0,2,0,Swain,2022-05-26
10,3,7,0,Swain,2022-05-27
2,1,1,0,Swain,2022-05-28
3,0,3,0,Swain,2022-05-29
1,1,0,0,Swain,2022-05-30
10,0,10,0,Swain,2022-05-31
2,2,0,0,Swain,2022-06-01
7,2,5,0,Swain,2022-06-02
10,3,7,0,Swain,2022-06-03
6,2,4,0,Swain,2022-06-04
6,2,4,0,Transylvania,2021-12-07
8,6,2,0,Transylvania,2021-12-09
16,12,4,0,Transylvania,2021-12-12
29,18,11,0,Transylvania,2021-12-13
24,13,11,0,Transylvania,2021-12-15
22,12,10,0,Transylvania,2021-12-16
9,5,4,0,Transylvania,2021-12-18
28,16,12,0,Transylvania,2021-12-20
32,18,14,0,Transylvania,2021-12-22
28,18,10,0,Transylvania,2021-12-23
11,7,4,0,Transylvania,2021-12-24
5,2,3,0,Transylvania,2021-12-25
18,15,3,0,Transylvania,2021-12-26
51,22,29,0,Transylvania,2021-12-29
30,16,14,0,Transylvania,2021-12-31
14,9,5,0,Transylvania,2022-01-01
53,25,28,0,Transylvania,2022-01-03
60,24,36,0,Transylvania,2022-01-04
56,25,31,0,Transylvania,2022-01-05
23,14,9,0,Transylvania,2022-01-08
22,14,8,0,Transylvania,2022-01-09
83,32,51,0,Transylvania,2022-01-10
69,34,35,0,Transylvania,2022-01-11
70,33,37,0,Transylvania,2022-01-14
7,6,1,0,Transylvania,2022-01-16
84,32,52,0,Transylvania,2022-01-20
48,18,30,0,Transylvania,2022-01-21
22,14,8,0,Transylvania,2022-01-23
41,15,26,0,Transylvania,2022-01-24
23,4,19,0,Transylvania,2022-01-25
43,15,28,0,Transylvania,2022-01-26
31,12,19,0,Transylvania,2022-01-27
24,6,18,0,Transylvania,2022-01-28
12,5,7,0,Transylvania,2022-01-29
14,4,10,0,Transylvania,2022-01-30
35,15,20,0,Transylvania,2022-01-31
32,9,23,0,Transylvania,2022-02-01
28,17,11,0,Transylvania,2022-02-02
13,8,5,0,Transylvania,2022-02-03
14,5,9,0,Transylvania,2022-02-05
17,7,10,0,Transylvania,2022-02-06
14,5,9,0,Transylvania,2022-02-10
11,6,5,0,Transylvania,2022-02-11
7,5,2,0,Transylvania,2022-02-12
5,5,0,0,Transylvania,2022-02-13
17,11,6,0,Transylvania,2022-02-14
11,5,6,0,Transylvania,2022-02-15
12,4,8,0,Transylvania,2022-02-16
5,3,2,0,Transylvania,2022-02-18
0,0,0,0,Transylvania,2022-02-19
3,2,1,0,Transylvania,2022-02-20
1,1,0,0,Transylvania,2022-02-21
5,3,2,0,Transylvania,2022-02-22
6,0,6,0,Transylvania,2022-02-24
1,1,0,0,Transylvania,2022-02-25
1,1,0,0,Transylvania,2022-02-26
1,1,0,0,Transylvania,2022-02-28
3,1,2,0,Transylvania,2022-03-01
0,0,0,0,Transylvania,2022-03-04
1,1,0,0,Transylvania,2022-03-05
1,1,0,0,Transylvania,2022-03-06
3,2,1,0,Transylvania,2022-03-07
2,2,0,0,Transylvania,2022-03-08
0,0,0,0,Transylvania,2022-03-09
0,0,0,0,Transylvania,2022-03-10
0,0,0,0,Transylvania,2022-03-11
0,0,0,0,Transylvania,2022-03-12
0,0,0,0,Transylvania,2022-03-13
4,1,3,0,Transylvania,2022-03-14
0,0,0,0,Transylvania,2022-03-15
1,1,0,0,Transylvania,2022-03-16
0,0,0,0,Transylvania,2022-03-17
1,1,0,0,Transylvania,2022-03-18
0,0,0,0,Transylvania,2022-03-19
0,0,0,0,Transylvania,2022-03-20
1,1,0,0,Transylvania,2022-03-22
1,0,1,0,Transylvania,2022-03-23
0,0,0,0,Transylvania,2022-03-24
0,0,0,0,Transylvania,2022-03-25
0,0,0,0,Transylvania,2022-03-26
0,0,0,0,Transylvania,2022-03-27
1,0,1,0,Transylvania,2022-03-28
0,0,0,0,Transylvania,2022-03-29
3,2,1,0,Transylvania,2022-03-30
0,0,0,0,Transylvania,2022-03-31
1,0,1,0,Transylvania,2022-04-01
0,0,0,0,Transylvania,2022-04-02
0,0,0,0,Transylvania,2022-04-03
1,0,1,0,Transylvania,2022-04-04
0,0,0,0,Transylvania,2022-04-05
5,2,3,0,Transylvania,2022-04-06
2,2,0,0,Transylvania,2022-04-07
2,1,1,0,Transylvania,2022-04-08
2,1,1,0,Transylvania,2022-04-09
0,0,0,0,Transylvania,2022-04-10
4,4,0,0,Transylvania,2022-04-11
2,0,2,0,Transylvania,2022-04-12
0,0,0,0,Transylvania,2022-04-13
0,0,0,0,Transylvania,2022-04-14
0,0,0,0,Transylvania,2022-04-15
1,0,1,0,Transylvania,2022-04-16
0,0,0,0,Transylvania,2022-04-17
3,1,2,0,Transylvania,2022-04-18
5,2,3,0,Transylvania,2022-04-19
3,1,2,0,Transylvania,2022-04-20
2,2,0,0,Transylvania,2022-04-21
1,0,1,0,Transylvania,2022-04-22
2,1,1,0,Transylvania,2022-04-23
2,1,1,0,Transylvania,2022-04-24
1,0,1,0,Transylvania,2022-04-25
8,5,3,0,Transylvania,2022-04-26
3,1,2,0,Transylvania,2022-04-27
0,0,0,0,Transylvania,2022-04-28
1,1,0,0,Transylvania,2022-04-29
2,1,1,0,Transylvania,2022-04-30
5,2,3,0,Transylvania,2022-05-01
3,2,1,0,Transylvania,2022-05-03
1,1,0,0,Transylvania,2022-05-04
4,1,3,0,Transylvania,2022-05-05
4,3,1,0,Transylvania,2022-05-06
3,3,0,0,Transylvania,2022-05-07
3,0,3,0,Transylvania,2022-05-08
2,1,1,0,Transylvania,2022-05-09
7,3,4,0,Transylvania,2022-05-10
5,2,3,0,Transylvania,2022-05-11
11,7,4,0,Transylvania,2022-05-12
6,3,3,0,Transylvania,2022-05-13
5,2,3,0,Transylvania,2022-05-14
3,2,1,0,Transylvania,2022-05-15
9,5,4,0,Transylvania,2022-05-16
9,6,3,0,Transylvania,2022-05-17
2,2,0,0,Transylvania,2022-05-18
12,2,10,0,Transylvania,2022-05-19
7,3,4,0,Transylvania,2022-05-20
6,3,3,0,Transylvania,2022-05-21
6,3,3,0,Transylvania,2022-05-22
10,1,9,0,Transylvania,2022-05-23
5,2,3,0,Transylvania,2022-05-24
6,1,5,0,Transylvania,2022-05-25
8,4,4,0,Transylvania,2022-05-26
6,2,4,0,Transylvania,2022-05-27
9,3,6,0,Transylvania,2022-05-28
8,4,4,0,Transylvania,2022-05-29
5,3,2,0,Transylvania,2022-05-30
10,1,9,0,Transylvania,2022-05-31
7,3,4,0,Transylvania,2022-06-01
11,7,4,0,Transylvania,2022-06-02
10,9,1,0,Transylvania,2022-06-03
1,0,1,0,Transylvania,2022-06-04
2,0,2,0,Tyrrell,2021-12-07
0,0,0,0,Tyrrell,2021-12-08
1,0,1,0,Tyrrell,2021-12-09
1,0,1,0,Tyrrell,2021-12-10
0,0,0,0,Tyrrell,2021-12-11
0,0,0,0,Tyrrell,2021-12-12
1,0,1,0,Tyrrell,2021-12-14
1,0,1,0,Tyrrell,2021-12-16
0,0,0,0,Tyrrell,2021-12-17
0,0,0,0,Tyrrell,2021-12-18
1,1,0,0,Tyrrell,2021-12-19
2,0,2,0,Tyrrell,2021-12-20
2,0,2,0,Tyrrell,2021-12-21
2,1,1,0,Tyrrell,2021-12-22
1,0,1,0,Tyrrell,2021-12-23
0,0,0,0,Tyrrell,2021-12-24
0,0,0,0,Tyrrell,2021-12-25
1,0,1,0,Tyrrell,2021-12-26
2,0,2,0,Tyrrell,2021-12-27
5,1,4,0,Tyrrell,2021-12-28
4,0,4,0,Tyrrell,2021-12-29
7,0,7,0,Tyrrell,2021-12-30
2,0,2,0,Tyrrell,2021-12-31
0,0,0,0,Tyrrell,2022-01-01
0,0,0,0,Tyrrell,2022-01-02
8,4,4,0,Tyrrell,2022-01-03
11,4,7,0,Tyrrell,2022-01-04
4,0,4,0,Tyrrell,2022-01-05
5,0,5,0,Tyrrell,2022-01-07
9,0,9,0,Tyrrell,2022-01-08
1,0,1,0,Tyrrell,2022-01-09
11,4,7,0,Tyrrell,2022-01-10
30,6,24,0,Tyrrell,2022-01-11
24,8,16,0,Tyrrell,2022-01-12
23,7,16,0,Tyrrell,2022-01-13
16,0,16,0,Tyrrell,2022-01-14
1,0,1,0,Tyrrell,2022-01-15
4,0,4,0,Tyrrell,2022-01-16
9,0,9,0,Tyrrell,2022-01-17
28,4,24,0,Tyrrell,2022-01-18
23,3,20,0,Tyrrell,2022-01-19
1,0,1,0,Tyrrell,2022-01-21
0,0,0,0,Tyrrell,2022-01-22
2,0,2,0,Tyrrell,2022-01-23
13,3,10,0,Tyrrell,2022-01-24
12,1,11,0,Tyrrell,2022-01-25
8,2,6,0,Tyrrell,2022-01-26
3,1,2,0,Tyrrell,2022-01-27
5,1,4,0,Tyrrell,2022-01-28
3,0,3,0,Tyrrell,2022-01-29
1,0,1,0,Tyrrell,2022-01-30
3,0,3,0,Tyrrell,2022-01-31
6,0,6,0,Tyrrell,2022-02-01
5,3,2,0,Tyrrell,2022-02-02
5,4,1,0,Tyrrell,2022-02-03
3,0,3,0,Tyrrell,2022-02-04
0,0,0,0,Tyrrell,2022-02-05
0,0,0,0,Tyrrell,2022-02-06
4,1,3,0,Tyrrell,2022-02-07
4,0,4,0,Tyrrell,2022-02-08
2,1,1,0,Tyrrell,2022-02-10
8,0,8,0,Tyrrell,2022-02-11
4,0,4,0,Tyrrell,2022-02-12
0,0,0,0,Tyrrell,2022-02-13
3,1,2,0,Tyrrell,2022-02-14
2,1,1,0,Tyrrell,2022-02-15
2,0,2,0,Tyrrell,2022-02-16
0,0,0,0,Tyrrell,2022-02-17
2,0,2,0,Tyrrell,2022-02-18
0,0,0,0,Tyrrell,2022-02-19
0,0,0,0,Tyrrell,2022-02-20
0,0,0,0,Tyrrell,2022-02-21
1,0,1,0,Tyrrell,2022-02-22
0,0,0,0,Tyrrell,2022-02-23
0,0,0,0,Tyrrell,2022-02-24
0,0,0,0,Tyrrell,2022-02-25
0,0,0,0,Tyrrell,2022-02-26
0,0,0,0,Tyrrell,2022-02-27
0,0,0,0,Tyrrell,2022-02-28
3,0,3,0,Tyrrell,2022-03-01
2,0,2,0,Tyrrell,2022-03-02
3,1,2,0,Tyrrell,2022-03-03
0,0,0,0,Tyrrell,2022-03-04
0,0,0,0,Tyrrell,2022-03-05
0,0,0,0,Tyrrell,2022-03-06
0,0,0,0,Tyrrell,2022-03-07
1,1,0,0,Tyrrell,2022-03-08
0,0,0,0,Tyrrell,2022-03-09
0,0,0,0,Tyrrell,2022-03-10
1,0,1,0,Tyrrell,2022-03-11
0,0,0,0,Tyrrell,2022-03-12
0,0,0,0,Tyrrell,2022-03-13
0,0,0,0,Tyrrell,2022-03-14
0,0,0,0,Tyrrell,2022-03-15
0,0,0,0,Tyrrell,2022-03-16
0,0,0,0,Tyrrell,2022-03-17
0,0,0,0,Tyrrell,2022-03-18
0,0,0,0,Tyrrell,2022-03-19
0,0,0,0,Tyrrell,2022-03-20
0,0,0,0,Tyrrell,2022-03-21
0,0,0,0,Tyrrell,2022-03-22
0,0,0,0,Tyrrell,2022-03-23
0,0,0,0,Tyrrell,2022-03-24
0,0,0,0,Tyrrell,2022-03-25
0,0,0,0,Tyrrell,2022-03-26
0,0,0,0,Tyrrell,2022-03-27
0,0,0,0,Tyrrell,2022-03-28
0,0,0,0,Tyrrell,2022-03-29
0,0,0,0,Tyrrell,2022-03-30
0,0,0,0,Tyrrell,2022-03-31
0,0,0,0,Tyrrell,2022-04-01
0,0,0,0,Tyrrell,2022-04-02
0,0,0,0,Tyrrell,2022-04-03
0,0,0,0,Tyrrell,2022-04-04
0,0,0,0,Tyrrell,2022-04-05
0,0,0,0,Tyrrell,2022-04-06
0,0,0,0,Tyrrell,2022-04-07
0,0,0,0,Tyrrell,2022-04-08
0,0,0,0,Tyrrell,2022-04-09
0,0,0,0,Tyrrell,2022-04-10
0,0,0,0,Tyrrell,2022-04-11
2,0,2,0,Tyrrell,2022-04-12
0,0,0,0,Tyrrell,2022-04-13
0,0,0,0,Tyrrell,2022-04-14
0,0,0,0,Tyrrell,2022-04-15
0,0,0,0,Tyrrell,2022-04-16
0,0,0,0,Tyrrell,2022-04-17
0,0,0,0,Tyrrell,2022-04-18
0,0,0,0,Tyrrell,2022-04-19
0,0,0,0,Tyrrell,2022-04-20
0,0,0,0,Tyrrell,2022-04-21
0,0,0,0,Tyrrell,2022-04-22
0,0,0,0,Tyrrell,2022-04-23
0,0,0,0,Tyrrell,2022-04-24
1,0,1,0,Tyrrell,2022-04-25
0,0,0,0,Tyrrell,2022-04-26
1,1,0,0,Tyrrell,2022-04-27
0,0,0,0,Tyrrell,2022-04-28
1,0,1,0,Tyrrell,2022-04-29
1,0,1,0,Tyrrell,2022-04-30
0,0,0,0,Tyrrell,2022-05-01
0,0,0,0,Tyrrell,2022-05-02
0,0,0,0,Tyrrell,2022-05-03
0,0,0,0,Tyrrell,2022-05-04
0,0,0,0,Tyrrell,2022-05-05
0,0,0,0,Tyrrell,2022-05-06
0,0,0,0,Tyrrell,2022-05-07
0,0,0,0,Tyrrell,2022-05-08
2,1,1,0,Tyrrell,2022-05-09
1,0,1,0,Tyrrell,2022-05-10
1,1,0,0,Tyrrell,2022-05-11
4,2,2,0,Tyrrell,2022-05-12
0,0,0,0,Tyrrell,2022-05-13
1,0,1,0,Tyrrell,2022-05-14
1,1,0,0,Tyrrell,2022-05-15
0,0,0,0,Tyrrell,2022-05-16
2,1,1,0,Tyrrell,2022-05-17
0,0,0,0,Tyrrell,2022-05-18
4,3,1,0,Tyrrell,2022-05-19
2,0,2,0,Tyrrell,2022-05-20
0,0,0,0,Tyrrell,2022-05-21
0,0,0,0,Tyrrell,2022-05-22
1,0,1,0,Tyrrell,2022-05-23
0,0,0,0,Tyrrell,2022-05-24
0,0,0,0,Tyrrell,2022-05-25
1,1,0,0,Tyrrell,2022-05-26
2,0,2,0,Tyrrell,2022-05-27
0,0,0,0,Tyrrell,2022-05-28
0,0,0,0,Tyrrell,2022-05-29
1,0,1,0,Tyrrell,2022-05-30
4,0,4,0,Tyrrell,2022-05-31
1,0,1,0,Tyrrell,2022-06-01
0,0,0,0,Tyrrell,2022-06-02
1,0,1,0,Tyrrell,2022-06-03
0,0,0,0,Tyrrell,2022-06-04
114,27,87,0,Union,2021-12-07
58,14,44,0,Union,2021-12-11
83,19,64,0,Union,2021-12-18
150,27,123,0,Union,2021-12-20
204,31,173,0,Union,2021-12-23
34,1,33,0,Union,2021-12-25
435,84,351,0,Union,2021-12-29
314,104,210,0,Union,2021-12-31
205,47,158,0,Union,2022-01-01
234,53,181,0,Union,2022-01-02
380,86,294,0,Union,2022-01-09
892,167,725,0,Union,2022-01-13
764,133,631,0,Union,2022-01-14
132,30,102,0,Union,2022-01-30
311,83,228,0,Union,2022-01-31
87,22,65,0,Union,2022-02-10
41,8,33,0,Union,2022-02-13
68,20,48,0,Union,2022-02-16
31,13,18,0,Union,2022-02-20
38,15,23,0,Union,2022-02-23
18,5,13,0,Union,2022-02-25
27,8,19,0,Union,2022-02-28
18,3,15,0,Union,2022-03-01
14,6,8,0,Union,2022-03-03
15,2,13,0,Union,2022-03-04
6,3,3,0,Union,2022-03-06
7,0,7,0,Union,2022-03-09
6,0,6,0,Union,2022-03-10
7,1,6,0,Union,2022-03-11
9,3,6,0,Union,2022-03-12
8,0,8,0,Union,2022-03-14
5,1,4,0,Union,2022-03-15
8,0,8,0,Union,2022-03-16
8,1,7,0,Union,2022-03-17
2,0,2,0,Union,2022-03-18
3,1,2,0,Union,2022-03-19
0,0,0,0,Union,2022-03-20
9,0,9,0,Union,2022-03-22
12,2,10,0,Union,2022-03-23
8,1,7,0,Union,2022-03-24
9,1,8,0,Union,2022-03-25
4,1,3,0,Union,2022-03-26
11,3,8,0,Union,2022-03-27
7,3,4,0,Union,2022-03-29
8,2,6,0,Union,2022-03-30
4,1,3,0,Union,2022-04-01
9,2,7,0,Union,2022-04-02
6,2,4,0,Union,2022-04-03
14,1,13,0,Union,2022-04-04
10,1,9,0,Union,2022-04-05
15,2,13,0,Union,2022-04-06
13,2,11,0,Union,2022-04-08
3,1,2,0,Union,2022-04-09
8,1,7,0,Union,2022-04-10
18,4,14,0,Union,2022-04-11
23,4,19,0,Union,2022-04-12
30,4,26,0,Union,2022-04-13
30,10,20,0,Union,2022-04-14
13,1,12,0,Union,2022-04-16
30,6,24,0,Union,2022-04-18
35,10,25,0,Union,2022-04-19
38,7,31,0,Union,2022-04-20
39,9,30,0,Union,2022-04-21
27,3,24,0,Union,2022-04-22
20,8,12,0,Union,2022-04-23
38,8,30,0,Union,2022-04-24
52,18,34,0,Union,2022-04-25
48,6,42,0,Union,2022-04-26
58,8,50,0,Union,2022-04-27
52,5,47,0,Union,2022-04-28
48,9,39,0,Union,2022-04-29
33,8,25,0,Union,2022-04-30
36,0,36,0,Union,2022-05-01
49,5,44,0,Union,2022-05-02
72,13,59,0,Union,2022-05-03
55,10,45,0,Union,2022-05-05
61,13,48,0,Union,2022-05-06
37,4,33,0,Union,2022-05-07
40,6,34,0,Union,2022-05-08
85,12,73,0,Union,2022-05-09
98,17,81,0,Union,2022-05-10
63,12,51,0,Union,2022-05-11
71,8,63,0,Union,2022-05-12
85,10,75,0,Union,2022-05-13
53,7,46,0,Union,2022-05-14
52,4,48,0,Union,2022-05-15
101,12,89,0,Union,2022-05-16
105,17,88,0,Union,2022-05-17
127,22,105,0,Union,2022-05-18
84,11,73,0,Union,2022-05-20
67,15,52,0,Union,2022-05-21
56,10,46,0,Union,2022-05-22
120,19,101,0,Union,2022-05-23
85,13,72,0,Union,2022-05-24
95,17,78,0,Union,2022-05-25
83,10,73,0,Union,2022-05-26
78,11,67,0,Union,2022-05-27
50,8,42,0,Union,2022-05-28
62,8,54,0,Union,2022-05-29
39,3,36,0,Union,2022-05-30
109,13,96,0,Union,2022-05-31
84,7,77,0,Union,2022-06-02
65,13,52,0,Union,2022-06-03
43,5,38,0,Union,2022-06-04
14,5,9,0,Vance,2021-12-07
16,2,14,0,Vance,2021-12-08
13,4,9,0,Vance,2021-12-09
13,3,10,0,Vance,2021-12-10
5,1,4,0,Vance,2021-12-11
5,0,5,0,Vance,2021-12-12
28,2,26,0,Vance,2021-12-15
34,9,25,0,Vance,2021-12-16
20,4,16,0,Vance,2021-12-17
15,3,12,0,Vance,2021-12-19
35,2,33,0,Vance,2021-12-20
32,12,20,0,Vance,2021-12-21
40,18,22,0,Vance,2021-12-22
35,5,30,0,Vance,2021-12-23
22,5,17,0,Vance,2021-12-24
22,9,13,0,Vance,2021-12-25
34,10,24,0,Vance,2021-12-26
118,26,92,0,Vance,2021-12-27
180,46,134,0,Vance,2021-12-29
231,68,163,0,Vance,2021-12-30
92,36,56,0,Vance,2021-12-31
28,18,10,0,Vance,2022-01-01
52,10,42,0,Vance,2022-01-02
95,16,79,0,Vance,2022-01-07
63,15,48,0,Vance,2022-01-08
45,18,27,0,Vance,2022-01-09
184,38,146,0,Vance,2022-01-10
130,14,116,0,Vance,2022-01-11
114,21,93,0,Vance,2022-01-14
74,10,64,0,Vance,2022-01-15
10,3,7,0,Vance,2022-01-16
117,11,106,0,Vance,2022-01-17
172,27,145,0,Vance,2022-01-18
158,15,143,0,Vance,2022-01-19
59,5,54,0,Vance,2022-01-21
22,3,19,0,Vance,2022-01-22
91,5,86,0,Vance,2022-01-26
48,3,45,0,Vance,2022-01-28
18,1,17,0,Vance,2022-01-29
61,4,57,0,Vance,2022-02-01
34,8,26,0,Vance,2022-02-02
10,0,10,0,Vance,2022-02-05
9,1,8,0,Vance,2022-02-06
35,12,23,0,Vance,2022-02-07
41,11,30,0,Vance,2022-02-08
23,4,19,0,Vance,2022-02-09
18,1,17,0,Vance,2022-02-10
20,5,15,0,Vance,2022-02-11
7,1,6,0,Vance,2022-02-12
4,2,2,0,Vance,2022-02-13
22,1,21,0,Vance,2022-02-14
12,1,11,0,Vance,2022-02-16
13,3,10,0,Vance,2022-02-17
9,1,8,0,Vance,2022-02-18
2,0,2,0,Vance,2022-02-20
10,5,5,0,Vance,2022-02-21
6,1,5,0,Vance,2022-02-22
6,0,6,0,Vance,2022-02-23
4,1,3,0,Vance,2022-02-24
5,0,5,0,Vance,2022-02-25
0,0,0,0,Vance,2022-02-26
4,0,4,0,Vance,2022-02-27
3,3,0,0,Vance,2022-02-28
4,1,3,0,Vance,2022-03-01
1,0,1,0,Vance,2022-03-02
6,1,5,0,Vance,2022-03-03
2,0,2,0,Vance,2022-03-04
3,2,1,0,Vance,2022-03-05
0,0,0,0,Vance,2022-03-06
4,0,4,0,Vance,2022-03-07
7,4,3,0,Vance,2022-03-08
4,0,4,0,Vance,2022-03-09
1,0,1,0,Vance,2022-03-10
3,1,2,0,Vance,2022-03-11
0,0,0,0,Vance,2022-03-12
1,1,0,0,Vance,2022-03-13
1,1,0,0,Vance,2022-03-15
0,0,0,0,Vance,2022-03-16
0,0,0,0,Vance,2022-03-17
4,0,4,0,Vance,2022-03-18
0,0,0,0,Vance,2022-03-19
2,0,2,0,Vance,2022-03-20
1,1,0,0,Vance,2022-03-21
2,1,1,0,Vance,2022-03-22
2,0,2,0,Vance,2022-03-23
3,1,2,0,Vance,2022-03-24
2,0,2,0,Vance,2022-03-25
2,1,1,0,Vance,2022-03-26
0,0,0,0,Vance,2022-03-27
1,0,1,0,Vance,2022-03-28
0,0,0,0,Vance,2022-03-29
0,0,0,0,Vance,2022-03-30
2,1,1,0,Vance,2022-03-31
2,0,2,0,Vance,2022-04-01
1,0,1,0,Vance,2022-04-02
1,1,0,0,Vance,2022-04-03
1,1,0,0,Vance,2022-04-04
1,1,0,0,Vance,2022-04-05
5,0,5,0,Vance,2022-04-06
2,0,2,0,Vance,2022-04-07
5,2,3,0,Vance,2022-04-08
3,0,3,0,Vance,2022-04-09
2,1,1,0,Vance,2022-04-10
1,1,0,0,Vance,2022-04-12
2,1,1,0,Vance,2022-04-13
5,2,3,0,Vance,2022-04-14
0,0,0,0,Vance,2022-04-15
2,1,1,0,Vance,2022-04-16
0,0,0,0,Vance,2022-04-17
1,0,1,0,Vance,2022-04-18
3,2,1,0,Vance,2022-04-19
2,1,1,0,Vance,2022-04-20
1,0,1,0,Vance,2022-04-21
5,2,3,0,Vance,2022-04-22
2,0,2,0,Vance,2022-04-23
2,1,1,0,Vance,2022-04-24
8,3,5,0,Vance,2022-04-25
4,0,4,0,Vance,2022-04-26
2,1,1,0,Vance,2022-04-27
4,1,3,0,Vance,2022-04-28
5,3,2,0,Vance,2022-04-29
3,2,1,0,Vance,2022-04-30
4,1,3,0,Vance,2022-05-01
5,0,5,0,Vance,2022-05-02
8,2,6,0,Vance,2022-05-03
9,1,8,0,Vance,2022-05-04
8,3,5,0,Vance,2022-05-05
7,1,6,0,Vance,2022-05-06
7,4,3,0,Vance,2022-05-07
4,1,3,0,Vance,2022-05-08
17,4,13,0,Vance,2022-05-09
18,3,15,0,Vance,2022-05-10
8,3,5,0,Vance,2022-05-11
15,4,11,0,Vance,2022-05-12
9,2,7,0,Vance,2022-05-13
9,3,6,0,Vance,2022-05-14
3,0,3,0,Vance,2022-05-15
16,5,11,0,Vance,2022-05-16
19,5,14,0,Vance,2022-05-17
22,7,15,0,Vance,2022-05-18
20,5,15,0,Vance,2022-05-19
22,8,14,0,Vance,2022-05-20
12,3,9,0,Vance,2022-05-21
8,5,3,0,Vance,2022-05-22
28,15,13,0,Vance,2022-05-23
14,4,10,0,Vance,2022-05-24
16,6,10,0,Vance,2022-05-25
11,2,9,0,Vance,2022-05-26
10,5,5,0,Vance,2022-05-27
13,3,10,0,Vance,2022-05-28
5,0,5,0,Vance,2022-05-29
7,6,1,0,Vance,2022-05-30
23,7,16,0,Vance,2022-05-31
22,6,16,0,Vance,2022-06-01
14,3,11,0,Vance,2022-06-02
15,5,10,0,Vance,2022-06-03
12,2,10,0,Vance,2022-06-04
319,26,293,0,Wake,2021-12-10
241,18,223,0,Wake,2021-12-11
131,12,119,0,Wake,2021-12-12
453,36,417,0,Wake,2021-12-16
1221,121,1100,0,Wake,2021-12-22
220,19,201,0,Wake,2021-12-25
788,113,675,0,Wake,2021-12-26
3998,242,3756,0,Wake,2021-12-29
3900,235,3665,0,Wake,2021-12-30
2622,150,2472,0,Wake,2021-12-31
2118,143,1975,0,Wake,2022-01-31
344,57,287,0,Wake,2022-02-06
456,42,414,0,Wake,2022-02-16
139,25,114,0,Wake,2022-02-20
76,15,61,0,Wake,2022-02-27
204,21,183,0,Wake,2022-02-28
154,14,140,0,Wake,2022-03-01
148,17,131,0,Wake,2022-03-02
96,8,88,0,Wake,2022-03-14
88,9,79,0,Wake,2022-03-17
73,16,57,0,Wake,2022-03-22
120,13,107,0,Wake,2022-03-23
60,4,56,0,Wake,2022-03-26
101,14,87,0,Wake,2022-03-28
102,6,96,0,Wake,2022-03-29
107,6,101,0,Wake,2022-04-01
40,2,38,0,Wake,2022-04-03
151,18,133,0,Wake,2022-04-05
176,15,161,0,Wake,2022-04-06
146,20,126,0,Wake,2022-04-07
182,14,168,0,Wake,2022-04-08
83,13,70,0,Wake,2022-04-10
248,24,224,0,Wake,2022-04-11
228,23,205,0,Wake,2022-04-12
182,31,151,0,Wake,2022-04-16
106,17,89,0,Wake,2022-04-17
439,41,398,0,Wake,2022-04-18
316,40,276,0,Wake,2022-04-19
360,51,309,0,Wake,2022-04-20
314,34,280,0,Wake,2022-04-21
240,22,218,0,Wake,2022-04-23
477,67,410,0,Wake,2022-04-25
444,64,380,0,Wake,2022-04-26
483,38,445,0,Wake,2022-04-27
403,46,357,0,Wake,2022-04-29
319,38,281,0,Wake,2022-04-30
623,67,556,0,Wake,2022-05-03
624,81,543,0,Wake,2022-05-04
515,43,472,0,Wake,2022-05-06
839,104,735,0,Wake,2022-05-10
856,98,758,0,Wake,2022-05-12
853,91,762,0,Wake,2022-05-13
641,50,591,0,Wake,2022-05-14
1112,126,986,0,Wake,2022-05-18
1021,106,915,0,Wake,2022-05-19
820,75,745,0,Wake,2022-05-20
626,53,573,0,Wake,2022-05-21
1037,93,944,0,Wake,2022-05-23
988,103,885,0,Wake,2022-05-24
856,70,786,0,Wake,2022-05-25
841,97,744,0,Wake,2022-05-26
696,82,614,0,Wake,2022-05-27
470,52,418,0,Wake,2022-05-28
350,47,303,0,Wake,2022-05-29
246,57,189,0,Wake,2022-05-30
1208,112,1096,0,Wake,2022-05-31
880,80,800,0,Wake,2022-06-01
767,68,699,0,Wake,2022-06-02
675,62,613,0,Wake,2022-06-03
446,49,397,0,Wake,2022-06-04
4,0,4,0,Warren,2021-12-07
8,2,6,0,Warren,2021-12-08
10,2,8,0,Warren,2021-12-09
10,0,10,0,Warren,2021-12-10
1,0,1,0,Warren,2021-12-11
6,5,1,0,Warren,2021-12-12
10,1,9,0,Warren,2021-12-13
9,2,7,0,Warren,2021-12-14
6,1,5,0,Warren,2021-12-17
10,3,7,0,Warren,2021-12-18
9,1,8,0,Warren,2021-12-20
6,1,5,0,Warren,2021-12-21
10,1,9,0,Warren,2021-12-22
14,7,7,0,Warren,2021-12-23
5,3,2,0,Warren,2021-12-24
5,1,4,0,Warren,2021-12-25
6,1,5,0,Warren,2021-12-26
25,5,20,0,Warren,2021-12-27
59,13,46,0,Warren,2021-12-29
78,23,55,0,Warren,2021-12-30
32,16,16,0,Warren,2021-12-31
4,2,2,0,Warren,2022-01-01
24,11,13,0,Warren,2022-01-02
72,14,58,0,Warren,2022-01-03
97,19,78,0,Warren,2022-01-04
67,11,56,0,Warren,2022-01-05
62,13,49,0,Warren,2022-01-07
14,1,13,0,Warren,2022-01-09
67,5,62,0,Warren,2022-01-11
38,8,30,0,Warren,2022-01-13
50,4,46,0,Warren,2022-01-14
16,4,12,0,Warren,2022-01-15
4,1,3,0,Warren,2022-01-16
24,7,17,0,Warren,2022-01-17
72,12,60,0,Warren,2022-01-18
47,15,32,0,Warren,2022-01-20
10,3,7,0,Warren,2022-01-21
7,2,5,0,Warren,2022-01-22
66,7,59,0,Warren,2022-01-24
11,2,9,0,Warren,2022-01-25
19,2,17,0,Warren,2022-01-26
10,0,10,0,Warren,2022-01-29
17,5,12,0,Warren,2022-01-30
25,5,20,0,Warren,2022-01-31
23,2,21,0,Warren,2022-02-01
16,2,14,0,Warren,2022-02-02
14,3,11,0,Warren,2022-02-03
12,3,9,0,Warren,2022-02-04
4,1,3,0,Warren,2022-02-05
6,0,6,0,Warren,2022-02-06
11,3,8,0,Warren,2022-02-07
6,0,6,0,Warren,2022-02-08
6,1,5,0,Warren,2022-02-09
7,3,4,0,Warren,2022-02-10
6,0,6,0,Warren,2022-02-11
12,1,11,0,Warren,2022-02-14
6,3,3,0,Warren,2022-02-15
4,0,4,0,Warren,2022-02-16
5,0,5,0,Warren,2022-02-17
1,0,1,0,Warren,2022-02-18
1,0,1,0,Warren,2022-02-19
2,1,1,0,Warren,2022-02-20
4,1,3,0,Warren,2022-02-21
3,1,2,0,Warren,2022-02-22
2,0,2,0,Warren,2022-02-23
1,0,1,0,Warren,2022-02-25
0,0,0,0,Warren,2022-02-26
1,0,1,0,Warren,2022-02-27
1,0,1,0,Warren,2022-02-28
1,0,1,0,Warren,2022-03-01
2,0,2,0,Warren,2022-03-02
0,0,0,0,Warren,2022-03-03
1,0,1,0,Warren,2022-03-04
1,1,0,0,Warren,2022-03-05
0,0,0,0,Warren,2022-03-06
2,1,1,0,Warren,2022-03-08
1,1,0,0,Warren,2022-03-09
0,0,0,0,Warren,2022-03-10
0,0,0,0,Warren,2022-03-11
0,0,0,0,Warren,2022-03-12
0,0,0,0,Warren,2022-03-13
2,0,2,0,Warren,2022-03-14
0,0,0,0,Warren,2022-03-15
1,0,1,0,Warren,2022-03-16
0,0,0,0,Warren,2022-03-17
0,0,0,0,Warren,2022-03-18
0,0,0,0,Warren,2022-03-19
0,0,0,0,Warren,2022-03-20
0,0,0,0,Warren,2022-03-21
1,0,1,0,Warren,2022-03-22
1,1,0,0,Warren,2022-03-23
0,0,0,0,Warren,2022-03-24
3,0,3,0,Warren,2022-03-25
0,0,0,0,Warren,2022-03-26
0,0,0,0,Warren,2022-03-27
0,0,0,0,Warren,2022-03-28
0,0,0,0,Warren,2022-03-29
0,0,0,0,Warren,2022-03-30
0,0,0,0,Warren,2022-03-31
0,0,0,0,Warren,2022-04-01
0,0,0,0,Warren,2022-04-02
0,0,0,0,Warren,2022-04-03
2,0,2,0,Warren,2022-04-04
3,0,3,0,Warren,2022-04-05
2,0,2,0,Warren,2022-04-06
0,0,0,0,Warren,2022-04-07
0,0,0,0,Warren,2022-04-09
0,0,0,0,Warren,2022-04-10
2,0,2,0,Warren,2022-04-11
1,0,1,0,Warren,2022-04-12
1,1,0,0,Warren,2022-04-13
2,0,2,0,Warren,2022-04-14
0,0,0,0,Warren,2022-04-15
1,0,1,0,Warren,2022-04-16
0,0,0,0,Warren,2022-04-17
1,0,1,0,Warren,2022-04-18
2,0,2,0,Warren,2022-04-19
0,0,0,0,Warren,2022-04-20
3,2,1,0,Warren,2022-04-21
4,3,1,0,Warren,2022-04-22
2,0,2,0,Warren,2022-04-23
0,0,0,0,Warren,2022-04-24
5,0,5,0,Warren,2022-04-25
3,0,3,0,Warren,2022-04-26
3,0,3,0,Warren,2022-04-27
1,0,1,0,Warren,2022-04-28
0,0,0,0,Warren,2022-04-29
2,0,2,0,Warren,2022-04-30
1,0,1,0,Warren,2022-05-01
4,2,2,0,Warren,2022-05-02
5,3,2,0,Warren,2022-05-03
5,1,4,0,Warren,2022-05-04
6,1,5,0,Warren,2022-05-05
9,1,8,0,Warren,2022-05-06
3,1,2,0,Warren,2022-05-07
2,0,2,0,Warren,2022-05-08
9,1,8,0,Warren,2022-05-09
4,0,4,0,Warren,2022-05-10
2,1,1,0,Warren,2022-05-11
7,0,7,0,Warren,2022-05-12
6,3,3,0,Warren,2022-05-13
2,0,2,0,Warren,2022-05-14
1,0,1,0,Warren,2022-05-15
13,4,9,0,Warren,2022-05-16
7,2,5,0,Warren,2022-05-17
7,2,5,0,Warren,2022-05-18
7,4,3,0,Warren,2022-05-19
0,0,0,0,Warren,2022-05-20
5,2,3,0,Warren,2022-05-21
3,0,3,0,Warren,2022-05-22
11,0,11,0,Warren,2022-05-23
2,0,2,0,Warren,2022-05-24
8,2,6,0,Warren,2022-05-25
15,2,13,0,Warren,2022-05-26
5,1,4,0,Warren,2022-05-27
10,2,8,0,Warren,2022-05-28
1,0,1,0,Warren,2022-05-29
4,3,1,0,Warren,2022-05-30
7,1,6,0,Warren,2022-05-31
15,1,14,0,Warren,2022-06-01
11,2,9,0,Warren,2022-06-02
7,2,5,0,Warren,2022-06-03
0,0,0,0,Warren,2022-06-04
4,1,3,0,Washington,2021-12-07
0,0,0,0,Washington,2021-12-08
3,1,2,0,Washington,2021-12-09
2,0,2,0,Washington,2021-12-10
1,0,1,0,Washington,2021-12-11
0,0,0,0,Washington,2021-12-12
2,0,2,0,Washington,2021-12-13
2,0,2,0,Washington,2021-12-14
0,0,0,0,Washington,2021-12-15
0,0,0,0,Washington,2021-12-16
0,0,0,0,Washington,2021-12-18
0,0,0,0,Washington,2021-12-19
6,1,5,0,Washington,2021-12-20
2,1,1,0,Washington,2021-12-21
5,3,2,0,Washington,2021-12-22
5,0,5,0,Washington,2021-12-23
0,0,0,0,Washington,2021-12-24
1,0,1,0,Washington,2021-12-25
23,18,5,0,Washington,2021-12-27
24,13,11,0,Washington,2021-12-28
30,19,11,0,Washington,2021-12-29
53,32,21,0,Washington,2021-12-30
25,1,24,0,Washington,2021-12-31
5,3,2,0,Washington,2022-01-01
12,2,10,0,Washington,2022-01-02
42,7,35,0,Washington,2022-01-03
62,11,51,0,Washington,2022-01-04
56,5,51,0,Washington,2022-01-05
38,2,36,0,Washington,2022-01-07
12,2,10,0,Washington,2022-01-09
62,2,60,0,Washington,2022-01-10
43,9,34,0,Washington,2022-01-11
49,11,38,0,Washington,2022-01-13
55,7,48,0,Washington,2022-01-14
69,6,63,0,Washington,2022-01-18
4,3,1,0,Washington,2022-01-21
2,2,0,0,Washington,2022-01-22
9,3,6,0,Washington,2022-01-23
48,26,22,0,Washington,2022-01-24
47,8,39,0,Washington,2022-01-25
29,12,17,0,Washington,2022-01-26
15,4,11,0,Washington,2022-01-27
5,2,3,0,Washington,2022-01-29
6,2,4,0,Washington,2022-01-30
13,4,9,0,Washington,2022-02-01
7,0,7,0,Washington,2022-02-03
17,5,12,0,Washington,2022-02-04
13,4,9,0,Washington,2022-02-07
12,2,10,0,Washington,2022-02-08
3,1,2,0,Washington,2022-02-09
2,0,2,0,Washington,2022-02-10
4,0,4,0,Washington,2022-02-12
1,0,1,0,Washington,2022-02-13
7,2,5,0,Washington,2022-02-14
9,6,3,0,Washington,2022-02-15
6,4,2,0,Washington,2022-02-16
2,1,1,0,Washington,2022-02-17
2,1,1,0,Washington,2022-02-18
1,0,1,0,Washington,2022-02-20
3,0,3,0,Washington,2022-02-22
0,0,0,0,Washington,2022-02-23
2,0,2,0,Washington,2022-02-24
1,1,0,0,Washington,2022-02-25
0,0,0,0,Washington,2022-02-26
1,0,1,0,Washington,2022-02-27
2,0,2,0,Washington,2022-02-28
3,2,1,0,Washington,2022-03-02
0,0,0,0,Washington,2022-03-03
2,0,2,0,Washington,2022-03-04
0,0,0,0,Washington,2022-03-05
1,0,1,0,Washington,2022-03-06
1,0,1,0,Washington,2022-03-07
2,0,2,0,Washington,2022-03-08
1,0,1,0,Washington,2022-03-09
0,0,0,0,Washington,2022-03-10
0,0,0,0,Washington,2022-03-11
0,0,0,0,Washington,2022-03-12
0,0,0,0,Washington,2022-03-13
1,0,1,0,Washington,2022-03-14
2,2,0,0,Washington,2022-03-15
0,0,0,0,Washington,2022-03-16
0,0,0,0,Washington,2022-03-17
0,0,0,0,Washington,2022-03-18
0,0,0,0,Washington,2022-03-19
0,0,0,0,Washington,2022-03-20
0,0,0,0,Washington,2022-03-21
0,0,0,0,Washington,2022-03-22
1,0,1,0,Washington,2022-03-23
0,0,0,0,Washington,2022-03-24
0,0,0,0,Washington,2022-03-25
0,0,0,0,Washington,2022-03-26
1,0,1,0,Washington,2022-03-27
0,0,0,0,Washington,2022-03-28
1,1,0,0,Washington,2022-03-29
0,0,0,0,Washington,2022-03-30
0,0,0,0,Washington,2022-03-31
1,0,1,0,Washington,2022-04-01
0,0,0,0,Washington,2022-04-02
3,1,2,0,Washington,2022-04-03
0,0,0,0,Washington,2022-04-04
1,0,1,0,Washington,2022-04-05
0,0,0,0,Washington,2022-04-06
0,0,0,0,Washington,2022-04-07
1,1,0,0,Washington,2022-04-08
0,0,0,0,Washington,2022-04-09
0,0,0,0,Washington,2022-04-10
0,0,0,0,Washington,2022-04-11
0,0,0,0,Washington,2022-04-12
0,0,0,0,Washington,2022-04-13
0,0,0,0,Washington,2022-04-14
0,0,0,0,Washington,2022-04-15
0,0,0,0,Washington,2022-04-16
1,0,1,0,Washington,2022-04-17
1,0,1,0,Washington,2022-04-18
1,1,0,0,Washington,2022-04-19
2,1,1,0,Washington,2022-04-20
0,0,0,0,Washington,2022-04-21
0,0,0,0,Washington,2022-04-22
0,0,0,0,Washington,2022-04-23
0,0,0,0,Washington,2022-04-24
2,1,1,0,Washington,2022-04-25
3,0,3,0,Washington,2022-04-26
1,0,1,0,Washington,2022-04-27
3,1,2,0,Washington,2022-04-28
0,0,0,0,Washington,2022-04-29
1,0,1,0,Washington,2022-04-30
0,0,0,0,Washington,2022-05-01
1,1,0,0,Washington,2022-05-02
0,0,0,0,Washington,2022-05-03
0,0,0,0,Washington,2022-05-04
0,0,0,0,Washington,2022-05-05
0,0,0,0,Washington,2022-05-06
0,0,0,0,Washington,2022-05-07
0,0,0,0,Washington,2022-05-08
2,1,1,0,Washington,2022-05-09
4,1,3,0,Washington,2022-05-10
0,0,0,0,Washington,2022-05-11
1,1,0,0,Washington,2022-05-12
3,1,2,0,Washington,2022-05-13
4,1,3,0,Washington,2022-05-14
3,1,2,0,Washington,2022-05-15
2,0,2,0,Washington,2022-05-17
0,0,0,0,Washington,2022-05-18
4,2,2,0,Washington,2022-05-19
1,0,1,0,Washington,2022-05-20
0,0,0,0,Washington,2022-05-21
0,0,0,0,Washington,2022-05-22
2,0,2,0,Washington,2022-05-23
1,0,1,0,Washington,2022-05-24
1,0,1,0,Washington,2022-05-25
2,0,2,0,Washington,2022-05-26
0,0,0,0,Washington,2022-05-27
1,0,1,0,Washington,2022-05-28
1,0,1,0,Washington,2022-05-29
1,0,1,0,Washington,2022-05-30
1,0,1,0,Washington,2022-05-31
3,0,3,0,Washington,2022-06-01
4,2,2,0,Washington,2022-06-02
4,1,3,0,Washington,2022-06-03
0,0,0,0,Washington,2022-06-04
15,6,9,0,Watauga,2021-12-08
15,5,10,0,Watauga,2021-12-09
6,2,4,0,Watauga,2021-12-10
5,3,2,0,Watauga,2021-12-11
8,4,4,0,Watauga,2021-12-12
20,9,11,0,Watauga,2021-12-13
21,12,9,0,Watauga,2021-12-14
17,5,12,0,Watauga,2021-12-16
19,4,15,0,Watauga,2021-12-17
44,6,38,0,Watauga,2021-12-20
30,4,26,0,Watauga,2021-12-22
12,6,6,0,Watauga,2021-12-24
6,0,6,0,Watauga,2021-12-25
25,5,20,0,Watauga,2021-12-26
48,13,35,0,Watauga,2021-12-27
89,24,65,0,Watauga,2021-12-28
69,22,47,0,Watauga,2021-12-29
92,22,70,0,Watauga,2021-12-30
33,14,19,0,Watauga,2021-12-31
17,13,4,0,Watauga,2022-01-01
26,16,10,0,Watauga,2022-01-02
52,24,28,0,Watauga,2022-01-03
201,64,137,0,Watauga,2022-01-04
179,56,123,0,Watauga,2022-01-05
136,36,100,0,Watauga,2022-01-06
39,11,28,0,Watauga,2022-01-08
39,11,28,0,Watauga,2022-01-09
208,87,121,0,Watauga,2022-01-10
128,55,73,0,Watauga,2022-01-14
44,26,18,0,Watauga,2022-01-15
21,19,2,0,Watauga,2022-01-16
53,46,7,0,Watauga,2022-01-17
122,89,33,0,Watauga,2022-01-18
272,100,172,0,Watauga,2022-01-19
228,82,146,0,Watauga,2022-01-20
179,81,98,0,Watauga,2022-01-24
218,80,138,0,Watauga,2022-01-25
124,69,55,0,Watauga,2022-01-26
128,48,80,0,Watauga,2022-01-27
33,23,10,0,Watauga,2022-01-29
42,22,20,0,Watauga,2022-01-30
121,62,59,0,Watauga,2022-01-31
122,56,66,0,Watauga,2022-02-01
54,29,25,0,Watauga,2022-02-04
20,10,10,0,Watauga,2022-02-05
23,13,10,0,Watauga,2022-02-06
55,29,26,0,Watauga,2022-02-08
32,14,18,0,Watauga,2022-02-11
14,10,4,0,Watauga,2022-02-12
14,9,5,0,Watauga,2022-02-13
48,30,18,0,Watauga,2022-02-14
19,8,11,0,Watauga,2022-02-18
7,1,6,0,Watauga,2022-02-19
4,1,3,0,Watauga,2022-02-20
31,15,16,0,Watauga,2022-02-21
26,13,13,0,Watauga,2022-02-22
16,2,14,0,Watauga,2022-02-24
6,1,5,0,Watauga,2022-02-26
3,3,0,0,Watauga,2022-02-27
12,7,5,0,Watauga,2022-02-28
11,5,6,0,Watauga,2022-03-02
15,4,11,0,Watauga,2022-03-03
4,2,2,0,Watauga,2022-03-05
3,1,2,0,Watauga,2022-03-07
3,2,1,0,Watauga,2022-03-08
5,3,2,0,Watauga,2022-03-09
5,1,4,0,Watauga,2022-03-10
4,1,3,0,Watauga,2022-03-11
1,1,0,0,Watauga,2022-03-12
6,2,4,0,Watauga,2022-03-14
4,3,1,0,Watauga,2022-03-15
1,0,1,0,Watauga,2022-03-16
2,0,2,0,Watauga,2022-03-17
4,2,2,0,Watauga,2022-03-18
1,0,1,0,Watauga,2022-03-19
3,3,0,0,Watauga,2022-03-20
5,4,1,0,Watauga,2022-03-21
3,0,3,0,Watauga,2022-03-22
9,3,6,0,Watauga,2022-03-23
3,1,2,0,Watauga,2022-03-24
2,0,2,0,Watauga,2022-03-26
2,2,0,0,Watauga,2022-03-27
1,0,1,0,Watauga,2022-03-29
3,0,3,0,Watauga,2022-03-30
1,1,0,0,Watauga,2022-03-31
1,0,1,0,Watauga,2022-04-01
1,1,0,0,Watauga,2022-04-02
4,2,2,0,Watauga,2022-04-03
8,3,5,0,Watauga,2022-04-04
13,7,6,0,Watauga,2022-04-05
6,4,2,0,Watauga,2022-04-06
13,11,2,0,Watauga,2022-04-07
10,7,3,0,Watauga,2022-04-08
10,5,5,0,Watauga,2022-04-09
6,4,2,0,Watauga,2022-04-10
25,16,9,0,Watauga,2022-04-11
27,16,11,0,Watauga,2022-04-12
16,7,9,0,Watauga,2022-04-14
8,8,0,0,Watauga,2022-04-15
12,7,5,0,Watauga,2022-04-16
4,2,2,0,Watauga,2022-04-17
18,9,9,0,Watauga,2022-04-18
14,5,9,0,Watauga,2022-04-19
9,3,6,0,Watauga,2022-04-20
12,3,9,0,Watauga,2022-04-21
19,11,8,0,Watauga,2022-04-22
5,3,2,0,Watauga,2022-04-23
12,10,2,0,Watauga,2022-04-24
20,9,11,0,Watauga,2022-04-25
17,6,11,0,Watauga,2022-04-26
15,5,10,0,Watauga,2022-04-27
13,1,12,0,Watauga,2022-04-28
22,8,14,0,Watauga,2022-04-29
10,5,5,0,Watauga,2022-04-30
9,5,4,0,Watauga,2022-05-01
29,17,12,0,Watauga,2022-05-02
23,11,12,0,Watauga,2022-05-03
17,3,14,0,Watauga,2022-05-04
11,0,11,0,Watauga,2022-05-05
11,5,6,0,Watauga,2022-05-06
11,8,3,0,Watauga,2022-05-07
7,6,1,0,Watauga,2022-05-08
17,9,8,0,Watauga,2022-05-09
12,4,8,0,Watauga,2022-05-10
9,3,6,0,Watauga,2022-05-11
18,7,11,0,Watauga,2022-05-12
11,4,7,0,Watauga,2022-05-13
16,6,10,0,Watauga,2022-05-14
18,14,4,0,Watauga,2022-05-15
32,22,10,0,Watauga,2022-05-16
18,12,6,0,Watauga,2022-05-17
18,11,7,0,Watauga,2022-05-18
19,8,11,0,Watauga,2022-05-19
22,13,9,0,Watauga,2022-05-20
19,9,10,0,Watauga,2022-05-21
13,6,7,0,Watauga,2022-05-22
16,4,12,0,Watauga,2022-05-23
15,13,2,0,Watauga,2022-05-24
19,12,7,0,Watauga,2022-05-25
17,9,8,0,Watauga,2022-05-26
22,10,12,0,Watauga,2022-05-27
15,9,6,0,Watauga,2022-05-28
8,2,6,0,Watauga,2022-05-29
11,6,5,0,Watauga,2022-05-30
18,9,9,0,Watauga,2022-05-31
20,6,14,0,Watauga,2022-06-01
21,3,18,0,Watauga,2022-06-02
20,12,8,0,Watauga,2022-06-03
7,3,4,0,Watauga,2022-06-04
39,27,12,0,Wayne,2021-12-07
26,13,13,0,Wayne,2021-12-09
9,3,6,0,Wayne,2021-12-12
31,17,14,0,Wayne,2021-12-13
28,13,15,0,Wayne,2021-12-15
38,20,18,0,Wayne,2021-12-20
45,26,19,0,Wayne,2021-12-21
57,32,25,0,Wayne,2021-12-23
11,3,8,0,Wayne,2021-12-25
24,10,14,0,Wayne,2021-12-26
164,76,88,0,Wayne,2021-12-28
201,91,110,0,Wayne,2021-12-29
254,141,113,0,Wayne,2021-12-30
77,15,62,0,Wayne,2022-01-01
88,19,69,0,Wayne,2022-01-02
424,210,214,0,Wayne,2022-01-04
428,232,196,0,Wayne,2022-01-06
355,192,163,0,Wayne,2022-01-07
191,75,116,0,Wayne,2022-01-08
703,323,380,0,Wayne,2022-01-10
40,4,36,0,Wayne,2022-01-22
217,106,111,0,Wayne,2022-01-26
185,71,114,0,Wayne,2022-01-27
78,43,35,0,Wayne,2022-02-08
13,2,11,0,Wayne,2022-02-12
14,4,10,0,Wayne,2022-02-13
44,20,24,0,Wayne,2022-02-17
28,13,15,0,Wayne,2022-02-18
10,2,8,0,Wayne,2022-02-19
23,15,8,0,Wayne,2022-02-21
22,6,16,0,Wayne,2022-02-22
16,5,11,0,Wayne,2022-02-23
15,6,9,0,Wayne,2022-02-25
3,0,3,0,Wayne,2022-02-26
3,0,3,0,Wayne,2022-02-27
11,5,6,0,Wayne,2022-03-01
7,4,3,0,Wayne,2022-03-03
5,0,5,0,Wayne,2022-03-05
4,3,1,0,Wayne,2022-03-11
1,1,0,0,Wayne,2022-03-13
9,7,2,0,Wayne,2022-03-14
8,7,1,0,Wayne,2022-03-16
3,1,2,0,Wayne,2022-03-18
1,0,1,0,Wayne,2022-03-20
5,0,5,0,Wayne,2022-03-22
4,3,1,0,Wayne,2022-03-23
2,2,0,0,Wayne,2022-03-24
0,0,0,0,Wayne,2022-03-26
9,5,4,0,Wayne,2022-03-28
2,1,1,0,Wayne,2022-03-29
9,3,6,0,Wayne,2022-03-30
3,1,2,0,Wayne,2022-03-31
2,0,2,0,Wayne,2022-04-01
6,2,4,0,Wayne,2022-04-02
3,0,3,0,Wayne,2022-04-03
7,4,3,0,Wayne,2022-04-04
1,0,1,0,Wayne,2022-04-05
3,2,1,0,Wayne,2022-04-06
4,1,3,0,Wayne,2022-04-07
7,4,3,0,Wayne,2022-04-08
1,1,0,0,Wayne,2022-04-09
13,8,5,0,Wayne,2022-04-11
8,1,7,0,Wayne,2022-04-12
5,2,3,0,Wayne,2022-04-13
9,6,3,0,Wayne,2022-04-14
4,0,4,0,Wayne,2022-04-15
5,2,3,0,Wayne,2022-04-16
1,0,1,0,Wayne,2022-04-17
9,3,6,0,Wayne,2022-04-18
9,4,5,0,Wayne,2022-04-19
14,4,10,0,Wayne,2022-04-20
12,2,10,0,Wayne,2022-04-21
7,3,4,0,Wayne,2022-04-22
10,6,4,0,Wayne,2022-04-23
16,11,5,0,Wayne,2022-04-26
6,4,2,0,Wayne,2022-04-28
7,3,4,0,Wayne,2022-04-29
5,3,2,0,Wayne,2022-04-30
6,1,5,0,Wayne,2022-05-01
31,20,11,0,Wayne,2022-05-02
14,8,6,0,Wayne,2022-05-03
21,13,8,0,Wayne,2022-05-04
49,28,21,0,Wayne,2022-05-05
13,9,4,0,Wayne,2022-05-06
11,5,6,0,Wayne,2022-05-07
19,12,7,0,Wayne,2022-05-09
24,15,9,0,Wayne,2022-05-10
17,12,5,0,Wayne,2022-05-11
21,11,10,0,Wayne,2022-05-12
19,10,9,0,Wayne,2022-05-13
13,4,9,0,Wayne,2022-05-14
11,2,9,0,Wayne,2022-05-15
29,18,11,0,Wayne,2022-05-16
25,13,12,0,Wayne,2022-05-17
27,16,11,0,Wayne,2022-05-18
39,24,15,0,Wayne,2022-05-19
24,12,12,0,Wayne,2022-05-20
11,5,6,0,Wayne,2022-05-21
16,8,8,0,Wayne,2022-05-22
38,20,18,0,Wayne,2022-05-23
42,28,14,0,Wayne,2022-05-24
28,19,9,0,Wayne,2022-05-25
32,22,10,0,Wayne,2022-05-26
38,24,14,0,Wayne,2022-05-27
13,3,10,0,Wayne,2022-05-28
12,5,7,0,Wayne,2022-05-29
18,9,9,0,Wayne,2022-05-30
53,40,13,0,Wayne,2022-05-31
41,25,16,0,Wayne,2022-06-01
30,18,12,0,Wayne,2022-06-02
23,15,8,0,Wayne,2022-06-03
11,7,4,0,Wayne,2022-06-04
25,13,12,0,Wilkes,2021-12-07
34,10,24,0,Wilkes,2021-12-08
36,19,17,0,Wilkes,2021-12-09
18,15,3,0,Wilkes,2021-12-10
10,2,8,0,Wilkes,2021-12-11
33,19,14,0,Wilkes,2021-12-15
24,14,10,0,Wilkes,2021-12-17
18,10,8,0,Wilkes,2021-12-19
49,18,31,0,Wilkes,2021-12-20
21,16,5,0,Wilkes,2021-12-24
12,5,7,0,Wilkes,2021-12-25
97,29,68,0,Wilkes,2021-12-29
100,32,68,0,Wilkes,2021-12-30
55,25,30,0,Wilkes,2021-12-31
44,24,20,0,Wilkes,2022-01-01
131,48,83,0,Wilkes,2022-01-03
157,44,113,0,Wilkes,2022-01-06
110,45,65,0,Wilkes,2022-01-07
245,98,147,0,Wilkes,2022-01-10
182,72,110,0,Wilkes,2022-01-13
174,73,101,0,Wilkes,2022-01-14
56,10,46,0,Wilkes,2022-01-23
79,25,54,0,Wilkes,2022-02-02
38,15,23,0,Wilkes,2022-02-05
54,23,31,0,Wilkes,2022-02-10
22,10,12,0,Wilkes,2022-02-13
66,26,40,0,Wilkes,2022-02-14
25,9,16,0,Wilkes,2022-02-15
31,13,18,0,Wilkes,2022-02-18
21,9,12,0,Wilkes,2022-02-19
15,9,6,0,Wilkes,2022-02-20
24,9,15,0,Wilkes,2022-02-21
41,16,25,0,Wilkes,2022-02-22
16,8,8,0,Wilkes,2022-02-24
30,10,20,0,Wilkes,2022-02-25
4,2,2,0,Wilkes,2022-02-26
8,5,3,0,Wilkes,2022-02-27
9,1,8,0,Wilkes,2022-03-01
18,7,11,0,Wilkes,2022-03-02
8,3,5,0,Wilkes,2022-03-03
11,5,6,0,Wilkes,2022-03-04
4,0,4,0,Wilkes,2022-03-05
2,1,1,0,Wilkes,2022-03-06
6,1,5,0,Wilkes,2022-03-08
10,3,7,0,Wilkes,2022-03-09
3,1,2,0,Wilkes,2022-03-11
4,3,1,0,Wilkes,2022-03-12
3,0,3,0,Wilkes,2022-03-13
8,2,6,0,Wilkes,2022-03-14
2,0,2,0,Wilkes,2022-03-17
2,1,1,0,Wilkes,2022-03-18
0,0,0,0,Wilkes,2022-03-19
1,0,1,0,Wilkes,2022-03-20
2,2,0,0,Wilkes,2022-03-21
1,0,1,0,Wilkes,2022-03-22
1,0,1,0,Wilkes,2022-03-23
2,0,2,0,Wilkes,2022-03-24
0,0,0,0,Wilkes,2022-03-26
0,0,0,0,Wilkes,2022-03-27
2,1,1,0,Wilkes,2022-03-28
0,0,0,0,Wilkes,2022-03-29
1,0,1,0,Wilkes,2022-03-30
1,0,1,0,Wilkes,2022-03-31
1,0,1,0,Wilkes,2022-04-01
1,0,1,0,Wilkes,2022-04-02
1,0,1,0,Wilkes,2022-04-03
3,1,2,0,Wilkes,2022-04-04
0,0,0,0,Wilkes,2022-04-05
2,1,1,0,Wilkes,2022-04-06
2,0,2,0,Wilkes,2022-04-07
5,1,4,0,Wilkes,2022-04-08
1,0,1,0,Wilkes,2022-04-09
1,1,0,0,Wilkes,2022-04-10
1,0,1,0,Wilkes,2022-04-11
5,2,3,0,Wilkes,2022-04-12
1,1,0,0,Wilkes,2022-04-14
0,0,0,0,Wilkes,2022-04-16
0,0,0,0,Wilkes,2022-04-17
5,1,4,0,Wilkes,2022-04-18
2,0,2,0,Wilkes,2022-04-19
4,0,4,0,Wilkes,2022-04-20
6,3,3,0,Wilkes,2022-04-21
5,2,3,0,Wilkes,2022-04-22
4,2,2,0,Wilkes,2022-04-23
4,2,2,0,Wilkes,2022-04-24
4,0,4,0,Wilkes,2022-04-25
5,4,1,0,Wilkes,2022-04-26
2,2,0,0,Wilkes,2022-04-27
2,2,0,0,Wilkes,2022-04-28
9,6,3,0,Wilkes,2022-04-29
4,1,3,0,Wilkes,2022-04-30
4,4,0,0,Wilkes,2022-05-01
8,3,5,0,Wilkes,2022-05-02
16,5,11,0,Wilkes,2022-05-04
12,2,10,0,Wilkes,2022-05-05
15,11,4,0,Wilkes,2022-05-06
9,3,6,0,Wilkes,2022-05-07
4,1,3,0,Wilkes,2022-05-08
18,9,9,0,Wilkes,2022-05-09
8,4,4,0,Wilkes,2022-05-10
15,8,7,0,Wilkes,2022-05-11
9,2,7,0,Wilkes,2022-05-12
14,7,7,0,Wilkes,2022-05-13
17,8,9,0,Wilkes,2022-05-14
14,6,8,0,Wilkes,2022-05-15
18,7,11,0,Wilkes,2022-05-16
24,13,11,0,Wilkes,2022-05-18
17,5,12,0,Wilkes,2022-05-19
19,13,6,0,Wilkes,2022-05-20
11,8,3,0,Wilkes,2022-05-21
19,15,4,0,Wilkes,2022-05-22
51,26,25,0,Wilkes,2022-05-23
10,4,6,0,Wilkes,2022-05-24
24,16,8,0,Wilkes,2022-05-25
28,8,20,0,Wilkes,2022-05-26
21,15,6,0,Wilkes,2022-05-27
23,8,15,0,Wilkes,2022-05-28
22,14,8,0,Wilkes,2022-05-29
20,13,7,0,Wilkes,2022-05-30
23,16,7,0,Wilkes,2022-06-01
33,20,13,0,Wilkes,2022-06-02
17,7,10,0,Wilkes,2022-06-03
16,13,3,0,Wilkes,2022-06-04
20,6,14,0,Wilson,2021-12-07
14,3,11,0,Wilson,2021-12-09
11,4,7,0,Wilson,2021-12-12
20,5,15,0,Wilson,2021-12-13
18,8,10,0,Wilson,2021-12-15
16,10,6,0,Wilson,2021-12-16
11,2,9,0,Wilson,2021-12-19
26,5,21,0,Wilson,2021-12-20
34,11,23,0,Wilson,2021-12-21
22,6,16,0,Wilson,2021-12-24
9,4,5,0,Wilson,2021-12-25
25,9,16,0,Wilson,2021-12-26
125,41,84,0,Wilson,2021-12-27
218,45,173,0,Wilson,2021-12-29
132,24,108,0,Wilson,2021-12-31
335,80,255,0,Wilson,2022-01-03
336,61,275,0,Wilson,2022-01-04
241,87,154,0,Wilson,2022-01-17
23,0,23,0,Wilson,2022-01-22
35,6,29,0,Wilson,2022-01-29
21,5,16,0,Wilson,2022-01-30
82,11,71,0,Wilson,2022-02-01
43,10,33,0,Wilson,2022-02-04
36,14,22,0,Wilson,2022-02-08
28,12,16,0,Wilson,2022-02-09
8,0,8,0,Wilson,2022-02-12
15,6,9,0,Wilson,2022-02-16
20,7,13,0,Wilson,2022-02-17
10,3,7,0,Wilson,2022-02-20
16,4,12,0,Wilson,2022-02-22
9,0,9,0,Wilson,2022-02-23
3,1,2,0,Wilson,2022-02-27
8,2,6,0,Wilson,2022-02-28
6,2,4,0,Wilson,2022-03-01
8,2,6,0,Wilson,2022-03-02
2,0,2,0,Wilson,2022-03-03
3,1,2,0,Wilson,2022-03-06
3,0,3,0,Wilson,2022-03-08
4,2,2,0,Wilson,2022-03-09
6,3,3,0,Wilson,2022-03-10
3,0,3,0,Wilson,2022-03-11
3,0,3,0,Wilson,2022-03-12
5,0,5,0,Wilson,2022-03-14
1,0,1,0,Wilson,2022-03-15
1,0,1,0,Wilson,2022-03-16
7,2,5,0,Wilson,2022-03-17
1,1,0,0,Wilson,2022-03-18
2,1,1,0,Wilson,2022-03-21
0,0,0,0,Wilson,2022-03-22
5,1,4,0,Wilson,2022-03-23
0,0,0,0,Wilson,2022-03-24
1,0,1,0,Wilson,2022-03-25
0,0,0,0,Wilson,2022-03-26
0,0,0,0,Wilson,2022-03-27
7,3,4,0,Wilson,2022-03-29
3,3,0,0,Wilson,2022-03-30
4,2,2,0,Wilson,2022-03-31
2,0,2,0,Wilson,2022-04-01
2,0,2,0,Wilson,2022-04-02
0,0,0,0,Wilson,2022-04-03
0,0,0,0,Wilson,2022-04-04
1,0,1,0,Wilson,2022-04-06
5,2,3,0,Wilson,2022-04-07
5,0,5,0,Wilson,2022-04-08
2,0,2,0,Wilson,2022-04-09
6,2,4,0,Wilson,2022-04-10
6,1,5,0,Wilson,2022-04-11
9,5,4,0,Wilson,2022-04-12
7,6,1,0,Wilson,2022-04-13
4,3,1,0,Wilson,2022-04-14
5,2,3,0,Wilson,2022-04-15
1,0,1,0,Wilson,2022-04-16
1,1,0,0,Wilson,2022-04-17
4,4,0,0,Wilson,2022-04-18
7,1,6,0,Wilson,2022-04-19
10,3,7,0,Wilson,2022-04-20
8,3,5,0,Wilson,2022-04-21
4,0,4,0,Wilson,2022-04-22
4,1,3,0,Wilson,2022-04-23
3,2,1,0,Wilson,2022-04-24
10,3,7,0,Wilson,2022-04-25
10,6,4,0,Wilson,2022-04-26
14,4,10,0,Wilson,2022-04-27
4,3,1,0,Wilson,2022-04-28
7,4,3,0,Wilson,2022-04-29
3,2,1,0,Wilson,2022-04-30
7,3,4,0,Wilson,2022-05-01
14,5,9,0,Wilson,2022-05-02
11,3,8,0,Wilson,2022-05-03
14,5,9,0,Wilson,2022-05-04
9,3,6,0,Wilson,2022-05-05
11,4,7,0,Wilson,2022-05-06
7,1,6,0,Wilson,2022-05-07
6,2,4,0,Wilson,2022-05-08
23,12,11,0,Wilson,2022-05-09
17,8,9,0,Wilson,2022-05-10
21,9,12,0,Wilson,2022-05-11
15,5,10,0,Wilson,2022-05-12
13,7,6,0,Wilson,2022-05-13
14,4,10,0,Wilson,2022-05-14
26,9,17,0,Wilson,2022-05-16
31,13,18,0,Wilson,2022-05-17
29,3,26,0,Wilson,2022-05-18
21,9,12,0,Wilson,2022-05-19
27,10,17,0,Wilson,2022-05-20
13,5,8,0,Wilson,2022-05-22
15,5,10,0,Wilson,2022-05-24
25,8,17,0,Wilson,2022-05-25
21,8,13,0,Wilson,2022-05-26
16,5,11,0,Wilson,2022-05-27
7,4,3,0,Wilson,2022-05-28
11,6,5,0,Wilson,2022-05-30
35,12,23,0,Wilson,2022-05-31
25,13,12,0,Wilson,2022-06-01
19,4,15,0,Wilson,2022-06-02
16,5,11,0,Wilson,2022-06-03
4,3,1,0,Wilson,2022-06-04
34,9,25,0,Yadkin,2021-12-07
32,6,26,0,Yadkin,2021-12-10
13,4,9,0,Yadkin,2021-12-12
32,14,18,0,Yadkin,2021-12-14
39,15,24,0,Yadkin,2021-12-15
18,7,11,0,Yadkin,2021-12-18
44,9,35,0,Yadkin,2021-12-21
39,7,32,0,Yadkin,2021-12-22
17,6,11,0,Yadkin,2021-12-24
125,30,95,0,Yadkin,2021-12-28
104,23,81,0,Yadkin,2021-12-29
59,33,26,0,Yadkin,2021-12-31
36,14,22,0,Yadkin,2022-01-01
46,9,37,0,Yadkin,2022-01-02
109,39,70,0,Yadkin,2022-01-03
144,26,118,0,Yadkin,2022-01-04
94,25,69,0,Yadkin,2022-01-07
68,20,48,0,Yadkin,2022-01-09
130,39,91,0,Yadkin,2022-01-10
199,35,164,0,Yadkin,2022-01-11
151,29,122,0,Yadkin,2022-01-13
102,19,83,0,Yadkin,2022-01-14
73,10,63,0,Yadkin,2022-01-15
10,0,10,0,Yadkin,2022-01-16
103,18,85,0,Yadkin,2022-01-18
153,29,124,0,Yadkin,2022-01-19
106,25,81,0,Yadkin,2022-01-21
59,15,44,0,Yadkin,2022-01-22
82,25,57,0,Yadkin,2022-01-24
89,17,72,0,Yadkin,2022-01-26
23,6,17,0,Yadkin,2022-01-29
28,5,23,0,Yadkin,2022-01-30
53,11,42,0,Yadkin,2022-02-01
41,11,30,0,Yadkin,2022-02-03
41,10,31,0,Yadkin,2022-02-04
16,5,11,0,Yadkin,2022-02-05
18,7,11,0,Yadkin,2022-02-06
29,5,24,0,Yadkin,2022-02-07
40,11,29,0,Yadkin,2022-02-08
28,8,20,0,Yadkin,2022-02-09
18,4,14,0,Yadkin,2022-02-10
29,7,22,0,Yadkin,2022-02-11
14,4,10,0,Yadkin,2022-02-12
10,3,7,0,Yadkin,2022-02-13
27,11,16,0,Yadkin,2022-02-16
7,5,2,0,Yadkin,2022-02-18
7,4,3,0,Yadkin,2022-02-19
7,2,5,0,Yadkin,2022-02-20
11,5,6,0,Yadkin,2022-02-22
10,3,7,0,Yadkin,2022-02-23
6,1,5,0,Yadkin,2022-02-24
6,3,3,0,Yadkin,2022-02-25
7,1,6,0,Yadkin,2022-02-26
6,0,6,0,Yadkin,2022-02-28
7,2,5,0,Yadkin,2022-03-01
4,2,2,0,Yadkin,2022-03-02
2,0,2,0,Yadkin,2022-03-03
4,2,2,0,Yadkin,2022-03-04
1,0,1,0,Yadkin,2022-03-05
2,0,2,0,Yadkin,2022-03-06
4,0,4,0,Yadkin,2022-03-07
1,1,0,0,Yadkin,2022-03-09
0,0,0,0,Yadkin,2022-03-11
0,0,0,0,Yadkin,2022-03-12
2,0,2,0,Yadkin,2022-03-13
1,0,1,0,Yadkin,2022-03-15
1,1,0,0,Yadkin,2022-03-17
0,0,0,0,Yadkin,2022-03-18
0,0,0,0,Yadkin,2022-03-19
0,0,0,0,Yadkin,2022-03-20
4,3,1,0,Yadkin,2022-03-21
4,0,4,0,Yadkin,2022-03-23
0,0,0,0,Yadkin,2022-03-24
1,1,0,0,Yadkin,2022-03-25
0,0,0,0,Yadkin,2022-03-26
0,0,0,0,Yadkin,2022-03-27
2,1,1,0,Yadkin,2022-03-28
2,0,2,0,Yadkin,2022-03-29
3,1,2,0,Yadkin,2022-03-30
2,1,1,0,Yadkin,2022-03-31
0,0,0,0,Yadkin,2022-04-02
0,0,0,0,Yadkin,2022-04-03
2,1,1,0,Yadkin,2022-04-04
1,1,0,0,Yadkin,2022-04-05
4,1,3,0,Yadkin,2022-04-06
1,0,1,0,Yadkin,2022-04-07
2,1,1,0,Yadkin,2022-04-08
3,1,2,0,Yadkin,2022-04-09
1,0,1,0,Yadkin,2022-04-10
0,0,0,0,Yadkin,2022-04-11
0,0,0,0,Yadkin,2022-04-12
3,1,2,0,Yadkin,2022-04-13
3,0,3,0,Yadkin,2022-04-14
3,0,3,0,Yadkin,2022-04-16
3,2,1,0,Yadkin,2022-04-17
4,3,1,0,Yadkin,2022-04-18
1,0,1,0,Yadkin,2022-04-19
7,5,2,0,Yadkin,2022-04-20
4,2,2,0,Yadkin,2022-04-21
2,0,2,0,Yadkin,2022-04-22
1,0,1,0,Yadkin,2022-04-23
4,1,3,0,Yadkin,2022-04-24
5,3,2,0,Yadkin,2022-04-25
3,1,2,0,Yadkin,2022-04-26
2,0,2,0,Yadkin,2022-04-27
3,1,2,0,Yadkin,2022-04-28
5,5,0,0,Yadkin,2022-04-29
2,0,2,0,Yadkin,2022-04-30
1,0,1,0,Yadkin,2022-05-01
13,7,6,0,Yadkin,2022-05-02
4,1,3,0,Yadkin,2022-05-03
8,2,6,0,Yadkin,2022-05-04
6,2,4,0,Yadkin,2022-05-05
8,3,5,0,Yadkin,2022-05-06
5,1,4,0,Yadkin,2022-05-07
5,0,5,0,Yadkin,2022-05-08
12,3,9,0,Yadkin,2022-05-09
11,2,9,0,Yadkin,2022-05-10
9,2,7,0,Yadkin,2022-05-11
6,3,3,0,Yadkin,2022-05-12
13,4,9,0,Yadkin,2022-05-13
9,3,6,0,Yadkin,2022-05-14
12,6,6,0,Yadkin,2022-05-15
16,6,10,0,Yadkin,2022-05-16
20,5,15,0,Yadkin,2022-05-17
16,6,10,0,Yadkin,2022-05-18
18,7,11,0,Yadkin,2022-05-19
10,2,8,0,Yadkin,2022-05-20
9,1,8,0,Yadkin,2022-05-21
9,0,9,0,Yadkin,2022-05-22
18,3,15,0,Yadkin,2022-05-23
18,8,10,0,Yadkin,2022-05-24
16,6,10,0,Yadkin,2022-05-25
6,3,3,0,Yadkin,2022-05-26
22,11,11,0,Yadkin,2022-05-27
13,8,5,0,Yadkin,2022-05-28
8,3,5,0,Yadkin,2022-05-29
16,10,6,0,Yadkin,2022-05-30
25,7,18,0,Yadkin,2022-05-31
22,10,12,0,Yadkin,2022-06-01
25,13,12,0,Yadkin,2022-06-02
12,4,8,0,Yadkin,2022-06-03
10,6,4,0,Yadkin,2022-06-04
18,10,8,0,Yancey,2021-12-08
17,12,5,0,Yancey,2021-12-09
11,7,4,0,Yancey,2021-12-11
7,5,2,0,Yancey,2021-12-12
34,16,18,0,Yancey,2021-12-16
30,24,6,0,Yancey,2021-12-17
14,11,3,0,Yancey,2021-12-18
13,9,4,0,Yancey,2021-12-19
58,37,21,0,Yancey,2021-12-20
22,16,6,0,Yancey,2021-12-21
14,7,7,0,Yancey,2021-12-23
2,0,2,0,Yancey,2021-12-25
12,9,3,0,Yancey,2021-12-26
52,42,10,0,Yancey,2021-12-27
28,21,7,0,Yancey,2021-12-28
45,18,27,0,Yancey,2021-12-29
30,9,21,0,Yancey,2021-12-30
6,5,1,0,Yancey,2022-01-02
26,20,6,0,Yancey,2022-01-03
18,11,7,0,Yancey,2022-01-07
30,9,21,0,Yancey,2022-01-08
42,27,15,0,Yancey,2022-01-11
64,23,41,0,Yancey,2022-01-13
34,6,28,0,Yancey,2022-01-15
14,7,7,0,Yancey,2022-01-17
25,11,14,0,Yancey,2022-01-22
52,20,32,0,Yancey,2022-01-26
33,14,19,0,Yancey,2022-01-28
7,3,4,0,Yancey,2022-01-29
2,1,1,0,Yancey,2022-01-30
47,19,28,0,Yancey,2022-01-31
25,20,5,0,Yancey,2022-02-01
35,14,21,0,Yancey,2022-02-02
23,11,12,0,Yancey,2022-02-03
20,9,11,0,Yancey,2022-02-04
6,3,3,0,Yancey,2022-02-05
13,13,0,0,Yancey,2022-02-06
36,10,26,0,Yancey,2022-02-07
19,13,6,0,Yancey,2022-02-08
31,14,17,0,Yancey,2022-02-09
15,8,7,0,Yancey,2022-02-10
17,5,12,0,Yancey,2022-02-11
7,6,1,0,Yancey,2022-02-13
20,6,14,0,Yancey,2022-02-14
9,6,3,0,Yancey,2022-02-15
18,4,14,0,Yancey,2022-02-16
12,5,7,0,Yancey,2022-02-17
8,1,7,0,Yancey,2022-02-18
4,2,2,0,Yancey,2022-02-19
3,3,0,0,Yancey,2022-02-20
11,1,10,0,Yancey,2022-02-21
6,3,3,0,Yancey,2022-02-22
7,4,3,0,Yancey,2022-02-23
8,4,4,0,Yancey,2022-02-24
5,2,3,0,Yancey,2022-02-25
4,2,2,0,Yancey,2022-02-26
1,0,1,0,Yancey,2022-02-27
4,1,3,0,Yancey,2022-02-28
4,2,2,0,Yancey,2022-03-02
4,2,2,0,Yancey,2022-03-03
2,0,2,0,Yancey,2022-03-04
1,0,1,0,Yancey,2022-03-05
2,2,0,0,Yancey,2022-03-06
2,2,0,0,Yancey,2022-03-07
3,0,3,0,Yancey,2022-03-08
1,1,0,0,Yancey,2022-03-09
2,1,1,0,Yancey,2022-03-10
0,0,0,0,Yancey,2022-03-11
1,1,0,0,Yancey,2022-03-12
0,0,0,0,Yancey,2022-03-13
1,0,1,0,Yancey,2022-03-14
5,4,1,0,Yancey,2022-03-15
2,1,1,0,Yancey,2022-03-16
0,0,0,0,Yancey,2022-03-17
2,0,2,0,Yancey,2022-03-18
0,0,0,0,Yancey,2022-03-19
0,0,0,0,Yancey,2022-03-20
2,0,2,0,Yancey,2022-03-21
0,0,0,0,Yancey,2022-03-22
0,0,0,0,Yancey,2022-03-23
1,0,1,0,Yancey,2022-03-24
1,1,0,0,Yancey,2022-03-25
0,0,0,0,Yancey,2022-03-26
0,0,0,0,Yancey,2022-03-27
2,0,2,0,Yancey,2022-03-28
3,0,3,0,Yancey,2022-03-29
0,0,0,0,Yancey,2022-03-30
6,1,5,0,Yancey,2022-03-31
0,0,0,0,Yancey,2022-04-01
1,0,1,0,Yancey,2022-04-02
0,0,0,0,Yancey,2022-04-03
1,0,1,0,Yancey,2022-04-04
1,0,1,0,Yancey,2022-04-05
0,0,0,0,Yancey,2022-04-06
0,0,0,0,Yancey,2022-04-07
2,1,1,0,Yancey,2022-04-08
0,0,0,0,Yancey,2022-04-09
0,0,0,0,Yancey,2022-04-10
0,0,0,0,Yancey,2022-04-11
2,1,1,0,Yancey,2022-04-12
2,2,0,0,Yancey,2022-04-13
1,1,0,0,Yancey,2022-04-14
0,0,0,0,Yancey,2022-04-15
2,2,0,0,Yancey,2022-04-16
0,0,0,0,Yancey,2022-04-17
1,1,0,0,Yancey,2022-04-18
1,1,0,0,Yancey,2022-04-19
1,0,1,0,Yancey,2022-04-20
2,1,1,0,Yancey,2022-04-21
3,2,1,0,Yancey,2022-04-22
1,1,0,0,Yancey,2022-04-23
0,0,0,0,Yancey,2022-04-24
6,4,2,0,Yancey,2022-04-25
6,2,4,0,Yancey,2022-04-26
3,2,1,0,Yancey,2022-04-27
1,0,1,0,Yancey,2022-04-28
4,4,0,0,Yancey,2022-04-29
1,0,1,0,Yancey,2022-04-30
1,0,1,0,Yancey,2022-05-01
2,1,1,0,Yancey,2022-05-02
3,2,1,0,Yancey,2022-05-03
2,2,0,0,Yancey,2022-05-04
3,3,0,0,Yancey,2022-05-05
2,0,2,0,Yancey,2022-05-06
1,0,1,0,Yancey,2022-05-07
5,2,3,0,Yancey,2022-05-08
7,4,3,0,Yancey,2022-05-09
6,4,2,0,Yancey,2022-05-10
5,2,3,0,Yancey,2022-05-11
1,1,0,0,Yancey,2022-05-12
7,4,3,0,Yancey,2022-05-13
3,3,0,0,Yancey,2022-05-14
1,1,0,0,Yancey,2022-05-15
9,6,3,0,Yancey,2022-05-16
6,3,3,0,Yancey,2022-05-17
10,8,2,0,Yancey,2022-05-18
7,4,3,0,Yancey,2022-05-19
10,8,2,0,Yancey,2022-05-20
4,2,2,0,Yancey,2022-05-21
6,4,2,0,Yancey,2022-05-22
7,5,2,0,Yancey,2022-05-23
3,1,2,0,Yancey,2022-05-24
9,7,2,0,Yancey,2022-05-25
9,8,1,0,Yancey,2022-05-26
9,4,5,0,Yancey,2022-05-27
2,1,1,0,Yancey,2022-05-28
2,2,0,0,Yancey,2022-05-29
1,0,1,0,Yancey,2022-05-30
12,8,4,0,Yancey,2022-05-31
12,5,7,0,Yancey,2022-06-01
7,5,2,0,Yancey,2022-06-02
8,8,0,0,Yancey,2022-06-03
4,3,1,0,Yancey,2022-06-04
20,2,18,1,Alamance,2021-12-12
105,7,98,1,Alamance,2021-12-20
57,8,49,1,Alamance,2021-12-24
107,18,89,1,Alamance,2021-12-26
244,53,191,1,Alamance,2021-12-31
192,52,140,1,Alamance,2022-01-02
673,90,583,1,Alamance,2022-01-03
742,89,653,1,Alamance,2022-01-04
279,21,258,1,Alamance,2022-01-08
588,54,534,1,Alamance,2022-01-14
123,9,114,1,Alamance,2022-01-23
139,21,118,1,Alamance,2022-02-07
101,14,87,1,Alamance,2022-02-08
29,7,22,1,Alamance,2022-02-12
66,7,59,1,Alamance,2022-02-15
23,8,15,1,Alamance,2022-02-20
69,11,58,1,Alamance,2022-02-21
34,3,31,1,Alamance,2022-02-23
14,2,12,1,Alamance,2022-02-27
4,1,3,1,Alamance,2022-03-06
15,1,14,1,Alamance,2022-03-08
15,3,12,1,Alamance,2022-03-09
4,0,4,1,Alamance,2022-03-13
9,0,9,1,Alamance,2022-03-14
5,1,4,1,Alamance,2022-03-17
1,0,1,1,Alamance,2022-03-20
8,4,4,1,Alamance,2022-03-24
9,2,7,1,Alamance,2022-03-28
12,4,8,1,Alamance,2022-03-31
14,6,8,1,Alamance,2022-04-01
7,1,6,1,Alamance,2022-04-02
38,7,31,1,Alamance,2022-04-11
24,4,20,1,Alamance,2022-04-23
38,5,33,1,Alamance,2022-04-26
91,22,69,1,Alamance,2022-05-17
112,17,95,1,Alamance,2022-05-18
17,7,10,1,Alexander,2021-12-24
7,3,4,1,Alexander,2022-01-16
122,47,75,1,Alexander,2022-01-18
50,26,24,1,Alexander,2022-01-23
88,23,65,1,Alexander,2022-01-26
43,12,31,1,Alexander,2022-02-03
13,6,7,1,Alexander,2022-02-06
28,2,26,1,Alexander,2022-02-09
28,6,22,1,Alexander,2022-02-10
20,7,13,1,Alexander,2022-02-16
14,6,8,1,Alexander,2022-02-18
20,12,8,1,Alexander,2022-02-21
6,0,6,1,Alexander,2022-02-24
5,2,3,1,Alexander,2022-03-01
4,1,3,1,Alexander,2022-03-07
0,0,0,1,Alexander,2022-04-16
8,3,5,1,Alexander,2022-05-18
4,0,4,1,Alexander,2022-06-01
12,4,8,1,Alleghany,2021-12-16
14,4,10,1,Alleghany,2021-12-29
12,6,6,1,Alleghany,2021-12-31
6,2,4,1,Alleghany,2022-01-03
38,10,28,1,Alleghany,2022-01-04
34,7,27,1,Alleghany,2022-01-13
0,0,0,1,Alleghany,2022-03-18
2,1,1,1,Alleghany,2022-05-31
1,0,1,1,Anson,2021-12-10
6,3,3,1,Anson,2021-12-14
9,1,8,1,Anson,2021-12-23
25,6,19,1,Anson,2022-01-02
24,4,20,1,Anson,2022-01-09
110,31,79,1,Anson,2022-01-19
68,16,52,1,Anson,2022-01-20
18,8,10,1,Anson,2022-01-30
13,4,9,1,Anson,2022-02-03
15,2,13,1,Anson,2022-02-06
28,6,22,1,Anson,2022-02-08
13,2,11,1,Anson,2022-02-09
19,5,14,1,Anson,2022-02-10
5,2,3,1,Anson,2022-02-13
12,3,9,1,Anson,2022-02-16
7,2,5,1,Anson,2022-02-20
6,0,6,1,Anson,2022-02-23
0,0,0,1,Anson,2022-03-05
1,1,0,1,Anson,2022-03-21
36,11,25,1,Ashe,2021-12-13
2,1,1,1,Ashe,2022-01-01
58,22,36,1,Ashe,2022-01-11
74,30,44,1,Ashe,2022-01-12
92,50,42,1,Ashe,2022-01-14
112,32,80,1,Ashe,2022-01-19
87,29,58,1,Ashe,2022-01-20
70,31,39,1,Ashe,2022-01-21
13,6,7,1,Ashe,2022-01-22
82,38,44,1,Ashe,2022-01-31
39,12,27,1,Ashe,2022-02-01
10,7,3,1,Ashe,2022-02-06
25,8,17,1,Ashe,2022-02-11
18,9,9,1,Ashe,2022-02-16
31,12,19,1,Ashe,2022-02-21
9,4,5,1,Ashe,2022-02-24
0,0,0,1,Ashe,2022-02-26
6,2,4,1,Ashe,2022-03-04
3,1,2,1,Ashe,2022-03-10
2,2,0,1,Ashe,2022-04-22
0,0,0,1,Ashe,2022-04-23
5,3,2,1,Ashe,2022-04-25
0,0,0,1,Ashe,2022-05-01
2,1,1,1,Ashe,2022-05-16
6,0,6,1,Avery,2022-02-06
6,2,4,1,Avery,2022-02-20
5,1,4,1,Avery,2022-03-04
2,2,0,1,Avery,2022-03-06
4,4,0,1,Avery,2022-03-22
2,0,2,1,Avery,2022-04-26
5,0,5,1,Avery,2022-04-29
20,3,17,1,Beaufort,2021-12-09
17,2,15,1,Beaufort,2021-12-22
115,24,91,1,Beaufort,2022-01-05
43,2,41,1,Beaufort,2022-01-09
339,34,305,1,Beaufort,2022-01-18
20,5,15,1,Beaufort,2022-01-21
82,14,68,1,Beaufort,2022-01-27
65,12,53,1,Beaufort,2022-01-28
18,1,17,1,Beaufort,2022-01-30
50,7,43,1,Beaufort,2022-02-04
12,0,12,1,Beaufort,2022-02-06
41,8,33,1,Beaufort,2022-02-08
32,4,28,1,Beaufort,2022-02-10
7,0,7,1,Beaufort,2022-02-13
27,1,26,1,Beaufort,2022-02-17
19,5,14,1,Beaufort,2022-02-18
5,1,4,1,Beaufort,2022-02-20
15,2,13,1,Beaufort,2022-02-23
10,1,9,1,Beaufort,2022-02-25
5,0,5,1,Beaufort,2022-02-26
2,0,2,1,Beaufort,2022-02-27
6,0,6,1,Beaufort,2022-03-01
2,0,2,1,Beaufort,2022-03-04
4,0,4,1,Beaufort,2022-03-07
3,0,3,1,Beaufort,2022-03-08
0,0,0,1,Beaufort,2022-03-31
3,1,2,1,Beaufort,2022-04-11
6,0,6,1,Bertie,2021-12-09
78,4,74,1,Bertie,2022-01-10
41,5,36,1,Bertie,2022-01-14
11,0,11,1,Bertie,2022-01-21
7,0,7,1,Bertie,2022-01-23
19,4,15,1,Bertie,2022-01-26
20,2,18,1,Bertie,2022-01-28
26,1,25,1,Bertie,2022-01-31
2,1,1,1,Bertie,2022-02-06
1,0,1,1,Bertie,2022-03-06
1,0,1,1,Bertie,2022-03-11
7,2,5,1,Bertie,2022-06-01
8,1,7,1,Bladen,2021-12-14
3,0,3,1,Bladen,2021-12-25
11,3,8,1,Bladen,2021-12-26
15,3,12,1,Bladen,2022-01-01
33,3,30,1,Bladen,2022-01-08
116,14,102,1,Bladen,2022-01-14
171,37,134,1,Bladen,2022-01-19
162,31,131,1,Bladen,2022-01-24
88,18,70,1,Bladen,2022-01-25
47,10,37,1,Bladen,2022-01-28
17,6,11,1,Bladen,2022-01-30
30,7,23,1,Bladen,2022-02-03
25,4,21,1,Bladen,2022-02-04
3,0,3,1,Bladen,2022-02-05
10,1,9,1,Bladen,2022-02-06
23,10,13,1,Bladen,2022-02-07
15,2,13,1,Bladen,2022-02-09
18,5,13,1,Bladen,2022-02-11
3,0,3,1,Bladen,2022-02-25
4,0,4,1,Bladen,2022-02-28
3,1,2,1,Bladen,2022-03-08
4,1,3,1,Bladen,2022-03-12
6,2,4,1,Bladen,2022-04-25
18,2,16,1,Bladen,2022-05-27
43,4,39,1,Brunswick,2021-12-09
41,3,38,1,Brunswick,2021-12-18
76,19,57,1,Brunswick,2021-12-20
51,7,44,1,Brunswick,2021-12-26
216,47,169,1,Brunswick,2021-12-30
131,20,111,1,Brunswick,2022-01-02
331,43,288,1,Brunswick,2022-01-03
340,71,269,1,Brunswick,2022-01-04
165,16,149,1,Brunswick,2022-01-08
182,25,157,1,Brunswick,2022-01-09
456,60,396,1,Brunswick,2022-01-11
159,18,141,1,Brunswick,2022-01-16
487,61,426,1,Brunswick,2022-01-18
240,58,182,1,Brunswick,2022-01-27
169,26,143,1,Brunswick,2022-01-28
253,34,219,1,Brunswick,2022-01-31
109,20,89,1,Brunswick,2022-02-09
33,4,29,1,Brunswick,2022-02-12
28,4,24,1,Brunswick,2022-02-13
48,5,43,1,Brunswick,2022-02-16
37,5,32,1,Brunswick,2022-02-18
21,4,17,1,Brunswick,2022-02-24
26,4,22,1,Brunswick,2022-02-25
17,0,17,1,Brunswick,2022-03-02
7,0,7,1,Brunswick,2022-03-03
6,1,5,1,Brunswick,2022-03-05
3,1,2,1,Brunswick,2022-03-10
5,2,3,1,Brunswick,2022-03-13
14,3,11,1,Brunswick,2022-03-17
10,0,10,1,Brunswick,2022-03-18
4,2,2,1,Brunswick,2022-03-25
9,0,9,1,Brunswick,2022-04-08
17,3,14,1,Brunswick,2022-04-12
60,9,51,1,Brunswick,2022-05-09
49,6,43,1,Brunswick,2022-05-12
46,9,37,1,Brunswick,2022-05-26
87,35,52,1,Buncombe,2021-12-09
205,61,144,1,Buncombe,2021-12-23
98,18,80,1,Buncombe,2021-12-26
429,88,341,1,Buncombe,2021-12-29
447,110,337,1,Buncombe,2021-12-30
134,24,110,1,Buncombe,2022-01-01
560,151,409,1,Buncombe,2022-01-03
584,150,434,1,Buncombe,2022-01-07
735,223,512,1,Buncombe,2022-01-12
630,180,450,1,Buncombe,2022-01-14
182,51,131,1,Buncombe,2022-01-17
576,163,413,1,Buncombe,2022-01-18
213,48,165,1,Buncombe,2022-01-23
374,112,262,1,Buncombe,2022-01-27
278,91,187,1,Buncombe,2022-02-01
106,29,77,1,Buncombe,2022-02-06
155,56,99,1,Buncombe,2022-02-10
123,40,83,1,Buncombe,2022-02-11
76,26,50,1,Buncombe,2022-02-12
96,42,54,1,Buncombe,2022-02-17
69,19,50,1,Buncombe,2022-02-24
20,4,16,1,Buncombe,2022-02-26
49,16,33,1,Buncombe,2022-02-28
38,9,29,1,Buncombe,2022-03-03
21,10,11,1,Buncombe,2022-03-08
19,10,9,1,Buncombe,2022-03-10
9,4,5,1,Buncombe,2022-03-13
26,6,20,1,Buncombe,2022-03-14
11,0,11,1,Buncombe,2022-03-15
16,7,9,1,Buncombe,2022-03-16
7,1,6,1,Buncombe,2022-03-25
11,2,9,1,Buncombe,2022-03-26
21,7,14,1,Buncombe,2022-03-29
15,8,7,1,Buncombe,2022-03-30
8,1,7,1,Buncombe,2022-04-03
32,6,26,1,Buncombe,2022-04-06
25,12,13,1,Buncombe,2022-04-07
62,28,34,1,Buncombe,2022-04-19
45,12,33,1,Buncombe,2022-04-22
82,34,48,1,Buncombe,2022-05-06
147,57,90,1,Buncombe,2022-05-12
67,20,47,1,Buncombe,2022-05-21
131,53,78,1,Buncombe,2022-05-24
24,9,15,1,Burke,2021-12-09
3,0,3,1,Burke,2021-12-25
134,19,115,1,Burke,2021-12-28
225,72,153,1,Burke,2022-01-03
242,53,189,1,Burke,2022-01-05
425,144,281,1,Burke,2022-01-11
371,117,254,1,Burke,2022-01-13
148,56,92,1,Burke,2022-01-15
231,69,162,1,Burke,2022-01-18
324,97,227,1,Burke,2022-01-19
75,35,40,1,Burke,2022-01-22
63,21,42,1,Burke,2022-01-23
239,113,126,1,Burke,2022-01-25
212,59,153,1,Burke,2022-01-26
35,10,25,1,Burke,2022-01-30
181,79,102,1,Burke,2022-01-31
115,44,71,1,Burke,2022-02-01
127,36,91,1,Burke,2022-02-02
35,10,25,1,Burke,2022-02-05
92,36,56,1,Burke,2022-02-09
25,4,21,1,Burke,2022-02-13
57,16,41,1,Burke,2022-02-15
13,1,12,1,Burke,2022-02-19
8,0,8,1,Burke,2022-02-20
39,12,27,1,Burke,2022-02-21
21,2,19,1,Burke,2022-02-23
8,1,7,1,Burke,2022-02-26
17,7,10,1,Burke,2022-02-28
1,0,1,1,Burke,2022-03-06
12,4,8,1,Burke,2022-03-09
0,0,0,1,Burke,2022-03-12
4,1,3,1,Burke,2022-03-14
1,0,1,1,Burke,2022-03-19
3,2,1,1,Burke,2022-03-22
4,1,3,1,Burke,2022-04-05
8,2,6,1,Burke,2022-04-14
8,3,5,1,Burke,2022-04-18
1,1,0,1,Burke,2022-04-30
17,8,9,1,Burke,2022-05-10
90,20,70,1,Cabarrus,2021-12-08
58,16,42,1,Cabarrus,2021-12-11
106,25,81,1,Cabarrus,2021-12-15
63,13,50,1,Cabarrus,2021-12-19
175,27,148,1,Cabarrus,2021-12-21
163,58,105,1,Cabarrus,2021-12-26
537,95,442,1,Cabarrus,2021-12-28
132,44,88,1,Cabarrus,2022-01-01
552,150,402,1,Cabarrus,2022-01-07
669,152,517,1,Cabarrus,2022-01-13
694,257,437,1,Cabarrus,2022-01-18
346,90,256,1,Cabarrus,2022-01-26
102,22,80,1,Cabarrus,2022-01-30
68,15,53,1,Cabarrus,2022-02-06
139,28,111,1,Cabarrus,2022-02-07
136,33,103,1,Cabarrus,2022-02-08
89,25,64,1,Cabarrus,2022-02-14
65,15,50,1,Cabarrus,2022-02-18
47,15,32,1,Cabarrus,2022-02-21
16,10,6,1,Cabarrus,2022-02-27
20,3,17,1,Cabarrus,2022-02-28
2,0,2,1,Cabarrus,2022-03-06
9,3,6,1,Cabarrus,2022-03-07
13,5,8,1,Cabarrus,2022-03-10
7,1,6,1,Cabarrus,2022-03-17
4,1,3,1,Cabarrus,2022-04-02
13,4,9,1,Cabarrus,2022-04-07
35,7,28,1,Cabarrus,2022-04-26
25,7,18,1,Cabarrus,2022-04-30
94,17,77,1,Cabarrus,2022-05-17
34,5,29,1,Caldwell,2021-12-15
35,8,27,1,Caldwell,2021-12-16
22,4,18,1,Caldwell,2021-12-24
108,19,89,1,Caldwell,2021-12-27
139,22,117,1,Caldwell,2021-12-29
214,36,178,1,Caldwell,2022-01-03
94,20,74,1,Caldwell,2022-01-09
60,23,37,1,Caldwell,2022-01-17
182,17,165,1,Caldwell,2022-01-18
315,65,250,1,Caldwell,2022-01-19
266,46,220,1,Caldwell,2022-01-21
151,26,125,1,Caldwell,2022-01-25
118,14,104,1,Caldwell,2022-01-26
69,5,64,1,Caldwell,2022-01-29
57,12,45,1,Caldwell,2022-01-30
96,22,74,1,Caldwell,2022-02-03
52,12,40,1,Caldwell,2022-02-09
44,11,33,1,Caldwell,2022-02-10
27,4,23,1,Caldwell,2022-02-13
54,12,42,1,Caldwell,2022-02-14
46,7,39,1,Caldwell,2022-02-15
8,2,6,1,Caldwell,2022-02-19
26,5,21,1,Caldwell,2022-02-21
38,8,30,1,Caldwell,2022-02-22
9,0,9,1,Caldwell,2022-02-27
13,2,11,1,Caldwell,2022-03-01
3,0,3,1,Caldwell,2022-03-05
3,0,3,1,Caldwell,2022-03-18
2,0,2,1,Caldwell,2022-03-23
0,0,0,1,Caldwell,2022-03-31
14,3,11,1,Carteret,2021-12-13
20,6,14,1,Carteret,2021-12-14
34,9,25,1,Carteret,2021-12-23
106,37,69,1,Carteret,2022-01-03
202,82,120,1,Carteret,2022-01-11
198,78,120,1,Carteret,2022-01-12
233,107,126,1,Carteret,2022-01-17
51,11,40,1,Carteret,2022-01-23
30,6,24,1,Carteret,2022-01-29
78,23,55,1,Carteret,2022-02-02
59,22,37,1,Carteret,2022-02-03
63,22,41,1,Carteret,2022-02-04
30,15,15,1,Carteret,2022-02-11
17,4,13,1,Carteret,2022-02-12
18,1,17,1,Carteret,2022-02-13
27,10,17,1,Carteret,2022-02-14
11,3,8,1,Carteret,2022-02-17
20,11,9,1,Carteret,2022-02-21
3,0,3,1,Carteret,2022-02-25
6,2,4,1,Carteret,2022-02-26
6,3,3,1,Carteret,2022-03-03
6,0,6,1,Carteret,2022-03-07
7,3,4,1,Carteret,2022-03-09
0,0,0,1,Carteret,2022-03-31
2,0,2,1,Carteret,2022-04-18
9,5,4,1,Carteret,2022-04-28
13,1,12,1,Caswell,2022-01-22
2,2,0,1,Caswell,2022-02-12
12,0,12,1,Caswell,2022-02-14
3,0,3,1,Caswell,2022-02-16
6,1,5,1,Caswell,2022-02-18
0,0,0,1,Caswell,2022-02-20
2,0,2,1,Caswell,2022-02-22
3,0,3,1,Caswell,2022-03-02
47,15,32,1,Catawba,2021-12-09
26,9,17,1,Catawba,2021-12-25
315,78,237,1,Catawba,2021-12-28
330,107,223,1,Catawba,2021-12-30
90,43,47,1,Catawba,2022-01-01
490,182,308,1,Catawba,2022-01-06
168,41,127,1,Catawba,2022-01-09
778,324,454,1,Catawba,2022-01-10
687,263,424,1,Catawba,2022-01-11
125,38,87,1,Catawba,2022-01-29
326,137,189,1,Catawba,2022-01-31
180,68,112,1,Catawba,2022-02-03
176,76,100,1,Catawba,2022-02-04
56,22,34,1,Catawba,2022-02-06
179,65,114,1,Catawba,2022-02-07
79,34,45,1,Catawba,2022-02-11
38,14,24,1,Catawba,2022-02-13
105,49,56,1,Catawba,2022-02-15
25,9,16,1,Catawba,2022-02-20
46,15,31,1,Catawba,2022-02-22
43,20,23,1,Catawba,2022-02-28
17,4,13,1,Catawba,2022-03-03
8,2,6,1,Catawba,2022-03-15
3,1,2,1,Catawba,2022-03-22
2,0,2,1,Catawba,2022-03-26
3,1,2,1,Catawba,2022-03-29
5,1,4,1,Catawba,2022-03-30
5,0,5,1,Catawba,2022-04-01
12,5,7,1,Catawba,2022-04-13
19,5,14,1,Catawba,2022-04-20
21,4,17,1,Chatham,2021-12-08
59,0,59,1,Chatham,2021-12-22
213,17,196,1,Chatham,2022-01-13
167,26,141,1,Chatham,2022-01-14
71,11,60,1,Chatham,2022-01-21
70,13,57,1,Chatham,2022-01-28
28,3,25,1,Chatham,2022-01-29
65,18,47,1,Chatham,2022-02-01
19,5,14,1,Chatham,2022-02-05
32,5,27,1,Chatham,2022-02-09
18,0,18,1,Chatham,2022-02-15
17,7,10,1,Chatham,2022-02-16
15,2,13,1,Chatham,2022-02-18
2,0,2,1,Chatham,2022-03-29
5,0,5,1,Chatham,2022-03-30
6,2,4,1,Cherokee,2021-12-09
35,4,31,1,Cherokee,2021-12-28
49,12,37,1,Cherokee,2022-01-07
62,15,47,1,Cherokee,2022-01-13
25,1,24,1,Cherokee,2022-01-15
33,10,23,1,Cherokee,2022-01-17
108,29,79,1,Cherokee,2022-01-20
48,9,39,1,Cherokee,2022-01-21
29,8,21,1,Cherokee,2022-01-23
74,19,55,1,Cherokee,2022-01-31
23,2,21,1,Cherokee,2022-02-03
5,0,5,1,Cherokee,2022-02-06
7,0,7,1,Cherokee,2022-02-12
10,4,6,1,Cherokee,2022-02-17
6,2,4,1,Cherokee,2022-02-20
3,1,2,1,Cherokee,2022-02-25
2,0,2,1,Cherokee,2022-03-04
0,0,0,1,Cherokee,2022-03-06
0,0,0,1,Cherokee,2022-03-12
0,0,0,1,Cherokee,2022-03-16
1,0,1,1,Cherokee,2022-03-18
0,0,0,1,Cherokee,2022-03-30
32,2,30,1,Chowan,2021-12-28
22,0,22,1,Chowan,2022-01-08
96,6,90,1,Chowan,2022-01-10
73,6,67,1,Chowan,2022-01-14
67,6,61,1,Chowan,2022-01-20
49,0,49,1,Chowan,2022-01-25
18,0,18,1,Chowan,2022-01-28
5,0,5,1,Chowan,2022-01-29
13,0,13,1,Chowan,2022-02-02
4,0,4,1,Chowan,2022-02-06
12,0,12,1,Chowan,2022-02-07
0,0,0,1,Chowan,2022-02-15
2,0,2,1,Chowan,2022-02-24
0,0,0,1,Chowan,2022-03-03
2,1,1,1,Chowan,2022-03-10
16,0,16,1,Clay,2022-01-09
6,2,4,1,Clay,2022-01-23
15,1,14,1,Clay,2022-02-02
16,5,11,1,Clay,2022-02-03
6,2,4,1,Clay,2022-02-05
6,1,5,1,Clay,2022-02-21
0,0,0,1,Clay,2022-04-02
0,0,0,1,Clay,2022-05-04
27,5,22,1,Cleveland,2021-12-19
12,0,12,1,Cleveland,2021-12-25
36,1,35,1,Cleveland,2021-12-26
304,73,231,1,Cleveland,2022-01-04
359,60,299,1,Cleveland,2022-01-05
307,62,245,1,Cleveland,2022-01-07
399,56,343,1,Cleveland,2022-01-11
399,80,319,1,Cleveland,2022-01-13
233,45,188,1,Cleveland,2022-01-15
329,82,247,1,Cleveland,2022-01-18
97,27,70,1,Cleveland,2022-01-22
241,35,206,1,Cleveland,2022-01-25
157,19,138,1,Cleveland,2022-01-31
143,20,123,1,Cleveland,2022-02-01
81,14,67,1,Cleveland,2022-02-04
46,3,43,1,Cleveland,2022-02-06
36,3,33,1,Cleveland,2022-02-12
24,3,21,1,Cleveland,2022-02-13
37,8,29,1,Cleveland,2022-02-17
14,2,12,1,Cleveland,2022-02-19
10,5,5,1,Cleveland,2022-02-20
7,3,4,1,Cleveland,2022-02-27
2,0,2,1,Cleveland,2022-03-06
5,2,3,1,Cleveland,2022-03-07
3,0,3,1,Cleveland,2022-03-12
1,0,1,1,Cleveland,2022-03-15
2,1,1,1,Cleveland,2022-03-17
1,0,1,1,Cleveland,2022-03-18
2,0,2,1,Cleveland,2022-03-26
12,3,9,1,Cleveland,2022-04-25
16,5,11,1,Cleveland,2022-05-24
8,4,4,1,Columbus,2021-12-09
14,4,10,1,Columbus,2021-12-14
61,8,53,1,Columbus,2021-12-27
205,81,124,1,Columbus,2022-01-06
341,196,145,1,Columbus,2022-01-10
217,42,175,1,Columbus,2022-01-14
25,13,12,1,Columbus,2022-01-22
25,8,17,1,Columbus,2022-01-23
136,49,87,1,Columbus,2022-01-25
93,37,56,1,Columbus,2022-01-27
104,29,75,1,Columbus,2022-01-28
129,60,69,1,Columbus,2022-01-31
59,23,36,1,Columbus,2022-02-02
56,15,41,1,Columbus,2022-02-04
8,4,4,1,Columbus,2022-02-06
21,9,12,1,Columbus,2022-02-10
20,10,10,1,Columbus,2022-02-11
14,3,11,1,Columbus,2022-02-15
10,3,7,1,Columbus,2022-02-17
0,0,0,1,Columbus,2022-02-19
0,0,0,1,Columbus,2022-03-12
2,1,1,1,Columbus,2022-03-31
1,1,0,1,Columbus,2022-04-04
3,1,2,1,Columbus,2022-04-20
23,7,16,1,Craven,2021-12-09
35,8,27,1,Craven,2022-01-01
266,71,195,1,Craven,2022-01-04
132,63,69,1,Craven,2022-01-16
86,24,62,1,Craven,2022-01-23
256,66,190,1,Craven,2022-01-26
169,47,122,1,Craven,2022-01-27
68,19,49,1,Craven,2022-01-29
72,33,39,1,Craven,2022-01-30
109,27,82,1,Craven,2022-02-04
41,13,28,1,Craven,2022-02-06
140,47,93,1,Craven,2022-02-07
19,6,13,1,Craven,2022-02-12
19,5,14,1,Craven,2022-02-13
38,10,28,1,Craven,2022-02-18
16,5,11,1,Craven,2022-02-19
13,6,7,1,Craven,2022-03-02
9,3,6,1,Craven,2022-03-09
2,0,2,1,Craven,2022-03-12
6,1,5,1,Craven,2022-03-14
2,2,0,1,Craven,2022-03-20
5,4,1,1,Craven,2022-03-21
10,3,7,1,Craven,2022-04-23
63,30,33,1,Craven,2022-05-17
132,17,115,1,Cumberland,2021-12-08
128,23,105,1,Cumberland,2021-12-09
137,23,114,1,Cumberland,2021-12-16
176,17,159,1,Cumberland,2021-12-24
944,123,821,1,Cumberland,2021-12-30
354,36,318,1,Cumberland,2022-01-02
1427,129,1298,1,Cumberland,2022-01-03
976,95,881,1,Cumberland,2022-01-07
461,26,435,1,Cumberland,2022-01-09
1186,190,996,1,Cumberland,2022-01-12
682,98,584,1,Cumberland,2022-01-31
292,72,220,1,Cumberland,2022-02-08
229,57,172,1,Cumberland,2022-02-09
58,12,46,1,Cumberland,2022-02-24
25,8,17,1,Cumberland,2022-02-26
11,3,8,1,Cumberland,2022-02-27
80,11,69,1,Cumberland,2022-02-28
36,7,29,1,Cumberland,2022-03-02
51,5,46,1,Cumberland,2022-03-03
30,2,28,1,Cumberland,2022-03-14
25,3,22,1,Cumberland,2022-03-15
32,8,24,1,Cumberland,2022-03-16
7,2,5,1,Cumberland,2022-03-19
17,5,12,1,Cumberland,2022-03-21
16,3,13,1,Cumberland,2022-03-28
24,6,18,1,Cumberland,2022-04-12
64,11,53,1,Cumberland,2022-04-28
182,45,137,1,Cumberland,2022-05-16
19,4,15,1,Currituck,2021-12-22
7,0,7,1,Currituck,2021-12-24
34,5,29,1,Currituck,2021-12-30
73,5,68,1,Currituck,2022-01-11
30,7,23,1,Currituck,2022-02-02
10,2,8,1,Currituck,2022-02-16
0,0,0,1,Currituck,2022-02-24
0,0,0,1,Currituck,2022-03-04
1,0,1,1,Currituck,2022-03-22
34,0,34,1,Dare,2022-01-09
20,0,20,1,Dare,2022-02-03
36,2,34,1,Davidson,2021-12-19
78,8,70,1,Davidson,2021-12-21
65,2,63,1,Davidson,2021-12-26
315,36,279,1,Davidson,2021-12-28
299,58,241,1,Davidson,2021-12-30
187,25,162,1,Davidson,2021-12-31
129,12,117,1,Davidson,2022-01-01
470,56,414,1,Davidson,2022-01-04
463,70,393,1,Davidson,2022-01-06
573,112,461,1,Davidson,2022-01-10
662,79,583,1,Davidson,2022-01-11
414,40,374,1,Davidson,2022-01-21
310,39,271,1,Davidson,2022-01-26
235,36,199,1,Davidson,2022-01-27
86,6,80,1,Davidson,2022-01-30
49,2,47,1,Davidson,2022-02-05
75,10,65,1,Davidson,2022-02-10
57,11,46,1,Davidson,2022-02-11
55,9,46,1,Davidson,2022-02-15
15,1,14,1,Davidson,2022-02-19
45,8,37,1,Davidson,2022-02-22
13,0,13,1,Davidson,2022-02-26
7,1,6,1,Davidson,2022-02-27
10,3,7,1,Davidson,2022-03-04
12,4,8,1,Davidson,2022-03-08
6,0,6,1,Davidson,2022-03-16
27,7,20,1,Davidson,2022-05-04
66,22,44,1,Davidson,2022-05-25
37,4,33,1,Davie,2022-01-02
69,13,56,1,Davie,2022-01-28
64,16,48,1,Davie,2022-02-02
39,12,27,1,Davie,2022-02-04
19,1,18,1,Davie,2022-02-05
34,5,29,1,Davie,2022-02-08
6,3,3,1,Davie,2022-02-13
22,4,18,1,Davie,2022-02-15
12,4,8,1,Davie,2022-02-21
12,2,10,1,Davie,2022-02-25
5,2,3,1,Davie,2022-03-07
3,1,2,1,Davie,2022-03-08
4,1,3,1,Davie,2022-03-17
1,0,1,1,Davie,2022-03-19
9,5,4,1,Davie,2022-04-21
4,1,3,1,Davie,2022-04-23
4,2,2,1,Davie,2022-04-24
8,5,3,1,Davie,2022-04-28
22,8,14,1,Duplin,2021-12-23
2,0,2,1,Duplin,2021-12-25
86,31,55,1,Duplin,2022-01-09
415,165,250,1,Duplin,2022-01-10
226,114,112,1,Duplin,2022-01-17
16,4,12,1,Duplin,2022-01-22
42,8,34,1,Duplin,2022-01-23
110,42,68,1,Duplin,2022-01-27
68,20,48,1,Duplin,2022-02-02
38,13,25,1,Duplin,2022-02-04
54,28,26,1,Duplin,2022-02-07
22,13,9,1,Duplin,2022-02-10
11,3,8,1,Duplin,2022-02-12
9,0,9,1,Duplin,2022-02-13
8,3,5,1,Duplin,2022-02-19
5,1,4,1,Duplin,2022-02-20
10,5,5,1,Duplin,2022-02-25
0,0,0,1,Duplin,2022-02-26
2,0,2,1,Duplin,2022-03-04
5,1,4,1,Duplin,2022-03-05
0,0,0,1,Duplin,2022-03-11
3,0,3,1,Duplin,2022-03-15
2,0,2,1,Duplin,2022-03-16
2,2,0,1,Duplin,2022-03-18
2,2,0,1,Duplin,2022-03-28
3,2,1,1,Duplin,2022-05-09
13,4,9,1,Duplin,2022-05-25
70,5,65,1,Durham,2021-12-13
73,6,67,1,Durham,2021-12-14
1203,74,1129,1,Durham,2022-01-03
1392,77,1315,1,Durham,2022-01-10
1259,93,1166,1,Durham,2022-01-18
191,14,177,1,Durham,2022-01-30
485,47,438,1,Durham,2022-01-31
346,19,327,1,Durham,2022-02-01
298,19,279,1,Durham,2022-02-02
278,32,246,1,Durham,2022-02-03
197,3,194,1,Durham,2022-02-04
138,7,131,1,Durham,2022-02-05
123,6,117,1,Durham,2022-02-06
227,29,198,1,Durham,2022-02-07
72,6,66,1,Durham,2022-02-12
99,4,95,1,Durham,2022-02-15
122,5,117,1,Durham,2022-02-16
50,2,48,1,Durham,2022-02-19
79,7,72,1,Durham,2022-02-21
69,4,65,1,Durham,2022-02-22
45,0,45,1,Durham,2022-03-03
8,1,7,1,Durham,2022-03-05
33,2,31,1,Durham,2022-03-09
24,2,22,1,Durham,2022-03-17
15,1,14,1,Durham,2022-03-18
10,1,9,1,Durham,2022-03-19
12,1,11,1,Durham,2022-03-26
62,2,60,1,Durham,2022-04-06
70,3,67,1,Durham,2022-04-07
115,15,100,1,Durham,2022-04-14
138,8,130,1,Durham,2022-04-18
9,2,7,1,Edgecombe,2021-12-13
258,5,253,1,Edgecombe,2021-12-30
46,1,45,1,Edgecombe,2022-01-09
209,4,205,1,Edgecombe,2022-01-11
197,15,182,1,Edgecombe,2022-01-13
167,10,157,1,Edgecombe,2022-01-14
66,3,63,1,Edgecombe,2022-01-25
39,2,37,1,Edgecombe,2022-02-01
20,1,19,1,Edgecombe,2022-02-03
27,2,25,1,Edgecombe,2022-02-07
21,1,20,1,Edgecombe,2022-02-08
18,4,14,1,Edgecombe,2022-02-21
6,1,5,1,Edgecombe,2022-02-25
0,0,0,1,Edgecombe,2022-04-15
4,0,4,1,Edgecombe,2022-04-27
137,23,114,1,Forsyth,2021-12-07
166,23,143,1,Forsyth,2021-12-08
77,8,69,1,Forsyth,2021-12-11
86,5,81,1,Forsyth,2021-12-12
153,16,137,1,Forsyth,2021-12-17
219,18,201,1,Forsyth,2021-12-20
304,34,270,1,Forsyth,2021-12-22
164,17,147,1,Forsyth,2021-12-24
93,3,90,1,Forsyth,2021-12-25
1049,99,950,1,Forsyth,2021-12-29
280,24,256,1,Forsyth,2022-01-01
423,22,401,1,Forsyth,2022-01-02
1499,135,1364,1,Forsyth,2022-01-12
236,46,190,1,Forsyth,2022-02-08
62,9,53,1,Forsyth,2022-02-13
94,25,69,1,Forsyth,2022-02-17
33,5,28,1,Forsyth,2022-02-19
85,16,69,1,Forsyth,2022-02-21
56,7,49,1,Forsyth,2022-02-23
20,2,18,1,Forsyth,2022-02-27
43,13,30,1,Forsyth,2022-02-28
32,4,28,1,Forsyth,2022-03-02
32,5,27,1,Forsyth,2022-03-07
11,3,8,1,Forsyth,2022-03-08
25,9,16,1,Forsyth,2022-03-09
15,3,12,1,Forsyth,2022-03-11
19,6,13,1,Forsyth,2022-03-12
22,4,18,1,Forsyth,2022-03-14
19,2,17,1,Forsyth,2022-03-15
24,7,17,1,Forsyth,2022-03-17
22,7,15,1,Forsyth,2022-03-23
30,7,23,1,Forsyth,2022-03-30
34,12,22,1,Forsyth,2022-04-04
182,35,147,1,Forsyth,2022-05-16
202,45,157,1,Forsyth,2022-05-19
106,16,90,1,Forsyth,2022-05-28
88,7,81,1,Franklin,2022-01-01
313,19,294,1,Franklin,2022-01-14
29,7,22,1,Franklin,2022-01-30
66,2,64,1,Franklin,2022-02-04
99,30,69,1,Franklin,2022-02-07
45,8,37,1,Franklin,2022-02-09
70,8,62,1,Franklin,2022-02-10
16,0,16,1,Franklin,2022-02-17
8,3,5,1,Franklin,2022-02-24
3,0,3,1,Franklin,2022-02-27
5,1,4,1,Franklin,2022-03-06
4,0,4,1,Franklin,2022-03-14
0,0,0,1,Franklin,2022-03-27
41,1,40,1,Franklin,2022-05-09
115,36,79,1,Gaston,2021-12-07
110,19,91,1,Gaston,2021-12-17
165,28,137,1,Gaston,2021-12-20
161,36,125,1,Gaston,2021-12-21
197,46,151,1,Gaston,2021-12-23
42,1,41,1,Gaston,2021-12-25
281,81,200,1,Gaston,2021-12-31
261,62,199,1,Gaston,2022-01-02
712,118,594,1,Gaston,2022-01-12
58,10,48,1,Gaston,2022-02-21
48,13,35,1,Gaston,2022-02-22
36,8,28,1,Gaston,2022-02-24
14,3,11,1,Gaston,2022-02-25
12,2,10,1,Gaston,2022-02-27
22,9,13,1,Gaston,2022-03-03
13,9,4,1,Gaston,2022-03-06
14,2,12,1,Gaston,2022-03-07
10,3,7,1,Gaston,2022-03-08
2,1,1,1,Gaston,2022-03-11
4,1,3,1,Gaston,2022-03-13
8,1,7,1,Gaston,2022-03-15
11,1,10,1,Gaston,2022-03-16
5,2,3,1,Gaston,2022-03-17
4,0,4,1,Gaston,2022-03-25
8,4,4,1,Gaston,2022-03-28
6,2,4,1,Gaston,2022-03-30
9,3,6,1,Gaston,2022-04-07
6,2,4,1,Gaston,2022-04-09
58,11,47,1,Gaston,2022-05-11
76,13,63,1,Gaston,2022-05-25
52,9,43,1,Gaston,2022-05-29
67,10,57,1,Gaston,2022-06-01
11,0,11,1,Gates,2022-01-07
23,8,15,1,Gates,2022-01-14
34,29,5,1,Graham,2022-01-10
13,9,4,1,Graham,2022-01-15
0,0,0,1,Graham,2022-03-24
31,6,25,1,Granville,2021-12-21
157,12,145,1,Granville,2022-01-07
264,19,245,1,Granville,2022-01-18
34,1,33,1,Granville,2022-01-30
59,1,58,1,Granville,2022-02-03
38,5,33,1,Granville,2022-02-14
11,4,7,1,Granville,2022-04-29
14,6,8,1,Granville,2022-05-03
13,0,13,1,Granville,2022-05-15
14,5,9,1,Greene,2022-01-23
48,17,31,1,Greene,2022-01-26
31,8,23,1,Greene,2022-02-07
6,0,6,1,Greene,2022-02-12
2,0,2,1,Greene,2022-02-13
5,2,3,1,Greene,2022-02-17
1,0,1,1,Greene,2022-02-23
1,0,1,1,Greene,2022-02-25
4,1,3,1,Greene,2022-03-07
175,28,147,1,Guilford,2021-12-07
152,26,126,1,Guilford,2021-12-09
136,21,115,1,Guilford,2021-12-10
192,27,165,1,Guilford,2021-12-15
417,70,347,1,Guilford,2021-12-23
983,150,833,1,Guilford,2021-12-27
1157,153,1004,1,Guilford,2021-12-28
1250,265,985,1,Guilford,2021-12-30
802,209,593,1,Guilford,2021-12-31
324,69,255,1,Guilford,2022-01-01
1142,74,1068,1,Guilford,2022-01-08
1756,267,1489,1,Guilford,2022-01-13
1433,187,1246,1,Guilford,2022-01-19
926,122,804,1,Guilford,2022-01-21
572,122,450,1,Guilford,2022-01-31
120,22,98,1,Guilford,2022-02-17
21,8,13,1,Guilford,2022-02-27
67,10,57,1,Guilford,2022-02-28
42,9,33,1,Guilford,2022-03-03
37,8,29,1,Guilford,2022-03-07
34,7,27,1,Guilford,2022-03-08
31,10,21,1,Guilford,2022-03-10
23,7,16,1,Guilford,2022-03-11
9,0,9,1,Guilford,2022-03-19
12,4,8,1,Guilford,2022-03-20
37,8,29,1,Guilford,2022-03-23
24,2,22,1,Guilford,2022-03-29
27,5,22,1,Guilford,2022-03-30
11,4,7,1,Guilford,2022-04-02
90,21,69,1,Guilford,2022-04-12
64,7,57,1,Guilford,2022-04-16
170,70,100,1,Guilford,2022-04-18
160,42,118,1,Guilford,2022-04-25
122,29,93,1,Guilford,2022-04-26
115,32,83,1,Guilford,2022-04-29
73,23,50,1,Guilford,2022-04-30
286,63,223,1,Guilford,2022-05-09
247,47,200,1,Guilford,2022-05-10
247,46,201,1,Guilford,2022-05-12
206,30,176,1,Guilford,2022-05-24
125,18,107,1,Guilford,2022-05-28
88,25,63,1,Guilford,2022-05-30
203,22,181,1,Guilford,2022-06-01
82,10,72,1,Guilford,2022-06-04
6,0,6,1,Halifax,2021-12-07
27,2,25,1,Halifax,2021-12-23
223,22,201,1,Halifax,2021-12-29
58,4,54,1,Halifax,2022-01-02
304,29,275,1,Halifax,2022-01-04
25,1,24,1,Halifax,2022-01-16
23,3,20,1,Halifax,2022-01-21
12,1,11,1,Halifax,2022-01-22
95,16,79,1,Halifax,2022-01-25
66,17,49,1,Halifax,2022-01-27
18,5,13,1,Halifax,2022-01-29
9,4,5,1,Halifax,2022-02-05
8,0,8,1,Halifax,2022-02-06
28,7,21,1,Halifax,2022-02-09
8,1,7,1,Halifax,2022-02-12
0,0,0,1,Halifax,2022-02-24
5,0,5,1,Halifax,2022-02-26
2,0,2,1,Halifax,2022-03-26
2,2,0,1,Halifax,2022-04-10
47,11,36,1,Harnett,2021-12-08
31,1,30,1,Harnett,2021-12-18
191,23,168,1,Harnett,2021-12-27
248,44,204,1,Harnett,2021-12-29
116,14,102,1,Harnett,2022-01-02
441,79,362,1,Harnett,2022-01-06
204,17,187,1,Harnett,2022-01-08
149,20,129,1,Harnett,2022-01-09
623,119,504,1,Harnett,2022-01-10
528,98,430,1,Harnett,2022-01-13
625,108,517,1,Harnett,2022-01-19
482,68,414,1,Harnett,2022-01-20
174,39,135,1,Harnett,2022-01-21
83,8,75,1,Harnett,2022-01-23
62,8,54,1,Harnett,2022-01-29
77,18,59,1,Harnett,2022-01-30
106,24,82,1,Harnett,2022-02-04
44,5,39,1,Harnett,2022-02-05
33,5,28,1,Harnett,2022-02-06
95,35,60,1,Harnett,2022-02-08
52,9,43,1,Harnett,2022-02-11
55,14,41,1,Harnett,2022-02-14
42,6,36,1,Harnett,2022-02-15
31,5,26,1,Harnett,2022-02-18
17,4,13,1,Harnett,2022-02-19
27,1,26,1,Harnett,2022-02-22
6,1,5,1,Harnett,2022-02-27
21,5,16,1,Harnett,2022-02-28
9,1,8,1,Harnett,2022-03-01
18,8,10,1,Harnett,2022-03-02
16,5,11,1,Harnett,2022-03-07
9,1,8,1,Harnett,2022-03-08
7,0,7,1,Harnett,2022-03-11
14,5,9,1,Harnett,2022-03-14
9,1,8,1,Harnett,2022-03-16
9,1,8,1,Harnett,2022-03-18
5,1,4,1,Harnett,2022-04-06
9,2,7,1,Harnett,2022-04-13
12,6,6,1,Harnett,2022-04-23
7,0,7,1,Harnett,2022-04-24
25,8,17,1,Harnett,2022-04-25
27,3,24,1,Harnett,2022-05-28
19,4,15,1,Haywood,2021-12-10
8,2,6,1,Haywood,2021-12-12
32,7,25,1,Haywood,2021-12-20
16,1,15,1,Haywood,2021-12-21
20,10,10,1,Haywood,2021-12-22
11,5,6,1,Haywood,2021-12-24
64,21,43,1,Haywood,2021-12-29
59,27,32,1,Haywood,2021-12-31
33,15,18,1,Haywood,2022-01-02
88,23,65,1,Haywood,2022-01-07
141,54,87,1,Haywood,2022-01-11
166,51,115,1,Haywood,2022-01-14
61,20,41,1,Haywood,2022-01-17
112,29,83,1,Haywood,2022-01-27
93,29,64,1,Haywood,2022-01-28
20,2,18,1,Haywood,2022-01-29
54,9,45,1,Haywood,2022-01-30
106,46,60,1,Haywood,2022-01-31
93,48,45,1,Haywood,2022-02-01
89,30,59,1,Haywood,2022-02-02
34,13,21,1,Haywood,2022-02-05
36,13,23,1,Haywood,2022-02-06
49,22,27,1,Haywood,2022-02-07
45,15,30,1,Haywood,2022-02-08
43,19,24,1,Haywood,2022-02-14
14,10,4,1,Haywood,2022-02-22
23,12,11,1,Haywood,2022-02-24
14,1,13,1,Haywood,2022-02-25
8,4,4,1,Haywood,2022-02-26
8,2,6,1,Haywood,2022-03-01
3,1,2,1,Haywood,2022-03-29
56,24,32,1,Henderson,2021-12-07
38,19,19,1,Henderson,2021-12-12
24,5,19,1,Henderson,2021-12-25
33,13,20,1,Henderson,2021-12-26
165,29,136,1,Henderson,2021-12-29
177,40,137,1,Henderson,2021-12-30
248,89,159,1,Henderson,2022-01-14
230,86,144,1,Henderson,2022-01-18
152,50,102,1,Henderson,2022-01-31
108,34,74,1,Henderson,2022-02-01
106,36,70,1,Henderson,2022-02-04
46,21,25,1,Henderson,2022-02-06
108,36,72,1,Henderson,2022-02-07
64,18,46,1,Henderson,2022-02-08
67,19,48,1,Henderson,2022-02-10
49,15,34,1,Henderson,2022-02-11
24,12,12,1,Henderson,2022-02-12
32,18,14,1,Henderson,2022-02-18
22,7,15,1,Henderson,2022-02-22
10,4,6,1,Henderson,2022-03-01
4,0,4,1,Henderson,2022-03-06
3,2,1,1,Henderson,2022-03-09
7,5,2,1,Henderson,2022-03-11
1,0,1,1,Henderson,2022-03-17
3,0,3,1,Henderson,2022-03-19
2,1,1,1,Henderson,2022-03-24
38,13,25,1,Henderson,2022-05-13
16,3,13,1,Henderson,2022-05-15
31,9,22,1,Henderson,2022-05-25
3,0,3,1,Hertford,2021-12-15
19,1,18,1,Hertford,2022-01-02
79,18,61,1,Hertford,2022-01-13
48,7,41,1,Hertford,2022-01-19
2,0,2,1,Hertford,2022-01-22
20,3,17,1,Hertford,2022-01-28
13,3,10,1,Hertford,2022-01-31
1,0,1,1,Hertford,2022-02-11
4,1,3,1,Hertford,2022-02-16
0,0,0,1,Hertford,2022-04-05
20,1,19,1,Hoke,2021-12-08
65,3,62,1,Hoke,2022-01-01
150,6,144,1,Hoke,2022-01-09
310,27,283,1,Hoke,2022-01-19
215,34,181,1,Hoke,2022-01-24
93,17,76,1,Hoke,2022-01-27
77,4,73,1,Hoke,2022-01-28
75,14,61,1,Hoke,2022-02-01
54,4,50,1,Hoke,2022-02-02
55,6,49,1,Hoke,2022-02-04
13,2,11,1,Hoke,2022-02-17
8,1,7,1,Hoke,2022-02-18
2,0,2,1,Hoke,2022-02-20
6,0,6,1,Hoke,2022-02-28
1,0,1,1,Hoke,2022-03-01
7,2,5,1,Hoke,2022-03-08
1,0,1,1,Hoke,2022-04-04
3,0,3,1,Hyde,2021-12-30
7,1,6,1,Hyde,2022-01-06
87,23,64,1,Iredell,2021-12-07
74,20,54,1,Iredell,2021-12-10
53,17,36,1,Iredell,2021-12-12
129,33,96,1,Iredell,2021-12-13
117,24,93,1,Iredell,2021-12-14
158,52,106,1,Iredell,2021-12-20
65,22,43,1,Iredell,2021-12-24
444,156,288,1,Iredell,2021-12-29
403,135,268,1,Iredell,2021-12-30
141,75,66,1,Iredell,2022-01-01
211,86,125,1,Iredell,2022-01-09
638,194,444,1,Iredell,2022-01-13
178,69,109,1,Iredell,2022-01-17
275,99,176,1,Iredell,2022-01-27
219,86,133,1,Iredell,2022-02-01
190,59,131,1,Iredell,2022-02-03
67,14,53,1,Iredell,2022-02-05
118,49,69,1,Iredell,2022-02-08
103,37,66,1,Iredell,2022-02-10
84,34,50,1,Iredell,2022-02-11
58,23,35,1,Iredell,2022-02-15
22,8,14,1,Iredell,2022-02-19
25,10,15,1,Iredell,2022-02-20
62,24,38,1,Iredell,2022-02-21
37,13,24,1,Iredell,2022-02-22
28,12,16,1,Iredell,2022-02-23
26,9,17,1,Iredell,2022-02-24
31,10,21,1,Iredell,2022-02-28
1,0,1,1,Iredell,2022-03-12
1,1,0,1,Iredell,2022-04-02
30,8,22,1,Iredell,2022-05-15
30,11,19,1,Iredell,2022-05-21
88,35,53,1,Iredell,2022-05-23
82,31,51,1,Iredell,2022-05-25
9,2,7,1,Jackson,2021-12-17
9,3,6,1,Jackson,2021-12-21
17,7,10,1,Jackson,2022-01-01
150,27,123,1,Jackson,2022-01-04
166,42,124,1,Jackson,2022-01-05
120,28,92,1,Jackson,2022-01-06
99,22,77,1,Jackson,2022-01-07
129,39,90,1,Jackson,2022-01-14
71,8,63,1,Jackson,2022-01-21
73,25,48,1,Jackson,2022-01-26
102,38,64,1,Jackson,2022-01-27
42,14,28,1,Jackson,2022-02-04
15,6,9,1,Jackson,2022-02-11
23,10,13,1,Jackson,2022-02-14
11,4,7,1,Jackson,2022-02-22
9,5,4,1,Jackson,2022-02-25
5,2,3,1,Jackson,2022-02-27
6,4,2,1,Jackson,2022-03-02
7,3,4,1,Jackson,2022-03-03
1,0,1,1,Jackson,2022-03-27
0,0,0,1,Jackson,2022-04-15
7,3,4,1,Jackson,2022-05-02
91,22,69,1,Johnston,2021-12-08
111,20,91,1,Johnston,2021-12-15
149,17,132,1,Johnston,2021-12-20
153,32,121,1,Johnston,2021-12-22
34,11,23,1,Johnston,2021-12-25
552,76,476,1,Johnston,2021-12-29
615,104,511,1,Johnston,2021-12-30
936,122,814,1,Johnston,2022-01-04
382,24,358,1,Johnston,2022-01-08
359,71,288,1,Johnston,2022-01-09
1027,185,842,1,Johnston,2022-01-11
496,85,411,1,Johnston,2022-01-15
132,28,104,1,Johnston,2022-01-16
1205,197,1008,1,Johnston,2022-01-18
979,138,841,1,Johnston,2022-01-19
261,54,207,1,Johnston,2022-01-21
160,31,129,1,Johnston,2022-01-23
864,150,714,1,Johnston,2022-01-24
365,81,284,1,Johnston,2022-01-31
280,69,211,1,Johnston,2022-02-01
253,60,193,1,Johnston,2022-02-02
99,15,84,1,Johnston,2022-02-05
202,40,162,1,Johnston,2022-02-07
108,34,74,1,Johnston,2022-02-09
41,6,35,1,Johnston,2022-02-22
29,9,20,1,Johnston,2022-02-23
16,3,13,1,Johnston,2022-02-27
17,0,17,1,Johnston,2022-03-04
17,3,14,1,Johnston,2022-03-07
11,4,7,1,Johnston,2022-03-10
7,1,6,1,Johnston,2022-03-13
9,4,5,1,Johnston,2022-03-15
10,4,6,1,Johnston,2022-03-24
32,3,29,1,Johnston,2022-05-08
85,16,69,1,Johnston,2022-05-09
72,22,50,1,Johnston,2022-05-10
94,26,68,1,Johnston,2022-05-17
49,6,43,1,Johnston,2022-05-21
96,18,78,1,Johnston,2022-05-24
5,0,5,1,Jones,2021-12-13
21,15,6,1,Jones,2022-01-26
13,2,11,1,Lee,2021-12-24
194,39,155,1,Lee,2022-01-04
210,30,180,1,Lee,2022-01-05
163,9,154,1,Lee,2022-01-06
103,7,96,1,Lee,2022-01-08
67,16,51,1,Lee,2022-01-09
320,67,253,1,Lee,2022-01-10
307,41,266,1,Lee,2022-01-12
256,46,210,1,Lee,2022-01-14
159,39,120,1,Lee,2022-01-17
69,5,64,1,Lee,2022-01-28
53,10,43,1,Lee,2022-02-01
15,1,14,1,Lee,2022-02-05
30,5,25,1,Lee,2022-02-09
6,3,3,1,Lee,2022-02-13
13,4,9,1,Lee,2022-02-14
25,2,23,1,Lee,2022-02-16
16,2,14,1,Lee,2022-02-17
6,0,6,1,Lee,2022-02-22
3,0,3,1,Lee,2022-02-26
3,3,0,1,Lee,2022-03-06
7,1,6,1,Lee,2022-03-08
4,1,3,1,Lee,2022-03-12
1,0,1,1,Lee,2022-03-23
0,0,0,1,Lee,2022-04-01
21,5,16,1,Lee,2022-05-23
124,13,111,1,Lenoir,2021-12-28
35,7,28,1,Lenoir,2022-01-01
160,21,139,1,Lenoir,2022-01-03
195,47,148,1,Lenoir,2022-01-04
50,13,37,1,Lenoir,2022-01-09
276,59,217,1,Lenoir,2022-01-13
352,70,282,1,Lenoir,2022-01-18
341,76,265,1,Lenoir,2022-01-19
252,43,209,1,Lenoir,2022-01-24
186,35,151,1,Lenoir,2022-01-25
139,30,109,1,Lenoir,2022-01-26
25,10,15,1,Lenoir,2022-01-29
14,3,11,1,Lenoir,2022-01-30
89,18,71,1,Lenoir,2022-01-31
58,15,43,1,Lenoir,2022-02-01
16,3,13,1,Lenoir,2022-02-05
10,1,9,1,Lenoir,2022-02-06
51,13,38,1,Lenoir,2022-02-07
3,0,3,1,Lenoir,2022-02-13
19,2,17,1,Lenoir,2022-02-14
14,3,11,1,Lenoir,2022-02-15
2,0,2,1,Lenoir,2022-02-23
6,1,5,1,Lenoir,2022-02-25
1,0,1,1,Lenoir,2022-03-04
1,1,0,1,Lenoir,2022-03-05
1,0,1,1,Lenoir,2022-03-06
3,1,2,1,Lenoir,2022-03-10
0,0,0,1,Lenoir,2022-03-26
2,1,1,1,Lenoir,2022-04-14
24,8,16,1,Lenoir,2022-05-31
29,8,21,1,Lincoln,2021-12-09
66,14,52,1,Lincoln,2021-12-23
147,45,102,1,Lincoln,2021-12-27
54,15,39,1,Lincoln,2022-01-02
270,66,204,1,Lincoln,2022-01-04
94,15,79,1,Lincoln,2022-01-08
213,86,127,1,Lincoln,2022-01-10
339,113,226,1,Lincoln,2022-01-11
71,25,46,1,Lincoln,2022-01-23
40,11,29,1,Lincoln,2022-01-30
130,39,91,1,Lincoln,2022-02-01
31,8,23,1,Lincoln,2022-02-06
41,10,31,1,Lincoln,2022-02-11
23,11,12,1,Lincoln,2022-02-12
43,13,30,1,Lincoln,2022-02-15
20,5,15,1,Lincoln,2022-02-18
12,6,6,1,Lincoln,2022-02-22
9,2,7,1,Lincoln,2022-03-01
2,0,2,1,Lincoln,2022-03-18
3,0,3,1,Lincoln,2022-03-29
1,0,1,1,Lincoln,2022-04-05
15,4,11,1,Lincoln,2022-05-02
15,4,11,1,Macon,2021-12-14
1,0,1,1,Macon,2021-12-18
7,2,5,1,Macon,2021-12-25
33,12,21,1,Macon,2021-12-30
6,0,6,1,Macon,2022-01-01
81,19,62,1,Macon,2022-01-03
41,15,26,1,Macon,2022-01-07
18,5,13,1,Macon,2022-01-09
97,6,91,1,Macon,2022-01-14
108,29,79,1,Macon,2022-01-18
34,11,23,1,Macon,2022-01-27
57,15,42,1,Macon,2022-01-31
21,4,17,1,Macon,2022-02-08
8,2,6,1,Macon,2022-02-17
6,2,4,1,Macon,2022-02-22
5,2,3,1,Macon,2022-02-24
1,0,1,1,Macon,2022-02-27
2,0,2,1,Macon,2022-03-02
5,3,2,1,Macon,2022-03-07
1,0,1,1,Macon,2022-03-19
0,0,0,1,Macon,2022-03-21
0,0,0,1,Macon,2022-03-30
2,0,2,1,Macon,2022-04-13
0,0,0,1,Macon,2022-04-15
2,1,1,1,Macon,2022-05-10
15,2,13,1,Madison,2021-12-23
15,3,12,1,Madison,2021-12-31
7,0,7,1,Madison,2022-01-08
52,3,49,1,Madison,2022-01-14
55,3,52,1,Madison,2022-01-18
34,6,28,1,Madison,2022-01-27
54,12,42,1,Madison,2022-02-01
4,0,4,1,Madison,2022-02-06
18,2,16,1,Madison,2022-02-08
26,4,22,1,Madison,2022-02-11
5,4,1,1,Madison,2022-02-22
0,0,0,1,Madison,2022-02-26
2,2,0,1,Madison,2022-03-09
9,0,9,1,Martin,2022-01-02
54,5,49,1,Martin,2022-01-07
115,5,110,1,Martin,2022-01-18
16,3,13,1,Martin,2022-01-23
87,7,80,1,Martin,2022-01-24
43,2,41,1,Martin,2022-01-26
35,1,34,1,Martin,2022-01-27
7,1,6,1,Martin,2022-02-09
2,0,2,1,Martin,2022-02-12
1,1,0,1,Martin,2022-02-13
1,0,1,1,Martin,2022-02-25
9,2,7,1,Martin,2022-02-26
2,0,2,1,Martin,2022-02-27
3,0,3,1,Martin,2022-02-28
0,0,0,1,Martin,2022-04-26
25,8,17,1,McDowell,2021-12-20
29,8,21,1,McDowell,2022-01-01
120,25,95,1,McDowell,2022-01-03
60,17,43,1,McDowell,2022-01-09
176,52,124,1,McDowell,2022-01-11
131,49,82,1,McDowell,2022-01-13
57,25,32,1,McDowell,2022-01-15
12,7,5,1,McDowell,2022-01-16
98,16,82,1,McDowell,2022-01-18
53,12,41,1,McDowell,2022-01-23
126,34,92,1,McDowell,2022-01-25
82,28,54,1,McDowell,2022-02-01
68,19,49,1,McDowell,2022-02-02
76,21,55,1,McDowell,2022-02-03
52,14,38,1,McDowell,2022-02-04
32,10,22,1,McDowell,2022-02-06
42,11,31,1,McDowell,2022-02-14
33,5,28,1,McDowell,2022-02-16
17,7,10,1,McDowell,2022-02-21
6,1,5,1,McDowell,2022-03-02
8,3,5,1,McDowell,2022-03-03
3,0,3,1,McDowell,2022-03-06
2,0,2,1,McDowell,2022-03-08
0,0,0,1,McDowell,2022-03-22
8,1,7,1,McDowell,2022-05-30
240,30,210,1,Mecklenburg,2021-12-11
1266,234,1032,1,Mecklenburg,2022-01-01
1690,311,1379,1,Mecklenburg,2022-01-09
140,27,113,1,Mecklenburg,2022-02-19
228,41,187,1,Mecklenburg,2022-02-21
182,31,151,1,Mecklenburg,2022-02-22
66,11,55,1,Mecklenburg,2022-02-27
68,11,57,1,Mecklenburg,2022-03-04
47,6,41,1,Mecklenburg,2022-03-05
40,6,34,1,Mecklenburg,2022-03-06
81,13,68,1,Mecklenburg,2022-03-07
54,8,46,1,Mecklenburg,2022-03-11
50,11,39,1,Mecklenburg,2022-03-16
66,13,53,1,Mecklenburg,2022-03-21
46,10,36,1,Mecklenburg,2022-03-24
53,11,42,1,Mecklenburg,2022-03-25
47,6,41,1,Mecklenburg,2022-03-28
93,17,76,1,Mecklenburg,2022-03-29
41,9,32,1,Mecklenburg,2022-04-02
50,12,38,1,Mecklenburg,2022-04-03
124,21,103,1,Mecklenburg,2022-04-08
234,47,187,1,Mecklenburg,2022-04-18
224,37,187,1,Mecklenburg,2022-05-08
453,59,394,1,Mecklenburg,2022-05-11
460,71,389,1,Mecklenburg,2022-05-12
428,64,364,1,Mecklenburg,2022-05-27
601,76,525,1,Mecklenburg,2022-05-31
500,61,439,1,Mecklenburg,2022-06-02
4,3,1,1,Mitchell,2021-12-26
27,15,12,1,Mitchell,2021-12-30
21,12,9,1,Mitchell,2022-01-03
46,3,43,1,Mitchell,2022-01-11
24,4,20,1,Mitchell,2022-01-13
6,4,2,1,Mitchell,2022-01-16
22,3,19,1,Mitchell,2022-01-19
9,1,8,1,Mitchell,2022-01-22
17,5,12,1,Mitchell,2022-01-28
19,9,10,1,Mitchell,2022-02-03
9,8,1,1,Mitchell,2022-02-13
6,3,3,1,Mitchell,2022-02-18
0,0,0,1,Mitchell,2022-03-21
29,8,21,1,Montgomery,2021-12-30
55,3,52,1,Montgomery,2022-01-07
35,6,29,1,Montgomery,2022-01-09
129,21,108,1,Montgomery,2022-01-13
34,6,28,1,Montgomery,2022-01-28
12,2,10,1,Montgomery,2022-01-29
2,0,2,1,Montgomery,2022-01-30
24,6,18,1,Montgomery,2022-02-02
31,9,22,1,Montgomery,2022-02-03
3,1,2,1,Montgomery,2022-02-06
13,0,13,1,Montgomery,2022-02-07
16,1,15,1,Montgomery,2022-02-08
14,1,13,1,Montgomery,2022-02-09
3,1,2,1,Montgomery,2022-02-12
13,0,13,1,Montgomery,2022-02-14
3,1,2,1,Montgomery,2022-02-19
5,0,5,1,Montgomery,2022-05-16
5,2,3,1,Montgomery,2022-05-30
17,1,16,1,Moore,2021-12-08
37,0,37,1,Moore,2021-12-09
31,3,28,1,Moore,2021-12-14
27,2,25,1,Moore,2021-12-18
60,4,56,1,Moore,2021-12-22
78,1,77,1,Moore,2021-12-26
125,6,119,1,Moore,2022-01-02
295,36,259,1,Moore,2022-01-04
441,30,411,1,Moore,2022-01-10
428,69,359,1,Moore,2022-01-18
92,10,82,1,Moore,2022-01-23
318,39,279,1,Moore,2022-01-24
194,36,158,1,Moore,2022-01-25
133,31,102,1,Moore,2022-01-27
129,25,104,1,Moore,2022-02-01
84,13,71,1,Moore,2022-02-03
74,15,59,1,Moore,2022-02-04
55,7,48,1,Moore,2022-02-14
32,4,28,1,Moore,2022-02-16
23,2,21,1,Moore,2022-02-18
15,5,10,1,Moore,2022-02-19
20,2,18,1,Moore,2022-02-23
23,6,17,1,Moore,2022-02-24
14,2,12,1,Moore,2022-03-01
10,1,9,1,Moore,2022-03-03
5,0,5,1,Moore,2022-03-05
4,2,2,1,Moore,2022-03-06
3,1,2,1,Moore,2022-03-10
6,2,4,1,Moore,2022-03-11
4,2,2,1,Moore,2022-04-06
16,6,10,1,Moore,2022-04-28
21,4,17,1,Moore,2022-05-03
30,10,20,1,Moore,2022-05-11
24,2,22,1,Nash,2021-12-10
42,8,34,1,Nash,2021-12-17
53,15,38,1,Nash,2021-12-23
193,27,166,1,Nash,2021-12-27
169,10,159,1,Nash,2021-12-31
598,18,580,1,Nash,2022-01-04
403,26,377,1,Nash,2022-01-06
313,21,292,1,Nash,2022-01-07
108,5,103,1,Nash,2022-01-09
348,31,317,1,Nash,2022-01-13
498,34,464,1,Nash,2022-01-18
59,0,59,1,Nash,2022-01-21
49,8,41,1,Nash,2022-01-23
248,27,221,1,Nash,2022-01-25
135,14,121,1,Nash,2022-01-26
123,11,112,1,Nash,2022-01-27
109,19,90,1,Nash,2022-01-28
38,8,30,1,Nash,2022-01-29
67,14,53,1,Nash,2022-02-04
29,2,27,1,Nash,2022-02-05
69,10,59,1,Nash,2022-02-07
40,8,32,1,Nash,2022-02-08
49,12,37,1,Nash,2022-02-11
14,1,13,1,Nash,2022-02-12
25,4,21,1,Nash,2022-02-16
21,5,16,1,Nash,2022-02-17
14,6,8,1,Nash,2022-02-18
11,3,8,1,Nash,2022-02-19
7,1,6,1,Nash,2022-02-20
13,1,12,1,Nash,2022-02-22
19,4,15,1,Nash,2022-02-23
1,0,1,1,Nash,2022-02-26
5,0,5,1,Nash,2022-03-14
2,0,2,1,Nash,2022-03-22
2,1,1,1,Nash,2022-03-24
3,1,2,1,Nash,2022-04-02
4,0,4,1,Nash,2022-04-06
2,0,2,1,Nash,2022-04-10
5,4,1,1,Nash,2022-04-12
5,2,3,1,Nash,2022-04-16
8,2,6,1,Nash,2022-04-27
25,7,18,1,Nash,2022-05-24
14,5,9,1,Nash,2022-05-30
26,4,22,1,New Hanover,2021-12-25
464,110,354,1,New Hanover,2021-12-28
289,55,234,1,New Hanover,2022-01-09
671,123,548,1,New Hanover,2022-01-13
228,50,178,1,New Hanover,2022-01-21
122,21,101,1,New Hanover,2022-01-22
191,48,143,1,New Hanover,2022-01-23
398,66,332,1,New Hanover,2022-01-26
102,31,71,1,New Hanover,2022-01-30
323,66,257,1,New Hanover,2022-01-31
79,19,60,1,New Hanover,2022-02-05
74,12,62,1,New Hanover,2022-02-06
172,42,130,1,New Hanover,2022-02-07
90,24,66,1,New Hanover,2022-02-09
119,30,89,1,New Hanover,2022-02-10
34,10,24,1,New Hanover,2022-02-13
70,17,53,1,New Hanover,2022-02-15
55,20,35,1,New Hanover,2022-02-17
21,9,12,1,New Hanover,2022-02-20
13,4,9,1,New Hanover,2022-02-26
18,2,16,1,New Hanover,2022-02-28
17,3,14,1,New Hanover,2022-03-02
13,3,10,1,New Hanover,2022-03-03
3,0,3,1,New Hanover,2022-03-05
7,1,6,1,New Hanover,2022-03-08
10,0,10,1,New Hanover,2022-03-10
11,5,6,1,New Hanover,2022-03-11
5,0,5,1,New Hanover,2022-03-12
9,3,6,1,New Hanover,2022-03-17
4,1,3,1,New Hanover,2022-03-18
5,0,5,1,New Hanover,2022-03-21
14,3,11,1,New Hanover,2022-04-06
19,8,11,1,New Hanover,2022-04-07
21,1,20,1,New Hanover,2022-05-01
58,8,50,1,New Hanover,2022-05-25
2,0,2,1,Northampton,2021-12-14
68,19,49,1,Northampton,2022-01-11
8,1,7,1,Northampton,2022-01-21
27,8,19,1,Northampton,2022-01-28
4,0,4,1,Northampton,2022-01-30
21,3,18,1,Northampton,2022-01-31
15,5,10,1,Northampton,2022-02-02
10,4,6,1,Northampton,2022-02-04
3,0,3,1,Northampton,2022-02-12
1,0,1,1,Northampton,2022-02-13
6,0,6,1,Northampton,2022-02-22
0,0,0,1,Northampton,2022-02-27
1,0,1,1,Northampton,2022-03-16
53,10,43,1,Onslow,2021-12-16
53,8,45,1,Onslow,2021-12-26
107,33,74,1,Onslow,2022-01-01
995,113,882,1,Onslow,2022-01-11
179,27,152,1,Onslow,2022-01-21
427,59,368,1,Onslow,2022-01-26
273,31,242,1,Onslow,2022-02-01
261,39,222,1,Onslow,2022-02-07
25,4,21,1,Onslow,2022-02-24
6,1,5,1,Onslow,2022-02-27
15,1,14,1,Onslow,2022-03-05
8,1,7,1,Onslow,2022-03-11
4,1,3,1,Onslow,2022-03-14
3,0,3,1,Onslow,2022-03-16
4,0,4,1,Onslow,2022-03-22
5,1,4,1,Onslow,2022-04-07
6,0,6,1,Onslow,2022-04-30
14,5,9,1,Onslow,2022-05-08
81,10,71,1,Onslow,2022-05-16
37,12,25,1,Onslow,2022-05-21
81,12,69,1,Onslow,2022-05-24
53,2,51,1,Orange,2021-12-17
513,25,488,1,Orange,2022-01-04
132,9,123,1,Orange,2022-01-09
431,30,401,1,Orange,2022-01-14
32,7,25,1,Orange,2022-01-16
120,4,116,1,Orange,2022-01-23
285,12,273,1,Orange,2022-01-25
182,7,175,1,Orange,2022-01-27
55,5,50,1,Orange,2022-01-30
105,3,102,1,Orange,2022-02-04
51,2,49,1,Orange,2022-02-06
72,2,70,1,Orange,2022-02-10
38,3,35,1,Orange,2022-02-12
62,7,55,1,Orange,2022-02-16
42,3,39,1,Orange,2022-02-21
15,2,13,1,Orange,2022-03-03
20,1,19,1,Orange,2022-03-07
8,0,8,1,Orange,2022-03-17
9,0,9,1,Orange,2022-03-19
60,6,54,1,Orange,2022-04-09
24,2,22,1,Pamlico,2022-01-03
16,0,16,1,Pamlico,2022-02-01
0,0,0,1,Pamlico,2022-05-08
45,19,26,1,Pasquotank,2022-01-16
26,7,19,1,Pasquotank,2022-01-21
29,2,27,1,Pasquotank,2022-01-23
90,24,66,1,Pasquotank,2022-01-25
14,1,13,1,Pasquotank,2022-01-30
30,5,25,1,Pasquotank,2022-02-02
34,11,23,1,Pasquotank,2022-02-03
9,1,8,1,Pasquotank,2022-02-05
3,0,3,1,Pasquotank,2022-02-11
0,0,0,1,Pasquotank,2022-03-18
0,0,0,1,Pasquotank,2022-03-20
0,0,0,1,Pasquotank,2022-03-22
8,2,6,1,Pender,2021-12-18
89,15,74,1,Pender,2021-12-27
88,16,72,1,Pender,2022-01-09
221,20,201,1,Pender,2022-01-11
184,23,161,1,Pender,2022-01-14
114,21,93,1,Pender,2022-01-15
63,7,56,1,Pender,2022-01-16
228,42,186,1,Pender,2022-01-17
53,7,46,1,Pender,2022-01-21
165,16,149,1,Pender,2022-01-25
121,13,108,1,Pender,2022-01-26
35,0,35,1,Pender,2022-01-29
116,10,106,1,Pender,2022-01-31
60,9,51,1,Pender,2022-02-03
55,6,49,1,Pender,2022-02-04
18,0,18,1,Pender,2022-02-06
35,6,29,1,Pender,2022-02-09
29,7,22,1,Pender,2022-02-14
9,5,4,1,Pender,2022-02-19
7,1,6,1,Pender,2022-02-25
17,4,13,1,Pender,2022-05-17
15,2,13,1,Pender,2022-05-27
6,0,6,1,Perquimans,2021-12-09
32,16,16,1,Perquimans,2022-01-07
45,7,38,1,Perquimans,2022-01-18
3,1,2,1,Perquimans,2022-02-04
0,0,0,1,Perquimans,2022-02-16
0,0,0,1,Perquimans,2022-03-21
5,3,2,1,Person,2021-12-12
18,7,11,1,Person,2021-12-17
5,1,4,1,Person,2021-12-19
76,21,55,1,Person,2021-12-30
184,32,152,1,Person,2022-01-18
110,23,87,1,Person,2022-01-20
20,5,15,1,Person,2022-01-29
48,18,30,1,Person,2022-02-01
39,11,28,1,Person,2022-02-03
14,2,12,1,Person,2022-02-09
6,2,4,1,Person,2022-02-19
6,1,5,1,Person,2022-02-21
5,3,2,1,Person,2022-02-24
1,1,0,1,Person,2022-03-16
822,74,748,1,Pitt,2022-01-14
669,77,592,1,Pitt,2022-01-17
56,1,55,1,Pitt,2022-01-22
287,26,261,1,Pitt,2022-01-28
313,32,281,1,Pitt,2022-01-31
175,12,163,1,Pitt,2022-02-02
159,15,144,1,Pitt,2022-02-03
146,11,135,1,Pitt,2022-02-07
95,10,85,1,Pitt,2022-02-09
63,7,56,1,Pitt,2022-02-11
69,6,63,1,Pitt,2022-02-14
42,7,35,1,Pitt,2022-02-16
43,3,40,1,Pitt,2022-02-18
22,3,19,1,Pitt,2022-02-23
20,1,19,1,Pitt,2022-02-25
11,1,10,1,Pitt,2022-03-02
15,2,13,1,Pitt,2022-03-04
5,2,3,1,Pitt,2022-03-05
3,1,2,1,Pitt,2022-03-06
4,2,2,1,Pitt,2022-03-08
4,0,4,1,Pitt,2022-03-14
2,0,2,1,Pitt,2022-03-16
9,1,8,1,Pitt,2022-03-17
3,0,3,1,Pitt,2022-03-19
4,0,4,1,Pitt,2022-03-25
11,0,11,1,Pitt,2022-04-15
59,28,31,1,Polk,2022-01-11
18,17,1,1,Polk,2022-01-17
12,5,7,1,Polk,2022-01-30
17,12,5,1,Polk,2022-02-03
12,5,7,1,Polk,2022-02-04
22,14,8,1,Polk,2022-02-08
11,4,7,1,Polk,2022-02-09
7,4,3,1,Polk,2022-02-17
2,1,1,1,Polk,2022-02-20
0,0,0,1,Polk,2022-03-03
0,0,0,1,Polk,2022-03-08
1,0,1,1,Polk,2022-03-14
0,0,0,1,Polk,2022-04-11
0,0,0,1,Polk,2022-04-19
62,29,33,1,Randolph,2021-12-16
59,22,37,1,Randolph,2021-12-17
98,45,53,1,Randolph,2021-12-20
66,24,42,1,Randolph,2021-12-22
47,23,24,1,Randolph,2021-12-24
231,96,135,1,Randolph,2021-12-29
81,31,50,1,Randolph,2022-01-01
321,114,207,1,Randolph,2022-01-03
285,89,196,1,Randolph,2022-01-07
162,19,143,1,Randolph,2022-01-08
182,34,148,1,Randolph,2022-01-09
580,144,436,1,Randolph,2022-01-10
613,148,465,1,Randolph,2022-01-18
630,145,485,1,Randolph,2022-01-19
76,24,52,1,Randolph,2022-01-22
249,83,166,1,Randolph,2022-01-27
169,59,110,1,Randolph,2022-01-28
60,16,44,1,Randolph,2022-01-29
136,46,90,1,Randolph,2022-02-02
136,32,104,1,Randolph,2022-02-03
116,40,76,1,Randolph,2022-02-07
94,22,72,1,Randolph,2022-02-08
66,16,50,1,Randolph,2022-02-10
57,15,42,1,Randolph,2022-02-11
62,15,47,1,Randolph,2022-02-15
20,11,9,1,Randolph,2022-02-19
25,5,20,1,Randolph,2022-02-22
8,1,7,1,Randolph,2022-02-26
14,9,5,1,Randolph,2022-03-02
16,6,10,1,Randolph,2022-03-03
5,1,4,1,Randolph,2022-03-08
7,0,7,1,Randolph,2022-03-11
5,1,4,1,Randolph,2022-03-16
5,0,5,1,Randolph,2022-03-20
4,2,2,1,Randolph,2022-04-12
4,1,3,1,Randolph,2022-04-15
15,5,10,1,Randolph,2022-04-19
28,15,13,1,Randolph,2022-05-02
20,10,10,1,Randolph,2022-05-15
41,18,23,1,Randolph,2022-05-31
33,10,23,1,Randolph,2022-06-03
14,2,12,1,Richmond,2021-12-16
9,3,6,1,Richmond,2021-12-19
20,3,17,1,Richmond,2021-12-23
23,5,18,1,Richmond,2021-12-24
6,1,5,1,Richmond,2021-12-25
51,4,47,1,Richmond,2021-12-27
44,3,41,1,Richmond,2022-01-02
184,31,153,1,Richmond,2022-01-05
94,10,84,1,Richmond,2022-01-09
193,15,178,1,Richmond,2022-01-14
36,4,32,1,Richmond,2022-01-21
118,31,87,1,Richmond,2022-01-25
144,80,64,1,Richmond,2022-01-26
80,29,51,1,Richmond,2022-01-27
45,21,24,1,Richmond,2022-02-02
24,6,18,1,Richmond,2022-02-03
32,4,28,1,Richmond,2022-02-04
15,3,12,1,Richmond,2022-02-08
12,1,11,1,Richmond,2022-02-11
5,0,5,1,Richmond,2022-02-13
10,1,9,1,Richmond,2022-02-15
11,2,9,1,Richmond,2022-02-23
8,0,8,1,Richmond,2022-02-25
0,0,0,1,Richmond,2022-02-27
3,0,3,1,Richmond,2022-03-04
4,1,3,1,Richmond,2022-03-05
62,17,45,1,Robeson,2021-12-09
19,6,13,1,Robeson,2021-12-11
17,10,7,1,Robeson,2021-12-12
66,20,46,1,Robeson,2021-12-23
33,21,12,1,Robeson,2021-12-24
25,10,15,1,Robeson,2021-12-25
176,49,127,1,Robeson,2021-12-27
334,96,238,1,Robeson,2021-12-29
297,91,206,1,Robeson,2021-12-30
120,48,72,1,Robeson,2021-12-31
528,194,334,1,Robeson,2022-01-14
548,229,319,1,Robeson,2022-01-17
856,302,554,1,Robeson,2022-01-18
629,206,423,1,Robeson,2022-01-19
357,113,244,1,Robeson,2022-01-25
242,99,143,1,Robeson,2022-01-26
109,37,72,1,Robeson,2022-02-02
125,54,71,1,Robeson,2022-02-03
90,33,57,1,Robeson,2022-02-04
35,19,16,1,Robeson,2022-02-06
58,18,40,1,Robeson,2022-02-10
21,6,15,1,Robeson,2022-02-13
14,5,9,1,Robeson,2022-02-20
19,3,16,1,Robeson,2022-02-24
8,4,4,1,Robeson,2022-02-27
7,3,4,1,Robeson,2022-03-09
6,1,5,1,Robeson,2022-03-28
6,4,2,1,Robeson,2022-04-13
9,5,4,1,Robeson,2022-05-07
48,11,37,1,Rockingham,2021-12-09
21,4,17,1,Rockingham,2021-12-18
27,3,24,1,Rockingham,2021-12-24
38,4,34,1,Rockingham,2021-12-26
214,50,164,1,Rockingham,2021-12-30
133,42,91,1,Rockingham,2021-12-31
54,6,48,1,Rockingham,2022-01-01
258,50,208,1,Rockingham,2022-01-07
104,13,91,1,Rockingham,2022-01-09
346,30,316,1,Rockingham,2022-01-10
273,29,244,1,Rockingham,2022-01-13
324,50,274,1,Rockingham,2022-01-14
149,26,123,1,Rockingham,2022-01-15
269,63,206,1,Rockingham,2022-01-18
343,64,279,1,Rockingham,2022-01-19
94,9,85,1,Rockingham,2022-01-23
195,35,160,1,Rockingham,2022-01-25
177,27,150,1,Rockingham,2022-01-26
159,24,135,1,Rockingham,2022-01-27
114,8,106,1,Rockingham,2022-01-28
24,2,22,1,Rockingham,2022-02-05
81,8,73,1,Rockingham,2022-02-07
49,5,44,1,Rockingham,2022-02-08
64,9,55,1,Rockingham,2022-02-09
44,7,37,1,Rockingham,2022-02-11
57,10,47,1,Rockingham,2022-02-14
28,5,23,1,Rockingham,2022-02-15
32,2,30,1,Rockingham,2022-02-16
16,3,13,1,Rockingham,2022-02-18
7,1,6,1,Rockingham,2022-02-20
27,6,21,1,Rockingham,2022-02-21
10,1,9,1,Rockingham,2022-03-04
0,0,0,1,Rockingham,2022-03-12
2,0,2,1,Rockingham,2022-03-26
1,0,1,1,Rockingham,2022-04-13
48,7,41,1,Rowan,2021-12-07
119,11,108,1,Rowan,2021-12-20
79,19,60,1,Rowan,2021-12-22
49,9,40,1,Rowan,2021-12-24
29,8,21,1,Rowan,2021-12-25
64,3,61,1,Rowan,2021-12-26
147,20,127,1,Rowan,2021-12-31
348,56,292,1,Rowan,2022-01-07
125,31,94,1,Rowan,2022-01-09
654,116,538,1,Rowan,2022-01-10
579,84,495,1,Rowan,2022-01-13
34,6,28,1,Rowan,2022-01-16
169,59,110,1,Rowan,2022-01-17
482,100,382,1,Rowan,2022-01-18
446,72,374,1,Rowan,2022-01-20
226,43,183,1,Rowan,2022-01-27
228,24,204,1,Rowan,2022-01-28
68,10,58,1,Rowan,2022-01-30
145,21,124,1,Rowan,2022-02-02
44,4,40,1,Rowan,2022-02-05
47,11,36,1,Rowan,2022-02-06
120,24,96,1,Rowan,2022-02-07
103,10,93,1,Rowan,2022-02-08
83,7,76,1,Rowan,2022-02-09
26,3,23,1,Rowan,2022-02-12
32,6,26,1,Rowan,2022-02-13
32,4,28,1,Rowan,2022-02-18
18,5,13,1,Rowan,2022-02-23
13,2,11,1,Rowan,2022-02-25
7,0,7,1,Rowan,2022-02-27
12,5,7,1,Rowan,2022-03-07
14,5,9,1,Rowan,2022-03-08
9,1,8,1,Rowan,2022-03-09
4,0,4,1,Rowan,2022-03-11
10,3,7,1,Rowan,2022-03-15
5,1,4,1,Rowan,2022-03-29
6,0,6,1,Rowan,2022-04-30
26,7,19,1,Rowan,2022-05-08
31,4,27,1,Rowan,2022-06-03
10,0,10,1,Rutherford,2021-12-19
142,35,107,1,Rutherford,2022-01-05
203,112,91,1,Rutherford,2022-01-13
168,75,93,1,Rutherford,2022-01-14
84,41,43,1,Rutherford,2022-01-15
187,60,127,1,Rutherford,2022-01-18
69,34,35,1,Rutherford,2022-01-22
57,18,39,1,Rutherford,2022-01-23
93,32,61,1,Rutherford,2022-01-28
44,18,26,1,Rutherford,2022-01-29
21,9,12,1,Rutherford,2022-02-05
59,28,31,1,Rutherford,2022-02-08
26,5,21,1,Rutherford,2022-02-11
6,1,5,1,Rutherford,2022-02-12
26,12,14,1,Rutherford,2022-02-14
26,15,11,1,Rutherford,2022-02-15
16,5,11,1,Rutherford,2022-02-17
12,3,9,1,Rutherford,2022-02-18
10,2,8,1,Rutherford,2022-02-19
7,3,4,1,Rutherford,2022-02-23
14,4,10,1,Rutherford,2022-02-24
9,3,6,1,Rutherford,2022-03-01
0,0,0,1,Rutherford,2022-03-15
4,1,3,1,Rutherford,2022-04-26
7,0,7,1,Rutherford,2022-05-02
10,3,7,1,Rutherford,2022-05-10
8,1,7,1,Rutherford,2022-05-11
58,29,29,1,Sampson,2021-12-27
276,141,135,1,Sampson,2022-01-04
264,94,170,1,Sampson,2022-01-05
98,35,63,1,Sampson,2022-01-08
257,70,187,1,Sampson,2022-01-17
414,92,322,1,Sampson,2022-01-18
279,76,203,1,Sampson,2022-01-19
268,95,173,1,Sampson,2022-01-20
15,6,9,1,Sampson,2022-01-29
24,10,14,1,Sampson,2022-01-30
103,36,67,1,Sampson,2022-01-31
59,18,41,1,Sampson,2022-02-02
51,19,32,1,Sampson,2022-02-03
14,6,8,1,Sampson,2022-02-05
55,23,32,1,Sampson,2022-02-07
28,11,17,1,Sampson,2022-02-11
7,4,3,1,Sampson,2022-02-13
35,14,21,1,Sampson,2022-02-14
20,6,14,1,Sampson,2022-02-17
11,2,9,1,Sampson,2022-02-18
13,8,5,1,Sampson,2022-02-24
9,4,5,1,Sampson,2022-03-03
2,2,0,1,Sampson,2022-03-06
4,1,3,1,Sampson,2022-03-07
0,0,0,1,Sampson,2022-03-20
0,0,0,1,Sampson,2022-04-09
2,2,0,1,Sampson,2022-04-16
87,21,66,1,Scotland,2021-12-29
159,40,119,1,Scotland,2022-01-04
148,41,107,1,Scotland,2022-01-07
24,6,18,1,Scotland,2022-01-21
8,2,6,1,Scotland,2022-01-22
38,11,27,1,Scotland,2022-01-28
5,3,2,1,Scotland,2022-01-29
25,15,10,1,Scotland,2022-02-02
19,6,13,1,Scotland,2022-02-04
8,3,5,1,Scotland,2022-02-06
11,5,6,1,Scotland,2022-02-10
5,2,3,1,Scotland,2022-02-12
19,5,14,1,Scotland,2022-02-14
2,2,0,1,Scotland,2022-03-03
37,5,32,1,Stanly,2021-12-14
28,3,25,1,Stanly,2021-12-15
60,22,38,1,Stanly,2021-12-31
59,21,38,1,Stanly,2022-01-02
173,52,121,1,Stanly,2022-01-04
214,64,150,1,Stanly,2022-01-05
188,63,125,1,Stanly,2022-01-07
387,108,279,1,Stanly,2022-01-10
323,51,272,1,Stanly,2022-01-18
134,21,113,1,Stanly,2022-01-21
32,5,27,1,Stanly,2022-01-22
154,30,124,1,Stanly,2022-01-25
181,31,150,1,Stanly,2022-01-26
114,9,105,1,Stanly,2022-01-27
42,23,19,1,Stanly,2022-01-30
45,3,42,1,Stanly,2022-02-02
17,2,15,1,Stanly,2022-02-05
43,1,42,1,Stanly,2022-02-08
45,3,42,1,Stanly,2022-02-09
37,2,35,1,Stanly,2022-02-10
35,2,33,1,Stanly,2022-02-11
22,1,21,1,Stanly,2022-02-15
12,4,8,1,Stanly,2022-02-17
4,0,4,1,Stanly,2022-02-19
0,0,0,1,Stanly,2022-02-27
3,0,3,1,Stanly,2022-02-28
3,0,3,1,Stanly,2022-03-03
2,0,2,1,Stanly,2022-03-05
2,0,2,1,Stanly,2022-03-15
1,0,1,1,Stanly,2022-03-16
1,0,1,1,Stanly,2022-03-23
0,0,0,1,Stanly,2022-03-24
1,0,1,1,Stanly,2022-03-29
3,0,3,1,Stanly,2022-03-30
10,0,10,1,Stanly,2022-05-11
25,4,21,1,Stanly,2022-05-16
32,2,30,1,Stokes,2021-12-13
36,5,31,1,Stokes,2021-12-22
126,23,103,1,Stokes,2022-01-04
48,8,40,1,Stokes,2022-01-08
186,50,136,1,Stokes,2022-01-10
107,28,79,1,Stokes,2022-01-14
73,10,63,1,Stokes,2022-01-15
30,13,17,1,Stokes,2022-01-17
90,19,71,1,Stokes,2022-01-21
84,16,68,1,Stokes,2022-01-26
63,4,59,1,Stokes,2022-01-28
12,3,9,1,Stokes,2022-01-30
36,6,30,1,Stokes,2022-02-04
38,6,32,1,Stokes,2022-02-07
23,3,20,1,Stokes,2022-02-11
26,2,24,1,Stokes,2022-02-15
13,2,11,1,Stokes,2022-02-16
20,3,17,1,Stokes,2022-02-21
20,4,16,1,Stokes,2022-02-22
13,2,11,1,Stokes,2022-02-24
6,1,5,1,Stokes,2022-03-01
5,4,1,1,Stokes,2022-03-03
3,0,3,1,Stokes,2022-03-11
1,0,1,1,Stokes,2022-04-02
0,0,0,1,Stokes,2022-04-10
2,1,1,1,Stokes,2022-05-01
57,25,32,1,Surry,2021-12-08
47,21,26,1,Surry,2021-12-10
61,25,36,1,Surry,2021-12-13
46,14,32,1,Surry,2021-12-17
27,8,19,1,Surry,2021-12-19
72,26,46,1,Surry,2021-12-20
62,23,39,1,Surry,2021-12-22
149,55,94,1,Surry,2021-12-30
54,27,27,1,Surry,2022-01-01
160,60,100,1,Surry,2022-01-06
108,21,87,1,Surry,2022-01-09
253,72,181,1,Surry,2022-01-13
102,50,52,1,Surry,2022-01-17
208,67,141,1,Surry,2022-01-18
158,56,102,1,Surry,2022-01-21
157,53,104,1,Surry,2022-01-25
133,39,94,1,Surry,2022-01-26
120,45,75,1,Surry,2022-01-27
116,44,72,1,Surry,2022-01-28
38,9,29,1,Surry,2022-02-05
27,9,18,1,Surry,2022-02-18
16,5,11,1,Surry,2022-02-20
15,7,8,1,Surry,2022-03-02
3,2,1,1,Surry,2022-03-11
2,0,2,1,Surry,2022-03-20
2,2,0,1,Surry,2022-03-22
3,1,2,1,Surry,2022-04-07
3,0,3,1,Surry,2022-04-23
36,13,23,1,Surry,2022-05-24
26,13,13,1,Swain,2021-12-27
17,12,5,1,Swain,2022-01-01
17,10,7,1,Swain,2022-01-08
35,8,27,1,Swain,2022-01-14
16,7,9,1,Swain,2022-01-28
13,6,7,1,Swain,2022-01-30
6,2,4,1,Swain,2022-02-06
10,5,5,1,Swain,2022-02-14
2,0,2,1,Swain,2022-03-07
0,0,0,1,Swain,2022-03-08
1,0,1,1,Swain,2022-04-23
10,2,8,1,Swain,2022-05-20
19,11,8,1,Transylvania,2021-12-17
30,6,24,1,Transylvania,2021-12-27
36,15,21,1,Transylvania,2021-12-30
23,17,6,1,Transylvania,2022-01-02
42,15,27,1,Transylvania,2022-01-07
64,28,36,1,Transylvania,2022-01-12
53,15,38,1,Transylvania,2022-01-13
15,7,8,1,Transylvania,2022-01-17
36,22,14,1,Transylvania,2022-01-18
40,13,27,1,Transylvania,2022-01-19
23,14,9,1,Transylvania,2022-01-22
17,6,11,1,Transylvania,2022-02-07
13,6,7,1,Transylvania,2022-02-08
20,3,17,1,Transylvania,2022-02-09
8,5,3,1,Transylvania,2022-02-17
9,4,5,1,Transylvania,2022-02-23
0,0,0,1,Transylvania,2022-02-27
2,0,2,1,Transylvania,2022-03-02
3,2,1,1,Transylvania,2022-03-03
0,0,0,1,Transylvania,2022-03-21
2,0,2,1,Transylvania,2022-05-02
1,0,1,1,Tyrrell,2022-02-09
51,6,45,1,Union,2021-12-12
118,29,89,1,Union,2021-12-13
105,30,75,1,Union,2021-12-15
90,18,72,1,Union,2021-12-16
68,10,58,1,Union,2021-12-19
172,25,147,1,Union,2021-12-21
108,11,97,1,Union,2021-12-24
127,18,109,1,Union,2021-12-26
375,71,304,1,Union,2021-12-27
535,112,423,1,Union,2021-12-30
674,123,551,1,Union,2022-01-05
985,217,768,1,Union,2022-01-10
895,193,702,1,Union,2022-01-18
226,64,162,1,Union,2022-01-23
483,96,387,1,Union,2022-01-25
413,99,314,1,Union,2022-01-26
337,58,279,1,Union,2022-01-27
255,52,203,1,Union,2022-02-01
92,17,75,1,Union,2022-02-05
143,35,108,1,Union,2022-02-08
73,26,47,1,Union,2022-02-15
61,12,49,1,Union,2022-02-17
35,11,24,1,Union,2022-02-19
32,10,22,1,Union,2022-02-22
18,4,14,1,Union,2022-02-24
14,4,10,1,Union,2022-02-26
12,4,8,1,Union,2022-02-27
24,5,19,1,Union,2022-03-02
9,2,7,1,Union,2022-03-05
10,2,8,1,Union,2022-03-07
3,1,2,1,Union,2022-03-13
9,3,6,1,Union,2022-03-21
8,1,7,1,Union,2022-03-31
22,2,20,1,Union,2022-04-07
18,4,14,1,Union,2022-04-15
10,0,10,1,Union,2022-04-17
73,20,53,1,Union,2022-05-04
118,21,97,1,Union,2022-05-19
110,20,90,1,Union,2022-06-01
156,74,82,1,Vance,2022-01-03
133,24,109,1,Vance,2022-01-04
158,10,148,1,Vance,2022-01-13
35,4,31,1,Vance,2022-01-23
92,10,82,1,Vance,2022-01-25
60,6,54,1,Vance,2022-01-27
62,8,54,1,Vance,2022-01-31
26,1,25,1,Vance,2022-02-03
25,3,22,1,Vance,2022-02-04
9,2,7,1,Vance,2022-02-15
1,0,1,1,Vance,2022-03-14
365,37,328,1,Wake,2021-12-08
297,25,272,1,Wake,2021-12-09
429,45,384,1,Wake,2021-12-14
510,50,460,1,Wake,2021-12-17
1432,123,1309,1,Wake,2021-12-23
649,114,535,1,Wake,2021-12-24
3642,212,3430,1,Wake,2021-12-27
1825,71,1754,1,Wake,2022-01-01
1324,133,1191,1,Wake,2022-01-02
5115,352,4763,1,Wake,2022-01-03
4874,199,4675,1,Wake,2022-01-07
1315,117,1198,1,Wake,2022-01-09
6507,352,6155,1,Wake,2022-01-10
5900,316,5584,1,Wake,2022-01-11
1458,122,1336,1,Wake,2022-02-01
799,87,712,1,Wake,2022-02-09
611,51,560,1,Wake,2022-02-14
213,17,196,1,Wake,2022-02-25
99,14,85,1,Wake,2022-03-04
59,7,52,1,Wake,2022-03-11
28,7,21,1,Wake,2022-03-13
68,7,61,1,Wake,2022-03-15
80,5,75,1,Wake,2022-03-16
31,3,28,1,Wake,2022-03-19
92,15,77,1,Wake,2022-03-24
77,5,72,1,Wake,2022-03-25
29,6,23,1,Wake,2022-03-27
100,9,91,1,Wake,2022-03-30
89,13,76,1,Wake,2022-03-31
58,2,56,1,Wake,2022-04-02
147,13,134,1,Wake,2022-04-04
134,8,126,1,Wake,2022-04-09
175,23,152,1,Wake,2022-04-15
305,39,266,1,Wake,2022-04-22
190,37,153,1,Wake,2022-04-24
380,42,338,1,Wake,2022-04-28
200,28,172,1,Wake,2022-05-01
579,69,510,1,Wake,2022-05-05
533,43,490,1,Wake,2022-05-07
354,59,295,1,Wake,2022-05-08
445,68,377,1,Wake,2022-05-15
1152,123,1029,1,Wake,2022-05-16
1081,133,948,1,Wake,2022-05-17
385,62,323,1,Wake,2022-05-22
7,1,6,1,Warren,2021-12-16
83,20,63,1,Warren,2022-01-10
18,3,15,1,Warren,2022-01-23
21,6,15,1,Warren,2022-01-27
26,4,22,1,Warren,2022-01-28
2,0,2,1,Warren,2022-02-12
2,1,1,1,Warren,2022-02-13
0,0,0,1,Warren,2022-03-07
1,1,0,1,Warren,2022-04-08
2,0,2,1,Washington,2021-12-26
44,7,37,1,Washington,2022-01-17
18,13,5,1,Washington,2022-01-28
24,11,13,1,Washington,2022-01-31
18,7,11,1,Washington,2022-02-02
4,1,3,1,Washington,2022-02-05
4,0,4,1,Washington,2022-02-06
8,3,5,1,Washington,2022-02-11
0,0,0,1,Washington,2022-02-19
1,0,1,1,Washington,2022-02-21
2,0,2,1,Washington,2022-03-01
3,2,1,1,Washington,2022-05-16
73,42,31,1,Watauga,2022-01-07
197,65,132,1,Watauga,2022-01-11
148,53,95,1,Watauga,2022-01-13
160,70,90,1,Watauga,2022-01-21
101,40,61,1,Watauga,2022-02-02
72,34,38,1,Watauga,2022-02-03
90,52,38,1,Watauga,2022-02-07
41,20,21,1,Watauga,2022-02-10
35,19,16,1,Watauga,2022-02-15
18,10,8,1,Watauga,2022-02-23
19,1,18,1,Watauga,2022-02-25
13,5,8,1,Watauga,2022-03-01
9,1,8,1,Watauga,2022-03-04
6,4,2,1,Watauga,2022-03-06
3,2,1,1,Watauga,2022-03-13
0,0,0,1,Watauga,2022-03-25
5,2,3,1,Watauga,2022-03-28
31,18,13,1,Wayne,2021-12-16
33,15,18,1,Wayne,2021-12-24
117,58,59,1,Wayne,2021-12-27
114,52,62,1,Wayne,2021-12-31
333,125,208,1,Wayne,2022-01-03
408,222,186,1,Wayne,2022-01-05
163,44,119,1,Wayne,2022-01-09
630,290,340,1,Wayne,2022-01-12
485,215,270,1,Wayne,2022-01-13
561,283,278,1,Wayne,2022-01-14
423,208,215,1,Wayne,2022-01-17
712,295,417,1,Wayne,2022-01-18
102,14,88,1,Wayne,2022-01-23
42,1,41,1,Wayne,2022-01-29
152,70,82,1,Wayne,2022-02-01
107,55,52,1,Wayne,2022-02-02
88,44,44,1,Wayne,2022-02-03
31,7,24,1,Wayne,2022-02-05
32,4,28,1,Wayne,2022-02-06
53,17,36,1,Wayne,2022-02-11
54,31,23,1,Wayne,2022-02-14
43,23,20,1,Wayne,2022-02-15
36,23,13,1,Wayne,2022-02-16
5,1,4,1,Wayne,2022-02-20
10,7,3,1,Wayne,2022-03-02
8,2,6,1,Wayne,2022-03-04
3,1,2,1,Wayne,2022-03-06
18,8,10,1,Wayne,2022-03-07
12,3,9,1,Wayne,2022-03-08
8,4,4,1,Wayne,2022-03-09
7,4,3,1,Wayne,2022-03-10
3,1,2,1,Wayne,2022-03-12
8,3,5,1,Wayne,2022-03-15
12,3,9,1,Wayne,2022-03-17
3,2,1,1,Wayne,2022-03-21
3,2,1,1,Wayne,2022-03-25
1,1,0,1,Wayne,2022-03-27
3,0,3,1,Wayne,2022-04-10
7,2,5,1,Wayne,2022-04-24
18,11,7,1,Wayne,2022-04-25
11,5,6,1,Wayne,2022-04-27
10,6,4,1,Wayne,2022-05-08
11,7,4,1,Wilkes,2021-12-12
39,10,29,1,Wilkes,2021-12-22
48,16,32,1,Wilkes,2021-12-23
28,15,13,1,Wilkes,2021-12-26
102,32,70,1,Wilkes,2021-12-27
63,41,22,1,Wilkes,2022-01-02
148,71,77,1,Wilkes,2022-01-04
94,32,62,1,Wilkes,2022-01-08
63,35,28,1,Wilkes,2022-01-09
213,79,134,1,Wilkes,2022-01-11
50,7,43,1,Wilkes,2022-01-17
180,61,119,1,Wilkes,2022-01-21
91,29,62,1,Wilkes,2022-01-22
130,30,100,1,Wilkes,2022-01-26
111,54,57,1,Wilkes,2022-01-28
48,19,29,1,Wilkes,2022-01-29
122,43,79,1,Wilkes,2022-01-31
111,42,69,1,Wilkes,2022-02-01
30,22,8,1,Wilkes,2022-02-06
64,24,40,1,Wilkes,2022-02-09
20,5,15,1,Wilkes,2022-02-12
26,12,14,1,Wilkes,2022-02-23
28,9,19,1,Wilkes,2022-02-28
10,1,9,1,Wilkes,2022-03-07
4,2,2,1,Wilkes,2022-03-10
2,0,2,1,Wilkes,2022-03-15
2,1,1,1,Wilkes,2022-03-16
2,0,2,1,Wilkes,2022-03-25
1,1,0,1,Wilkes,2022-04-13
0,0,0,1,Wilkes,2022-04-15
9,1,8,1,Wilkes,2022-05-03
19,7,12,1,Wilkes,2022-05-17
37,23,14,1,Wilkes,2022-05-31
38,8,30,1,Wilson,2021-12-22
29,10,19,1,Wilson,2021-12-23
249,46,203,1,Wilson,2021-12-30
46,18,28,1,Wilson,2022-01-01
67,20,47,1,Wilson,2022-01-02
419,66,353,1,Wilson,2022-01-05
350,64,286,1,Wilson,2022-01-06
93,37,56,1,Wilson,2022-01-09
305,73,232,1,Wilson,2022-01-11
301,65,236,1,Wilson,2022-01-13
278,59,219,1,Wilson,2022-01-14
81,18,63,1,Wilson,2022-01-15
52,10,42,1,Wilson,2022-01-21
60,19,41,1,Wilson,2022-01-23
258,80,178,1,Wilson,2022-01-24
73,12,61,1,Wilson,2022-02-02
16,6,10,1,Wilson,2022-02-05
20,3,17,1,Wilson,2022-02-06
43,18,25,1,Wilson,2022-02-07
16,1,15,1,Wilson,2022-02-11
26,6,20,1,Wilson,2022-02-14
30,5,25,1,Wilson,2022-02-15
12,2,10,1,Wilson,2022-02-18
14,5,9,1,Wilson,2022-02-21
9,6,3,1,Wilson,2022-02-24
7,0,7,1,Wilson,2022-02-25
3,0,3,1,Wilson,2022-02-26
5,2,3,1,Wilson,2022-03-04
0,0,0,1,Wilson,2022-03-05
6,4,2,1,Wilson,2022-03-07
1,1,0,1,Wilson,2022-03-13
3,1,2,1,Wilson,2022-03-19
0,0,0,1,Wilson,2022-03-20
1,0,1,1,Wilson,2022-03-28
1,1,0,1,Wilson,2022-04-05
9,3,6,1,Wilson,2022-05-15
15,6,9,1,Wilson,2022-05-21
31,14,17,1,Wilson,2022-05-23
10,3,7,1,Wilson,2022-05-29
36,12,24,1,Yadkin,2021-12-09
45,17,28,1,Yadkin,2021-12-20
45,13,32,1,Yadkin,2021-12-23
34,17,17,1,Yadkin,2021-12-26
99,36,63,1,Yadkin,2021-12-27
113,33,80,1,Yadkin,2021-12-30
28,6,22,1,Yadkin,2022-01-17
48,19,29,1,Yadkin,2022-01-23
113,27,86,1,Yadkin,2022-01-25
60,17,43,1,Yadkin,2022-01-27
45,12,33,1,Yadkin,2022-01-28
55,17,38,1,Yadkin,2022-01-31
21,9,12,1,Yadkin,2022-02-14
20,1,19,1,Yadkin,2022-02-15
10,3,7,1,Yadkin,2022-02-17
11,2,9,1,Yadkin,2022-02-21
3,0,3,1,Yadkin,2022-03-08
1,1,0,1,Yadkin,2022-03-10
1,1,0,1,Yadkin,2022-03-14
2,1,1,1,Yadkin,2022-03-16
3,0,3,1,Yadkin,2022-04-01
2,0,2,1,Yadkin,2022-04-15
19,14,5,1,Yancey,2021-12-22
12,10,2,1,Yancey,2021-12-24
12,8,4,1,Yancey,2021-12-31
16,7,9,1,Yancey,2022-01-01
34,20,14,1,Yancey,2022-01-04
77,14,63,1,Yancey,2022-01-05
4,2,2,1,Yancey,2022-01-09
86,33,53,1,Yancey,2022-01-10
50,16,34,1,Yancey,2022-01-14
7,6,1,1,Yancey,2022-01-16
89,21,68,1,Yancey,2022-01-19
44,12,32,1,Yancey,2022-01-21
21,19,2,1,Yancey,2022-01-23
73,22,51,1,Yancey,2022-01-24
34,18,16,1,Yancey,2022-01-25
26,11,15,1,Yancey,2022-01-27
9,6,3,1,Yancey,2022-02-12
4,0,4,1,Yancey,2022-03-01
631,80,551,2,Alamance,2022-01-07
861,87,774,2,Alamance,2022-01-10
29,3,26,2,Alamance,2022-01-16
269,34,235,2,Alamance,2022-01-21
319,31,288,2,Alamance,2022-01-26
86,9,77,2,Alamance,2022-01-29
165,28,137,2,Alamance,2022-02-01
82,9,73,2,Alamance,2022-02-11
47,7,40,2,Alamance,2022-02-17
36,5,31,2,Alamance,2022-02-19
43,9,34,2,Alamance,2022-02-22
23,7,16,2,Alamance,2022-04-06
111,24,87,2,Alexander,2022-01-24
5,1,4,2,Alexander,2022-02-26
2,1,1,2,Alexander,2022-02-27
2,1,1,2,Alexander,2022-03-10
30,13,17,2,Alleghany,2022-02-01
71,17,54,2,Ashe,2022-01-25
216,30,186,2,Beaufort,2022-01-14
119,43,76,2,Beaufort,2022-01-17
111,20,91,2,Beaufort,2022-01-25
46,2,44,2,Bertie,2022-01-07
118,43,75,2,Bladen,2022-01-17
196,46,150,2,Bladen,2022-01-18
73,22,51,2,Bladen,2022-01-26
15,3,12,2,Bladen,2022-02-17
438,61,377,2,Brunswick,2022-01-12
165,24,141,2,Brunswick,2022-01-15
398,65,333,2,Brunswick,2022-01-20
120,17,103,2,Brunswick,2022-01-23
183,23,160,2,Brunswick,2022-02-01
142,15,127,2,Brunswick,2022-02-03
93,15,78,2,Brunswick,2022-02-08
36,4,32,2,Brunswick,2022-02-21
16,3,13,2,Brunswick,2022-03-01
2,0,2,2,Brunswick,2022-03-06
22,3,19,2,Brunswick,2022-03-07
141,27,114,2,Buncombe,2021-12-20
39,7,32,2,Buncombe,2021-12-25
364,73,291,2,Buncombe,2021-12-27
313,72,241,2,Buncombe,2021-12-31
843,290,553,2,Buncombe,2022-01-10
53,7,46,2,Buncombe,2022-01-16
460,115,345,2,Buncombe,2022-01-21
279,76,203,2,Buncombe,2022-01-28
138,24,114,2,Buncombe,2022-01-30
90,35,55,2,Buncombe,2022-02-18
43,10,33,2,Buncombe,2022-02-19
69,26,43,2,Buncombe,2022-02-23
54,17,37,2,Buncombe,2022-02-25
26,8,18,2,Buncombe,2022-03-04
8,2,6,2,Buncombe,2022-03-20
23,8,15,2,Burke,2021-12-14
115,16,99,2,Burke,2021-12-27
127,31,96,2,Burke,2021-12-29
69,7,62,2,Burke,2022-01-02
226,66,160,2,Burke,2022-01-04
470,164,306,2,Burke,2022-01-10
349,108,241,2,Burke,2022-01-14
137,35,102,2,Burke,2022-01-28
92,31,61,2,Burke,2022-02-10
51,16,35,2,Burke,2022-02-11
32,12,20,2,Burke,2022-02-12
30,11,19,2,Burke,2022-02-17
9,2,7,2,Burke,2022-02-25
12,2,10,2,Burke,2022-03-08
95,27,68,2,Cabarrus,2021-12-13
58,6,52,2,Cabarrus,2021-12-25
728,173,555,2,Cabarrus,2022-01-11
305,88,217,2,Cabarrus,2022-01-17
227,67,160,2,Cabarrus,2022-01-23
386,99,287,2,Cabarrus,2022-01-25
322,98,224,2,Cabarrus,2022-01-31
237,62,175,2,Cabarrus,2022-02-01
102,30,72,2,Cabarrus,2022-02-10
46,11,35,2,Cabarrus,2022-02-12
27,5,22,2,Cabarrus,2022-02-25
15,2,13,2,Cabarrus,2022-02-26
44,9,35,2,Caldwell,2021-12-26
362,77,285,2,Caldwell,2022-01-11
264,54,210,2,Caldwell,2022-01-14
23,3,20,2,Caldwell,2022-01-16
120,18,102,2,Caldwell,2022-01-22
100,25,75,2,Caldwell,2022-01-28
188,36,152,2,Caldwell,2022-01-31
101,16,85,2,Caldwell,2022-02-02
78,14,64,2,Caldwell,2022-02-04
40,3,37,2,Caldwell,2022-02-06
13,3,10,2,Caldwell,2022-02-23
10,0,10,2,Caldwell,2022-02-25
116,44,72,2,Carteret,2022-01-04
195,85,110,2,Carteret,2022-01-13
77,25,52,2,Carteret,2022-01-28
118,57,61,2,Carteret,2022-01-31
24,14,10,2,Carteret,2022-02-16
1,1,0,2,Carteret,2022-03-16
32,3,29,2,Caswell,2022-02-03
50,20,30,2,Catawba,2021-12-10
108,36,72,2,Catawba,2021-12-22
129,27,102,2,Catawba,2021-12-23
185,35,150,2,Catawba,2022-01-02
502,195,307,2,Catawba,2022-01-03
419,165,254,2,Catawba,2022-01-04
758,277,481,2,Catawba,2022-01-12
686,236,450,2,Catawba,2022-01-13
282,110,172,2,Catawba,2022-01-15
169,53,116,2,Catawba,2022-01-17
452,178,274,2,Catawba,2022-01-21
352,139,213,2,Catawba,2022-01-26
318,109,209,2,Catawba,2022-01-27
244,110,134,2,Catawba,2022-02-01
45,20,25,2,Catawba,2022-02-12
91,49,42,2,Catawba,2022-02-14
79,37,42,2,Catawba,2022-02-16
30,16,14,2,Catawba,2022-02-24
10,2,8,2,Catawba,2022-02-26
8,4,4,2,Catawba,2022-02-27
11,7,4,2,Catawba,2022-03-08
6,5,1,2,Catawba,2022-03-23
2,0,2,2,Catawba,2022-03-27
64,20,44,2,Chatham,2022-01-23
47,7,40,2,Cherokee,2022-01-05
29,1,28,2,Cherokee,2022-02-04
22,4,18,2,Cherokee,2022-02-11
31,2,29,2,Chowan,2022-01-27
55,9,46,2,Cleveland,2021-12-20
339,54,285,2,Cleveland,2022-01-14
385,69,316,2,Cleveland,2022-01-19
151,21,130,2,Cleveland,2022-02-02
62,8,54,2,Cleveland,2022-02-05
67,18,49,2,Cleveland,2022-02-10
57,10,47,2,Cleveland,2022-02-11
61,11,50,2,Cleveland,2022-02-14
33,9,24,2,Cleveland,2022-02-18
16,2,14,2,Cleveland,2022-02-23
10,1,9,2,Cleveland,2022-02-26
3,0,3,2,Cleveland,2022-03-23
326,156,170,2,Columbus,2022-01-12
326,116,210,2,Columbus,2022-01-18
187,64,123,2,Columbus,2022-01-20
266,107,159,2,Columbus,2022-01-24
25,16,9,2,Columbus,2022-02-14
328,129,199,2,Craven,2022-01-17
520,149,371,2,Craven,2022-01-18
36,3,33,2,Craven,2022-01-22
397,99,298,2,Craven,2022-01-24
164,36,128,2,Craven,2022-01-28
146,40,106,2,Craven,2022-02-01
124,23,101,2,Craven,2022-02-02
109,33,76,2,Craven,2022-02-03
63,14,49,2,Craven,2022-02-14
41,14,27,2,Craven,2022-02-17
294,25,269,2,Cumberland,2022-01-01
1025,125,900,2,Cumberland,2022-01-06
1468,140,1328,2,Cumberland,2022-01-11
1258,180,1078,2,Cumberland,2022-01-13
196,21,175,2,Cumberland,2022-01-16
986,120,866,2,Cumberland,2022-01-17
1631,159,1472,2,Cumberland,2022-01-18
1462,127,1335,2,Cumberland,2022-01-19
209,12,197,2,Cumberland,2022-01-22
724,58,666,2,Cumberland,2022-01-26
621,82,539,2,Cumberland,2022-01-28
209,21,188,2,Cumberland,2022-01-29
438,57,381,2,Cumberland,2022-02-02
367,46,321,2,Cumberland,2022-02-04
93,18,75,2,Cumberland,2022-02-06
305,63,242,2,Cumberland,2022-02-07
151,30,121,2,Cumberland,2022-02-11
182,18,164,2,Cumberland,2022-02-14
140,17,123,2,Cumberland,2022-02-16
121,26,95,2,Cumberland,2022-02-17
26,8,18,2,Cumberland,2022-02-20
114,6,108,2,Cumberland,2022-02-22
72,13,59,2,Cumberland,2022-02-23
18,2,16,2,Cumberland,2022-03-04
11,3,8,2,Cumberland,2022-03-05
77,16,61,2,Cumberland,2022-04-26
111,19,92,2,Cumberland,2022-05-09
7,0,7,2,Dare,2022-02-20
66,6,60,2,Davidson,2021-12-09
54,6,48,2,Davidson,2021-12-24
28,2,26,2,Davidson,2021-12-25
363,49,314,2,Davidson,2022-01-07
656,116,540,2,Davidson,2022-01-13
148,21,127,2,Davidson,2022-01-17
105,16,89,2,Davidson,2022-01-22
152,23,129,2,Davidson,2022-01-23
258,34,224,2,Davidson,2022-01-31
133,29,104,2,Davidson,2022-02-07
101,11,90,2,Davidson,2022-02-08
28,2,26,2,Davidson,2022-02-13
15,4,11,2,Davidson,2022-03-02
39,14,25,2,Davie,2022-01-17
60,13,47,2,Davie,2022-01-27
93,20,73,2,Davie,2022-01-31
26,3,23,2,Duplin,2022-01-01
170,60,110,2,Duplin,2022-01-25
99,52,47,2,Duplin,2022-01-28
9,2,7,2,Duplin,2022-02-05
40,13,27,2,Duplin,2022-02-08
22,8,14,2,Duplin,2022-02-15
3,1,2,2,Duplin,2022-03-08
1066,43,1023,2,Durham,2022-01-07
1356,81,1275,2,Durham,2022-01-11
947,66,881,2,Durham,2022-01-14
430,10,420,2,Durham,2022-01-23
639,43,596,2,Durham,2022-01-26
338,30,308,2,Durham,2022-01-28
176,13,163,2,Durham,2022-02-08
132,12,120,2,Durham,2022-02-11
75,15,60,2,Durham,2022-02-18
21,2,19,2,Durham,2022-02-27
30,1,29,2,Durham,2022-03-21
66,6,60,2,Durham,2022-04-05
216,7,209,2,Edgecombe,2022-01-18
43,1,42,2,Edgecombe,2022-01-28
333,46,287,2,Forsyth,2021-12-23
1037,101,936,2,Forsyth,2022-01-03
1298,128,1170,2,Forsyth,2022-01-05
427,34,393,2,Forsyth,2022-01-09
1515,126,1389,2,Forsyth,2022-01-11
271,55,216,2,Forsyth,2022-01-17
302,25,277,2,Forsyth,2022-01-23
695,73,622,2,Forsyth,2022-01-26
188,19,169,2,Forsyth,2022-01-29
153,13,140,2,Forsyth,2022-02-05
158,25,133,2,Forsyth,2022-02-14
122,23,99,2,Forsyth,2022-02-15
36,6,30,2,Forsyth,2022-02-25
24,1,23,2,Forsyth,2022-02-26
36,5,31,2,Forsyth,2022-03-03
17,3,14,2,Forsyth,2022-03-04
95,22,73,2,Forsyth,2022-04-25
361,27,334,2,Franklin,2022-01-24
121,25,96,2,Gaston,2021-12-15
85,26,59,2,Gaston,2021-12-24
582,94,488,2,Gaston,2021-12-30
735,96,639,2,Gaston,2022-01-04
555,84,471,2,Gaston,2022-01-07
913,151,762,2,Gaston,2022-01-10
689,135,554,2,Gaston,2022-01-14
525,103,422,2,Gaston,2022-01-21
451,98,353,2,Gaston,2022-01-26
154,31,123,2,Gaston,2022-01-30
358,86,272,2,Gaston,2022-01-31
216,43,173,2,Gaston,2022-02-03
92,19,73,2,Gaston,2022-02-06
51,9,42,2,Gaston,2022-02-13
116,38,78,2,Gaston,2022-02-14
77,13,64,2,Gaston,2022-02-17
18,7,11,2,Gaston,2022-03-01
21,5,16,2,Gaston,2022-03-02
1,0,1,2,Gaston,2022-03-12
20,3,17,2,Gaston,2022-04-12
114,10,104,2,Granville,2022-01-25
0,0,0,2,Greene,2022-03-15
412,62,350,2,Guilford,2021-12-22
198,43,155,2,Guilford,2021-12-24
395,42,353,2,Guilford,2021-12-26
1253,205,1048,2,Guilford,2021-12-29
1192,165,1027,2,Guilford,2022-01-03
213,33,180,2,Guilford,2022-01-29
438,88,350,2,Guilford,2022-02-02
226,45,181,2,Guilford,2022-02-09
112,14,98,2,Guilford,2022-02-12
178,40,138,2,Guilford,2022-02-14
198,41,157,2,Guilford,2022-02-15
48,10,38,2,Guilford,2022-02-25
52,18,34,2,Guilford,2022-03-01
23,6,17,2,Guilford,2022-03-09
7,1,6,2,Guilford,2022-03-13
13,4,9,2,Guilford,2022-03-25
9,1,8,2,Guilford,2022-03-27
42,8,34,2,Guilford,2022-04-09
91,26,65,2,Guilford,2022-04-13
138,24,114,2,Guilford,2022-05-14
274,41,233,2,Guilford,2022-05-31
272,49,223,2,Halifax,2022-01-05
242,23,219,2,Halifax,2022-01-11
203,29,174,2,Halifax,2022-01-14
34,8,26,2,Halifax,2022-02-03
29,10,19,2,Halifax,2022-02-04
4,0,4,2,Halifax,2022-02-19
8,0,8,2,Halifax,2022-02-22
1,0,1,2,Halifax,2022-03-13
441,90,351,2,Harnett,2022-01-07
555,119,436,2,Harnett,2022-01-14
240,39,201,2,Harnett,2022-01-15
382,97,285,2,Harnett,2022-01-17
498,107,391,2,Harnett,2022-01-24
268,54,214,2,Harnett,2022-01-26
177,54,123,2,Harnett,2022-02-01
63,19,44,2,Haywood,2021-12-27
64,18,46,2,Haywood,2022-02-03
27,10,17,2,Haywood,2022-02-11
22,5,17,2,Haywood,2022-02-15
13,8,5,2,Haywood,2022-02-20
4,1,3,2,Haywood,2022-03-04
12,4,8,2,Haywood,2022-03-07
7,2,5,2,Haywood,2022-03-08
3,1,2,2,Haywood,2022-03-09
184,71,113,2,Henderson,2022-01-03
103,37,66,2,Henderson,2022-01-09
277,82,195,2,Henderson,2022-01-13
14,2,12,2,Henderson,2022-01-16
276,100,176,2,Henderson,2022-01-19
78,23,55,2,Henderson,2022-01-22
92,37,55,2,Henderson,2022-01-23
156,50,106,2,Henderson,2022-01-27
137,54,83,2,Henderson,2022-01-28
55,19,36,2,Henderson,2022-01-30
123,40,83,2,Henderson,2022-02-02
49,21,28,2,Henderson,2022-02-05
38,19,19,2,Henderson,2022-02-21
7,2,5,2,Henderson,2022-03-10
19,8,11,2,Henderson,2022-04-26
127,20,107,2,Hertford,2022-01-05
307,27,280,2,Hoke,2022-01-05
276,17,259,2,Hoke,2022-01-13
116,19,97,2,Hoke,2022-01-26
50,11,39,2,Hoke,2022-02-03
62,19,43,2,Iredell,2021-12-18
64,22,42,2,Iredell,2021-12-19
152,52,100,2,Iredell,2021-12-22
320,109,211,2,Iredell,2021-12-27
192,96,96,2,Iredell,2022-01-02
451,190,261,2,Iredell,2022-01-03
479,168,311,2,Iredell,2022-01-06
633,242,391,2,Iredell,2022-01-10
506,159,347,2,Iredell,2022-01-20
334,113,221,2,Iredell,2022-01-21
91,21,70,2,Iredell,2022-01-29
334,102,232,2,Iredell,2022-01-31
106,45,61,2,Iredell,2022-02-09
37,9,28,2,Iredell,2022-02-12
36,14,22,2,Iredell,2022-02-13
80,30,50,2,Iredell,2022-02-14
43,14,29,2,Iredell,2022-02-18
18,12,6,2,Iredell,2022-03-03
2,1,1,2,Iredell,2022-03-05
9,3,6,2,Iredell,2022-03-08
204,26,178,2,Johnston,2022-01-02
859,130,729,2,Johnston,2022-01-03
969,159,810,2,Johnston,2022-01-14
852,164,688,2,Johnston,2022-01-17
97,17,80,2,Johnston,2022-01-22
409,59,350,2,Johnston,2022-01-27
330,78,252,2,Johnston,2022-01-28
109,26,83,2,Johnston,2022-02-10
41,13,28,2,Johnston,2022-02-13
97,24,73,2,Johnston,2022-02-14
88,19,69,2,Johnston,2022-02-15
85,21,64,2,Johnston,2022-02-16
31,8,23,2,Johnston,2022-02-19
16,3,13,2,Johnston,2022-02-26
24,2,22,2,Johnston,2022-03-01
15,4,11,2,Johnston,2022-03-03
5,3,2,2,Johnston,2022-03-27
7,1,6,2,Lee,2021-12-25
23,3,20,2,Lee,2022-01-22
25,5,20,2,Lenoir,2021-12-22
105,28,77,2,Lenoir,2022-01-27
100,17,83,2,Lenoir,2022-01-28
33,12,21,2,Lenoir,2022-02-08
6,3,3,2,Lenoir,2022-02-17
9,4,5,2,Lenoir,2022-02-28
4,0,4,2,Lenoir,2022-03-01
2,0,2,2,Lenoir,2022-03-23
45,19,26,2,Lincoln,2021-12-13
286,67,219,2,Lincoln,2022-01-18
185,61,124,2,Lincoln,2022-01-21
45,11,34,2,Lincoln,2022-01-29
163,69,94,2,Lincoln,2022-01-31
78,22,56,2,Lincoln,2022-02-07
49,11,38,2,Lincoln,2022-02-10
14,7,7,2,Lincoln,2022-02-20
7,1,6,2,Lincoln,2022-03-02
1,0,1,2,Lincoln,2022-03-16
10,1,9,2,Macon,2021-12-16
61,18,43,2,Macon,2022-01-19
16,2,14,2,Macon,2022-02-10
18,0,18,2,Martin,2022-02-03
91,28,63,2,McDowell,2022-02-07
60,14,46,2,McDowell,2022-02-08
181,29,152,2,Mecklenburg,2021-12-12
531,72,459,2,Mecklenburg,2021-12-16
635,61,574,2,Mecklenburg,2021-12-17
503,49,454,2,Mecklenburg,2021-12-19
1223,106,1117,2,Mecklenburg,2021-12-20
1419,166,1253,2,Mecklenburg,2021-12-21
367,25,342,2,Mecklenburg,2021-12-25
2943,358,2585,2,Mecklenburg,2021-12-27
2141,438,1703,2,Mecklenburg,2021-12-31
3657,651,3006,2,Mecklenburg,2022-01-03
397,69,328,2,Mecklenburg,2022-02-11
361,62,299,2,Mecklenburg,2022-02-14
137,28,109,2,Mecklenburg,2022-02-25
129,23,106,2,Mecklenburg,2022-02-28
93,18,75,2,Mecklenburg,2022-03-01
66,12,54,2,Mecklenburg,2022-03-08
49,17,32,2,Mecklenburg,2022-03-17
22,4,18,2,Mecklenburg,2022-03-20
218,43,175,2,Mecklenburg,2022-04-19
398,52,346,2,Mecklenburg,2022-05-04
498,79,419,2,Mecklenburg,2022-05-23
10,0,10,2,Montgomery,2022-02-05
317,38,279,2,Moore,2022-01-05
203,23,180,2,Moore,2022-01-09
472,53,419,2,Moore,2022-01-11
424,62,362,2,Moore,2022-01-19
26,5,21,2,Moore,2022-01-30
105,18,87,2,Moore,2022-02-02
54,6,48,2,Moore,2022-02-08
52,14,38,2,Moore,2022-02-09
48,8,40,2,Moore,2022-02-10
51,15,36,2,Moore,2022-02-11
23,3,20,2,Moore,2022-02-12
39,10,29,2,Moore,2022-02-15
3,1,2,2,Moore,2022-03-09
46,4,42,2,Nash,2021-12-15
19,1,18,2,Nash,2021-12-19
456,31,425,2,Nash,2022-01-03
579,52,527,2,Nash,2022-01-10
92,7,85,2,Nash,2022-01-15
40,2,38,2,Nash,2022-01-16
388,26,362,2,Nash,2022-01-19
282,34,248,2,Nash,2022-01-24
34,4,30,2,Nash,2022-01-30
82,11,71,2,Nash,2022-02-02
34,3,31,2,Nash,2022-02-10
1,0,1,2,Nash,2022-03-06
258,84,174,2,New Hanover,2021-12-31
88,24,64,2,New Hanover,2022-01-01
689,133,556,2,New Hanover,2022-01-12
872,297,575,2,New Hanover,2022-01-18
300,62,238,2,New Hanover,2022-01-28
113,23,90,2,New Hanover,2022-01-29
249,46,203,2,New Hanover,2022-02-01
208,34,174,2,New Hanover,2022-02-04
132,32,100,2,New Hanover,2022-02-08
66,17,49,2,New Hanover,2022-02-16
20,9,11,2,New Hanover,2022-02-19
10,2,8,2,New Hanover,2022-02-27
18,7,11,2,Northampton,2022-01-27
116,10,106,2,Onslow,2021-12-20
573,79,494,2,Onslow,2022-01-07
549,108,441,2,Onslow,2022-01-14
756,109,647,2,Onslow,2022-01-20
789,87,702,2,Onslow,2022-01-24
245,35,210,2,Onslow,2022-02-02
46,1,45,2,Onslow,2022-02-05
67,2,65,2,Onslow,2022-02-06
96,13,83,2,Onslow,2022-02-09
147,17,130,2,Onslow,2022-02-10
74,6,68,2,Onslow,2022-02-11
37,4,33,2,Onslow,2022-02-12
32,4,28,2,Onslow,2022-02-13
117,15,102,2,Onslow,2022-02-14
38,5,33,2,Onslow,2022-02-18
54,5,49,2,Onslow,2022-02-22
7,0,7,2,Onslow,2022-02-26
10,4,6,2,Onslow,2022-03-02
555,19,536,2,Orange,2022-01-19
36,3,33,2,Orange,2022-02-18
103,20,83,2,Pasquotank,2022-01-18
43,8,35,2,Pasquotank,2022-01-28
19,5,14,2,Pasquotank,2022-02-04
24,4,20,2,Pender,2022-02-11
0,0,0,2,Pender,2022-03-26
73,3,70,2,Person,2022-01-25
35,11,24,2,Pitt,2021-12-24
687,51,636,2,Pitt,2022-01-07
1048,61,987,2,Pitt,2022-01-10
1046,86,960,2,Pitt,2022-01-18
246,11,235,2,Pitt,2022-01-23
485,39,446,2,Pitt,2022-01-25
449,52,397,2,Pitt,2022-01-26
242,24,218,2,Pitt,2022-02-01
18,0,18,2,Pitt,2022-02-20
7,1,6,2,Pitt,2022-02-26
19,9,10,2,Polk,2022-01-28
112,48,64,2,Randolph,2022-01-02
470,94,376,2,Randolph,2022-01-13
405,80,325,2,Randolph,2022-01-14
323,108,215,2,Randolph,2022-01-21
161,33,128,2,Randolph,2022-01-23
396,98,298,2,Randolph,2022-01-24
271,69,202,2,Randolph,2022-01-26
157,39,118,2,Randolph,2022-02-01
87,34,53,2,Randolph,2022-02-04
46,7,39,2,Randolph,2022-02-06
26,4,22,2,Randolph,2022-02-12
21,7,14,2,Randolph,2022-02-13
44,12,32,2,Randolph,2022-02-16
32,9,23,2,Randolph,2022-02-17
16,3,13,2,Randolph,2022-02-20
10,2,8,2,Randolph,2022-03-07
3,0,3,2,Randolph,2022-03-17
3,1,2,2,Randolph,2022-04-08
122,10,112,2,Richmond,2022-01-03
261,57,204,2,Richmond,2022-01-13
9,2,7,2,Richmond,2022-01-22
178,47,131,2,Richmond,2022-01-24
14,3,11,2,Richmond,2022-01-29
5,1,4,2,Richmond,2022-02-06
53,22,31,2,Richmond,2022-02-07
83,58,25,2,Robeson,2022-01-16
87,31,56,2,Robeson,2022-01-21
111,50,61,2,Robeson,2022-02-07
74,18,56,2,Robeson,2022-02-08
57,23,34,2,Robeson,2022-02-09
32,9,23,2,Robeson,2022-02-17
23,9,14,2,Robeson,2022-02-18
28,16,12,2,Robeson,2022-02-21
16,7,9,2,Robeson,2022-02-23
12,6,6,2,Robeson,2022-02-25
3,0,3,2,Robeson,2022-03-13
11,0,11,2,Rockingham,2021-12-25
199,38,161,2,Rockingham,2021-12-29
277,54,223,2,Rockingham,2022-01-06
332,27,305,2,Rockingham,2022-01-11
210,21,189,2,Rockingham,2022-01-21
130,9,121,2,Rockingham,2022-01-31
72,8,64,2,Rockingham,2022-02-03
63,4,59,2,Rockingham,2022-02-04
14,2,12,2,Rockingham,2022-02-13
15,1,14,2,Rockingham,2022-02-25
13,0,13,2,Rockingham,2022-03-02
49,8,41,2,Rowan,2021-12-09
64,9,55,2,Rowan,2021-12-13
65,4,61,2,Rowan,2021-12-15
52,6,46,2,Rowan,2021-12-17
359,88,271,2,Rowan,2022-01-03
256,38,218,2,Rowan,2022-01-21
108,35,73,2,Rowan,2022-01-23
104,9,95,2,Rowan,2022-02-04
36,6,30,2,Rowan,2022-02-21
12,1,11,2,Rowan,2022-02-24
0,0,0,2,Rowan,2022-03-05
6,2,4,2,Rowan,2022-03-10
0,0,0,2,Rowan,2022-03-19
4,0,4,2,Rowan,2022-03-20
22,2,20,2,Rowan,2022-04-26
12,5,7,2,Rutherford,2021-12-17
23,3,20,2,Rutherford,2021-12-21
37,13,24,2,Rutherford,2022-01-01
202,125,77,2,Rutherford,2022-01-25
90,38,52,2,Rutherford,2022-02-01
73,14,59,2,Rutherford,2022-02-03
46,15,31,2,Rutherford,2022-02-09
9,2,7,2,Rutherford,2022-02-13
4,1,3,2,Rutherford,2022-03-02
192,73,119,2,Sampson,2022-01-25
156,55,101,2,Sampson,2022-01-26
7,3,4,2,Sampson,2022-02-06
34,10,24,2,Sampson,2022-02-08
2,0,2,2,Sampson,2022-02-20
18,7,11,2,Sampson,2022-02-23
78,13,65,2,Scotland,2022-01-09
12,7,5,2,Scotland,2022-01-30
33,8,25,2,Scotland,2022-02-01
213,85,128,2,Stanly,2022-01-03
358,65,293,2,Stanly,2022-01-12
311,67,244,2,Stanly,2022-01-13
266,40,226,2,Stanly,2022-01-14
62,30,32,2,Stanly,2022-01-23
111,16,95,2,Stanly,2022-01-31
52,3,49,2,Stanly,2022-02-04
5,0,5,2,Stanly,2022-03-01
25,3,22,2,Stokes,2021-12-09
131,19,112,2,Stokes,2022-01-18
106,18,88,2,Stokes,2022-01-25
19,5,14,2,Stokes,2022-01-29
41,5,36,2,Stokes,2022-02-03
27,2,25,2,Stokes,2022-02-10
12,0,12,2,Stokes,2022-02-12
3,0,3,2,Stokes,2022-03-05
15,7,8,2,Surry,2021-12-12
79,34,45,2,Surry,2022-01-02
346,121,225,2,Surry,2022-01-10
225,72,153,2,Surry,2022-01-14
58,29,29,2,Surry,2022-01-30
47,12,35,2,Surry,2022-02-11
22,7,15,2,Surry,2022-02-22
7,2,5,2,Surry,2022-03-03
7,0,7,2,Surry,2022-03-14
0,0,0,2,Surry,2022-03-19
5,0,5,2,Swain,2021-12-21
10,3,7,2,Swain,2022-02-09
25,4,21,2,Transylvania,2022-02-04
86,23,63,2,Union,2021-12-09
188,27,161,2,Union,2021-12-22
523,109,414,2,Union,2021-12-28
575,153,422,2,Union,2022-01-03
768,172,596,2,Union,2022-01-04
862,159,703,2,Union,2022-01-11
890,174,716,2,Union,2022-01-12
568,107,461,2,Union,2022-01-21
297,61,236,2,Union,2022-01-28
180,45,135,2,Union,2022-02-02
170,44,126,2,Union,2022-02-07
99,29,70,2,Union,2022-02-09
88,17,71,2,Union,2022-02-14
53,15,38,2,Union,2022-02-18
41,11,30,2,Union,2022-02-21
14,5,9,2,Union,2022-03-08
14,1,13,2,Union,2022-03-28
23,3,20,2,Vance,2022-01-30
4,2,2,2,Vance,2022-04-11
437,42,395,2,Wake,2021-12-15
259,47,212,2,Wake,2021-12-19
789,52,737,2,Wake,2021-12-20
4909,241,4668,2,Wake,2022-01-14
5341,292,5049,2,Wake,2022-01-19
3102,212,2890,2,Wake,2022-01-25
1828,134,1694,2,Wake,2022-01-28
1101,98,1003,2,Wake,2022-02-03
757,46,711,2,Wake,2022-02-05
570,51,519,2,Wake,2022-02-11
384,40,344,2,Wake,2022-02-21
297,31,266,2,Wake,2022-02-22
219,32,187,2,Wake,2022-02-24
126,15,111,2,Wake,2022-02-26
124,12,112,2,Wake,2022-03-03
44,8,36,2,Wake,2022-03-06
97,4,93,2,Wake,2022-03-08
83,7,76,2,Wake,2022-03-10
61,8,53,2,Wake,2022-03-12
45,8,37,2,Wake,2022-03-20
122,13,109,2,Wake,2022-03-21
243,17,226,2,Wake,2022-04-14
669,65,604,2,Wake,2022-05-02
997,99,898,2,Wake,2022-05-09
24,5,19,2,Watauga,2021-12-23
39,21,18,2,Watauga,2022-01-22
55,26,29,2,Watauga,2022-01-23
89,47,42,2,Watauga,2022-01-28
40,17,23,2,Watauga,2022-02-09
46,26,20,2,Wayne,2021-12-22
656,342,314,2,Wayne,2022-01-11
435,206,229,2,Wayne,2022-01-24
165,61,104,2,Wayne,2022-01-28
58,4,54,2,Wayne,2022-01-30
191,82,109,2,Wayne,2022-01-31
99,61,38,2,Wayne,2022-02-07
51,22,29,2,Wayne,2022-02-09
1,1,0,2,Wayne,2022-03-19
200,44,156,2,Wilkes,2022-01-24
107,38,69,2,Wilkes,2022-01-27
57,18,39,2,Wilkes,2022-02-07
101,69,32,2,Wilkes,2022-02-08
45,22,23,2,Wilkes,2022-02-11
33,11,22,2,Wilkes,2022-02-16
30,11,19,2,Wilkes,2022-02-17
430,91,339,2,Wilson,2022-01-10
342,72,270,2,Wilson,2022-01-12
336,70,266,2,Wilson,2022-01-18
190,41,149,2,Wilson,2022-01-25
114,25,89,2,Wilson,2022-01-27
95,27,68,2,Wilson,2022-01-31
28,7,21,2,Wilson,2022-02-10
10,1,9,2,Wilson,2022-02-19
29,7,22,2,Yadkin,2021-12-08
21,4,17,2,Yadkin,2021-12-25
96,16,80,2,Yadkin,2022-01-05
50,12,38,2,Yadkin,2022-02-02
2,1,1,2,Yadkin,2022-02-27
2,0,2,2,Yadkin,2022-03-22
50,34,16,2,Yancey,2022-01-18
640,61,579,3,Alamance,2022-01-13
557,77,480,3,Alamance,2022-01-18
556,44,512,3,Alamance,2022-01-19
205,15,190,3,Alamance,2022-01-28
239,27,212,3,Alamance,2022-01-31
141,12,129,3,Alamance,2022-02-02
139,15,124,3,Alamance,2022-02-04
88,10,78,3,Alamance,2022-02-10
32,9,23,3,Alamance,2022-02-13
10,0,10,3,Bertie,2022-01-29
392,55,337,3,Brunswick,2022-01-24
88,6,82,3,Brunswick,2022-01-29
87,20,67,3,Brunswick,2022-01-30
114,19,95,3,Brunswick,2022-02-04
71,2,69,3,Brunswick,2022-02-05
59,9,50,3,Brunswick,2022-02-10
48,10,38,3,Brunswick,2022-02-15
29,6,23,3,Brunswick,2022-02-19
98,21,77,3,Buncombe,2022-01-29
235,87,148,3,Buncombe,2022-02-04
219,98,121,3,Buncombe,2022-02-07
209,77,132,3,Buncombe,2022-02-08
177,77,100,3,Buncombe,2022-02-14
26,4,22,3,Buncombe,2022-03-07
36,6,30,3,Buncombe,2022-05-01
115,56,59,3,Buncombe,2022-05-03
292,93,199,3,Burke,2022-01-24
110,31,79,3,Burke,2022-02-03
97,30,67,3,Burke,2022-02-08
51,1,50,3,Cabarrus,2021-12-12
199,34,165,3,Cabarrus,2021-12-22
209,52,157,3,Cabarrus,2021-12-23
679,128,551,3,Cabarrus,2022-01-12
313,73,240,3,Cabarrus,2022-01-27
117,32,85,3,Cabarrus,2022-01-29
182,39,143,3,Cabarrus,2022-02-03
97,20,77,3,Cabarrus,2022-02-05
46,14,32,3,Cabarrus,2022-02-13
28,10,18,3,Cabarrus,2022-02-19
23,5,18,3,Cabarrus,2022-02-20
19,5,14,3,Cabarrus,2022-03-01
14,3,11,3,Cabarrus,2022-03-02
187,38,149,3,Caldwell,2022-01-27
138,28,110,3,Caldwell,2022-02-01
36,3,33,3,Caldwell,2022-02-05
45,8,37,3,Caldwell,2022-02-11
98,24,74,3,Catawba,2021-12-21
609,195,414,3,Catawba,2022-01-18
409,156,253,3,Catawba,2022-01-25
69,24,45,3,Catawba,2022-02-05
114,41,73,3,Catawba,2022-02-10
53,13,40,3,Catawba,2022-02-18
23,10,13,3,Catawba,2022-02-19
34,9,25,3,Catawba,2022-02-23
324,44,280,3,Cleveland,2022-01-20
107,19,88,3,Cleveland,2022-02-07
93,18,75,3,Cleveland,2022-02-08
59,8,51,3,Cleveland,2022-02-09
20,8,12,3,Cleveland,2022-02-22
123,52,71,3,Columbus,2022-01-26
45,18,27,3,Columbus,2022-02-03
406,29,377,3,Cumberland,2022-01-08
978,131,847,3,Cumberland,2022-01-14
470,54,416,3,Cumberland,2022-01-15
1030,73,957,3,Cumberland,2022-01-25
379,51,328,3,Cumberland,2022-02-03
174,48,126,3,Cumberland,2022-02-10
89,15,74,3,Cumberland,2022-02-12
110,10,100,3,Cumberland,2022-02-18
42,4,38,3,Cumberland,2022-02-25
94,12,82,3,Davidson,2021-12-22
152,17,135,3,Davidson,2022-01-02
629,76,553,3,Davidson,2022-01-14
341,36,305,3,Davidson,2022-01-25
80,7,73,3,Davidson,2022-01-29
198,15,183,3,Davidson,2022-02-01
169,28,141,3,Davidson,2022-02-02
148,17,131,3,Davidson,2022-02-04
34,3,31,3,Davidson,2022-02-12
44,11,33,3,Davidson,2022-02-21
20,5,15,3,Davidson,2022-02-24
324,20,304,3,Durham,2022-01-21
662,27,635,3,Durham,2022-01-25
61,5,56,3,Durham,2022-02-13
4,1,3,3,Edgecombe,2022-02-06
161,20,141,3,Forsyth,2021-12-13
177,25,152,3,Forsyth,2021-12-16
95,3,92,3,Forsyth,2021-12-18
725,94,631,3,Forsyth,2021-12-27
1642,163,1479,3,Forsyth,2022-01-10
1425,150,1275,3,Forsyth,2022-01-13
1006,138,868,3,Forsyth,2022-01-18
357,22,335,3,Forsyth,2022-01-22
789,90,699,3,Forsyth,2022-01-25
287,34,253,3,Forsyth,2022-02-03
197,37,160,3,Forsyth,2022-02-09
167,30,137,3,Forsyth,2022-02-10
132,18,114,3,Forsyth,2022-02-11
93,12,81,3,Forsyth,2022-02-22
615,97,518,3,Gaston,2022-01-03
279,47,232,3,Gaston,2022-01-08
839,157,682,3,Gaston,2022-01-11
285,63,222,3,Gaston,2022-01-17
212,35,177,3,Gaston,2022-01-22
387,57,330,3,Gaston,2022-01-27
187,40,147,3,Gaston,2022-02-08
168,39,129,3,Gaston,2022-02-09
128,31,97,3,Gaston,2022-02-10
34,12,22,3,Gaston,2022-02-19
325,54,271,3,Guilford,2021-12-21
396,113,283,3,Guilford,2022-01-17
897,85,812,3,Guilford,2022-01-25
471,82,389,3,Guilford,2022-02-01
117,21,96,3,Guilford,2022-02-06
300,56,244,3,Guilford,2022-02-07
238,41,197,3,Guilford,2022-02-08
185,40,145,3,Guilford,2022-02-11
91,24,67,3,Guilford,2022-02-13
157,36,121,3,Guilford,2022-02-16
105,27,78,3,Guilford,2022-02-22
94,32,62,3,Guilford,2022-02-23
45,7,38,3,Guilford,2022-03-02
47,10,37,3,Guilford,2022-03-04
23,3,20,3,Guilford,2022-03-15
15,4,11,3,Halifax,2022-01-30
392,119,273,3,Harnett,2022-01-25
70,13,57,3,Harnett,2022-02-10
23,6,17,3,Harnett,2022-02-13
187,63,124,3,Haywood,2022-01-10
46,27,19,3,Haywood,2022-02-21
188,35,153,3,Henderson,2022-01-07
71,28,43,3,Henderson,2022-01-15
104,53,51,3,Henderson,2022-01-17
147,54,93,3,Henderson,2022-01-26
100,32,68,3,Henderson,2022-02-03
91,34,57,3,Henderson,2022-02-09
22,10,12,3,Henderson,2022-02-13
110,47,63,3,Iredell,2021-12-26
373,99,274,3,Iredell,2022-01-07
473,104,369,3,Iredell,2022-01-14
568,220,348,3,Iredell,2022-01-18
175,56,119,3,Iredell,2022-01-22
202,100,102,3,Iredell,2022-01-23
376,106,270,3,Iredell,2022-01-26
101,32,69,3,Iredell,2022-01-30
600,110,490,3,Johnston,2022-01-25
125,27,98,3,Johnston,2022-01-30
186,44,142,3,Johnston,2022-02-04
143,32,111,3,Johnston,2022-02-08
99,24,75,3,Johnston,2022-02-11
69,15,54,3,Johnston,2022-02-12
34,7,27,3,Lee,2022-02-08
24,5,19,3,Lenoir,2022-02-09
306,88,218,3,Lincoln,2022-01-13
337,83,254,3,Lincoln,2022-01-19
90,23,67,3,Lincoln,2022-02-04
12,0,12,3,Madison,2022-01-09
60,21,39,3,McDowell,2022-02-10
37,11,26,3,McDowell,2022-02-11
349,63,286,3,Mecklenburg,2021-12-09
1651,196,1455,3,Mecklenburg,2021-12-22
1886,191,1695,3,Mecklenburg,2021-12-23
1144,160,984,3,Mecklenburg,2021-12-24
1162,142,1020,3,Mecklenburg,2021-12-26
1725,325,1400,3,Mecklenburg,2022-01-08
3061,361,2700,3,Mecklenburg,2022-01-14
1334,154,1180,3,Mecklenburg,2022-01-27
910,130,780,3,Mecklenburg,2022-02-02
354,45,309,3,Mecklenburg,2022-02-05
456,82,374,3,Mecklenburg,2022-02-10
193,24,169,3,Mecklenburg,2022-02-12
177,30,147,3,Mecklenburg,2022-02-13
221,37,184,3,Mecklenburg,2022-02-18
122,28,94,3,Mecklenburg,2022-02-20
82,15,67,3,Mecklenburg,2022-03-03
182,34,148,3,Moore,2022-01-26
19,4,15,3,Moore,2022-02-06
35,4,31,3,Nash,2021-12-08
163,26,137,3,Nash,2022-01-31
27,2,25,3,Nash,2022-02-15
742,132,610,3,New Hanover,2022-01-11
508,128,380,3,New Hanover,2022-01-25
360,77,283,3,New Hanover,2022-01-27
196,53,143,3,New Hanover,2022-02-03
41,15,26,3,New Hanover,2022-02-12
90,28,62,3,New Hanover,2022-02-14
53,12,41,3,New Hanover,2022-02-21
20,3,17,3,New Hanover,2022-02-25
1042,137,905,3,Onslow,2022-01-10
273,22,251,3,Onslow,2022-01-23
516,89,427,3,Onslow,2022-01-25
305,39,266,3,Onslow,2022-01-27
199,37,162,3,Onslow,2022-02-03
159,22,137,3,Onslow,2022-02-04
7,2,5,3,Onslow,2022-03-10
48,7,41,3,Pitt,2022-02-05
20,1,19,3,Pitt,2022-02-12
11,2,9,3,Pitt,2022-02-19
403,107,296,3,Randolph,2022-01-20
44,15,29,3,Randolph,2022-02-05
84,29,55,3,Randolph,2022-02-09
51,12,39,3,Randolph,2022-02-14
31,7,24,3,Randolph,2022-02-18
36,12,24,3,Randolph,2022-02-21
195,60,135,3,Robeson,2022-01-27
166,57,109,3,Robeson,2022-01-28
53,22,31,3,Robeson,2022-01-29
56,24,32,3,Robeson,2022-01-30
49,27,22,3,Robeson,2022-02-05
44,15,29,3,Robeson,2022-02-11
38,1,37,3,Rockingham,2022-01-29
72,8,64,3,Rockingham,2022-02-02
2,0,2,3,Rockingham,2022-03-09
402,43,359,3,Rowan,2022-01-04
610,96,514,3,Rowan,2022-01-11
84,22,62,3,Rowan,2022-01-22
477,89,388,3,Rowan,2022-01-24
279,43,236,3,Rowan,2022-01-26
82,9,73,3,Rowan,2022-02-10
68,4,64,3,Rowan,2022-02-11
115,42,73,3,Rutherford,2022-01-31
55,12,43,3,Rutherford,2022-02-04
80,18,62,3,Stokes,2022-01-06
10,2,8,3,Stokes,2022-01-16
56,9,47,3,Stokes,2022-01-22
14,2,12,3,Stokes,2022-02-18
14,10,4,3,Surry,2022-01-16
67,34,33,3,Surry,2022-01-23
65,25,40,3,Surry,2022-02-04
40,15,25,3,Surry,2022-02-06
75,25,50,3,Surry,2022-02-08
89,16,73,3,Union,2021-12-14
672,145,527,3,Union,2022-01-07
497,93,404,3,Union,2022-01-17
213,38,175,3,Union,2022-01-22
667,121,546,3,Union,2022-01-24
127,33,94,3,Union,2022-01-29
107,22,85,3,Union,2022-02-11
58,17,41,3,Union,2022-02-12
2,2,0,3,Vance,2022-02-19
6668,306,6362,3,Wake,2022-01-04
2819,144,2675,3,Wake,2022-01-15
417,41,376,3,Wake,2022-01-16
6164,399,5765,3,Wake,2022-01-18
4142,230,3912,3,Wake,2022-01-20
463,25,438,3,Wake,2022-01-22
2541,162,2379,3,Wake,2022-01-26
529,65,464,3,Wake,2022-01-30
1344,94,1250,3,Wake,2022-02-02
377,41,336,3,Wake,2022-02-18
241,21,220,3,Wake,2022-02-19
272,27,245,3,Wake,2022-02-23
130,8,122,3,Wake,2022-03-07
70,8,62,3,Wake,2022-03-18
907,78,829,3,Wake,2022-05-11
35,5,30,3,Warren,2022-01-08
156,36,120,3,Wayne,2022-01-21
345,167,178,3,Wayne,2022-01-25
82,36,46,3,Wayne,2022-02-10
22,13,9,3,Wayne,2022-02-28
183,80,103,3,Wilkes,2022-01-18
52,32,20,3,Wilkes,2022-01-30
80,29,51,3,Wilkes,2022-02-03
76,31,45,3,Wilkes,2022-02-04
79,22,57,3,Wilson,2022-01-28
61,5,56,3,Wilson,2022-02-03
13,2,11,3,Wilson,2022-02-13
275,28,247,4,Alamance,2022-01-27
57,9,48,4,Alamance,2022-02-05
301,68,233,4,Brunswick,2022-01-25
742,214,528,4,Buncombe,2022-01-13
261,60,201,4,Buncombe,2022-01-15
449,142,307,4,Buncombe,2022-01-25
427,118,309,4,Buncombe,2022-01-26
367,138,229,4,Buncombe,2022-01-31
86,27,59,4,Buncombe,2022-02-13
96,24,72,4,Buncombe,2022-02-16
139,50,89,4,Burke,2022-02-07
265,100,165,4,Cabarrus,2022-01-02
235,70,165,4,Cabarrus,2022-02-02
75,15,60,4,Cabarrus,2022-02-15
135,23,112,4,Caldwell,2022-01-15
81,22,59,4,Caldwell,2022-02-07
664,232,432,4,Catawba,2022-01-14
148,74,74,4,Catawba,2022-02-08
114,48,66,4,Catawba,2022-02-09
21,10,11,4,Catawba,2022-03-09
333,52,281,4,Cleveland,2022-01-24
1548,168,1380,4,Cumberland,2022-01-10
685,66,619,4,Cumberland,2022-01-27
35,8,27,4,Cumberland,2022-02-19
95,14,81,4,Davidson,2022-02-09
561,33,528,4,Durham,2022-01-09
864,120,744,4,Forsyth,2021-12-30
1023,108,915,4,Forsyth,2022-01-07
756,60,696,4,Forsyth,2022-01-15
80,10,70,4,Forsyth,2022-01-16
543,64,479,4,Forsyth,2022-01-27
551,88,463,4,Forsyth,2022-01-31
289,33,256,4,Forsyth,2022-02-04
100,21,79,4,Forsyth,2022-02-18
34,5,29,4,Forsyth,2022-03-01
21,3,18,4,Forsyth,2022-03-10
866,129,737,4,Gaston,2022-01-19
618,110,508,4,Gaston,2022-01-24
537,117,420,4,Gaston,2022-01-25
310,69,241,4,Gaston,2022-02-01
242,73,169,4,Gaston,2022-02-07
30,7,23,4,Gaston,2022-02-20
46,8,38,4,Gaston,2022-02-23
1384,219,1165,4,Guilford,2022-01-07
801,78,723,4,Guilford,2022-01-09
2048,341,1707,4,Guilford,2022-01-10
1625,255,1370,4,Guilford,2022-01-14
359,34,325,4,Guilford,2022-01-22
533,77,456,4,Guilford,2022-01-28
234,36,198,4,Guilford,2022-01-30
227,51,176,4,Guilford,2022-02-10
104,23,81,4,Guilford,2022-02-18
63,17,46,4,Guilford,2022-02-24
15,3,12,4,Guilford,2022-03-06
576,197,379,4,Iredell,2022-01-04
380,151,229,4,Iredell,2022-01-25
211,48,163,4,Iredell,2022-01-28
47,11,36,4,Iredell,2022-02-17
104,21,83,4,Johnston,2022-01-29
230,37,193,4,Johnston,2022-02-03
147,48,99,4,Lincoln,2022-01-27
3492,569,2923,4,Mecklenburg,2021-12-29
4387,635,3752,4,Mecklenburg,2022-01-05
3480,573,2907,4,Mecklenburg,2022-01-07
1529,254,1275,4,Mecklenburg,2022-01-17
1755,310,1445,4,Mecklenburg,2022-01-21
2162,337,1825,4,Mecklenburg,2022-01-24
495,81,414,4,Mecklenburg,2022-02-09
324,63,261,4,Mecklenburg,2022-02-15
74,14,60,4,Moore,2022-02-07
774,167,607,4,New Hanover,2022-01-10
39,7,32,4,New Hanover,2022-02-22
90,10,80,4,Onslow,2022-01-22
326,37,289,4,Onslow,2022-01-28
26,4,22,4,Randolph,2022-01-16
242,83,159,4,Randolph,2022-01-31
409,130,279,4,Robeson,2022-01-07
529,148,381,4,Robeson,2022-01-20
156,74,82,4,Robeson,2022-01-23
8,3,5,4,Robeson,2022-02-19
10,3,7,4,Robeson,2022-03-01
83,13,70,4,Rockingham,2022-01-22
219,27,192,4,Rowan,2022-01-15
19,1,18,4,Stokes,2022-02-17
81,28,53,4,Surry,2022-01-22
56,17,39,4,Surry,2022-01-29
30,12,18,4,Surry,2022-02-15
176,73,103,4,Union,2022-02-04
88,24,64,4,Union,2022-02-06
5937,294,5643,4,Wake,2022-01-12
3187,282,2905,4,Wake,2022-01-17
4430,289,4141,4,Wake,2022-01-24
1062,90,972,4,Wake,2022-02-04
380,28,352,4,Wake,2022-02-12
453,65,388,4,Wake,2022-02-15
52,8,44,4,Wake,2022-03-05
96,7,89,4,Wake,2022-03-09
93,43,50,4,Wayne,2022-02-04
212,83,129,4,Wilkes,2022-01-20
319,60,259,4,Wilson,2022-01-07
144,28,116,4,Wilson,2022-01-26
768,70,698,5,Alamance,2022-01-11
64,10,54,5,Alamance,2022-02-06
11,4,7,5,Bladen,2022-02-10
114,24,90,5,Buncombe,2022-02-05
40,14,26,5,Buncombe,2022-02-20
851,213,638,5,Cabarrus,2022-01-10
287,116,171,5,Catawba,2022-01-28
197,76,121,5,Catawba,2022-02-02
7,2,5,5,Catawba,2022-03-17
247,42,205,5,Cumberland,2022-01-23
1589,134,1455,5,Cumberland,2022-01-24
40,7,33,5,Cumberland,2022-02-13
1467,126,1341,5,Forsyth,2022-01-14
1243,123,1120,5,Forsyth,2022-01-19
1166,122,1044,5,Forsyth,2022-01-20
496,65,431,5,Forsyth,2022-01-28
203,26,177,5,Forsyth,2022-01-30
64,8,56,5,Forsyth,2022-02-12
32,1,31,5,Forsyth,2022-02-20
260,46,214,5,Gaston,2022-01-09
201,44,157,5,Gaston,2022-01-23
324,63,261,5,Gaston,2022-01-28
168,46,122,5,Gaston,2022-02-04
111,24,87,5,Gaston,2022-02-05
64,11,53,5,Gaston,2022-02-16
497,94,403,5,Guilford,2022-01-02
1516,224,1292,5,Guilford,2022-01-05
335,67,268,5,Guilford,2022-02-03
146,23,123,5,Guilford,2022-02-05
122,33,89,5,Guilford,2022-02-21
26,8,18,5,Guilford,2022-02-26
22,2,20,5,Guilford,2022-03-05
180,62,118,5,Henderson,2022-01-25
211,70,141,5,Iredell,2022-02-02
154,47,107,5,Iredell,2022-02-04
456,85,371,5,Johnston,2022-01-26
4527,715,3812,5,Mecklenburg,2022-01-10
941,138,803,5,Mecklenburg,2022-02-01
772,113,659,5,Mecklenburg,2022-02-03
162,30,132,5,Mecklenburg,2022-02-23
280,81,199,5,Randolph,2022-01-25
85,31,54,5,Randolph,2022-01-30
110,35,75,5,Surry,2022-02-01
27,9,18,5,Surry,2022-02-17
725,131,594,5,Union,2022-01-06
209,50,159,5,Union,2022-02-03
5083,238,4845,5,Wake,2022-01-13
1974,126,1848,5,Wake,2022-01-27
1186,98,1088,5,Wake,2022-02-07
138,42,96,5,Wilkes,2022-01-25
640,174,466,6,Cabarrus,2022-01-14
179,54,125,6,Catawba,2022-01-23
509,49,460,6,Cumberland,2022-01-21
202,28,174,6,Cumberland,2022-01-30
142,40,102,6,Forsyth,2022-02-16
168,30,138,6,Gaston,2022-01-29
76,17,59,6,Gaston,2022-02-12
99,33,66,6,Gaston,2022-02-15
1839,216,1623,6,Guilford,2022-01-12
4440,584,3856,6,Mecklenburg,2022-01-04
4092,637,3455,6,Mecklenburg,2022-01-06
236,40,196,6,Mecklenburg,2022-01-16
3257,445,2812,6,Mecklenburg,2022-01-18
767,161,606,6,Mecklenburg,2022-01-22
1585,250,1335,6,Mecklenburg,2022-01-26
1135,138,997,6,Mecklenburg,2022-01-28
550,91,459,6,Mecklenburg,2022-01-30
297,33,264,6,Pitt,2022-01-27
21,6,15,6,Rowan,2022-02-19
99,22,77,6,Surry,2022-01-08
1106,151,955,6,Wake,2022-01-21
1076,128,948,6,Wake,2022-01-23
608,68,540,6,Wake,2022-01-29
619,62,557,6,Wake,2022-02-10
232,40,192,6,Wake,2022-02-13
919,88,831,7,Forsyth,2022-01-21
2012,179,1833,7,Guilford,2022-01-11
147,26,121,7,Guilford,2022-01-16
1248,212,1036,7,Guilford,2022-01-18
488,47,441,7,Guilford,2022-01-23
3534,652,2882,7,Mecklenburg,2021-12-30
1818,305,1513,7,Mecklenburg,2022-01-02
4119,688,3431,7,Mecklenburg,2022-01-11
3193,417,2776,7,Mecklenburg,2022-01-19
341,48,293,7,Mecklenburg,2022-02-06
688,112,576,7,Mecklenburg,2022-02-07
20,11,9,7,Surry,2022-02-12
330,81,249,8,Cabarrus,2022-01-28
109,21,88,8,Cleveland,2022-02-03
279,50,229,8,Forsyth,2022-02-07
731,134,597,8,Gaston,2022-01-18
321,47,274,8,Guilford,2022-02-04
1001,169,832,8,Mecklenburg,2022-01-23
514,97,417,8,Mecklenburg,2022-01-29
887,88,799,8,Wake,2022-02-08
113,8,105,9,Forsyth,2022-02-06
752,105,647,9,Guilford,2022-01-26
1172,189,983,9,Mecklenburg,2022-01-31
1011,112,899,10,Forsyth,2022-01-24
654,93,561,10,Guilford,2022-01-27
3723,504,3219,10,Mecklenburg,2022-01-13
69,9,60,10,Onslow,2022-01-29
1812,305,1507,11,Mecklenburg,2022-01-25
578,109,469,11,Mecklenburg,2022-02-08
669,91,578,12,Mecklenburg,2022-02-04
