Reinfection,Total Cases by Date of Specimen collection,Total Antigen Cases by Date of Specimen Collection,Total Molecular Cases by Date of Specimen Collection,Death by Date of Death,County,Date
1,67,12,55,0,Brunswick,2021-12-16
0,26,0,26,0,Greene,2021-12-16
4,74,24,50,1,New Hanover,2021-12-16
1,75,8,67,1,Alamance,2021-12-16
0,52,8,44,0,Harnett,2021-12-16
0,55,19,36,0,Surry,2021-12-16
0,11,0,11,0,Beaufort,2021-12-16
0,30,4,26,0,Chatham,2021-12-16
3,106,42,64,0,Iredell,2021-12-16
0,10,1,9,0,Hoke,2021-12-16
5,112,24,88,2,Gaston,2021-12-16
0,38,3,35,0,Nash,2021-12-16
0,25,11,14,0,Yadkin,2021-12-16
0,28,1,27,0,Lee,2021-12-16
0,7,3,4,0,Swain,2021-12-16
2,71,31,40,0,Catawba,2021-12-16
1,28,18,10,1,Wayne,2021-12-17
0,17,9,8,0,Greene,2021-12-17
2,67,5,62,1,Davidson,2021-12-16
0,22,6,16,1,Haywood,2021-12-17
1,104,24,80,3,Iredell,2021-12-17
1,11,4,7,0,Madison,2021-12-16
0,7,1,6,0,Anson,2021-12-16
0,10,8,2,0,Avery,2021-12-17
0,8,2,6,0,Bladen,2021-12-17
0,51,19,32,0,Henderson,2021-12-17
2,41,7,34,0,Cleveland,2021-12-16
1,21,6,15,1,Jackson,2021-12-16
1,16,4,12,1,Halifax,2021-12-17
1,37,3,34,1,Stanly,2021-12-17
1,18,5,13,0,Granville,2021-12-17
0,30,12,18,0,Davie,2021-12-17
1,97,14,83,3,Forsyth,2021-12-19
1,130,9,121,1,Guilford,2021-12-19
4,45,18,27,0,Randolph,2021-12-19
0,20,5,15,0,Stokes,2021-12-19
0,10,3,7,0,Haywood,2021-12-19
1,27,1,26,1,Rockingham,2021-12-19
1,25,7,18,0,Rowan,2021-12-19
3,33,1,32,0,Alamance,2021-12-19
3,119,4,115,1,Alamance,2021-12-21
2,68,19,49,1,Gaston,2021-12-19
2,261,30,231,2,Forsyth,2021-12-21
0,5,2,3,0,Greene,2021-12-19
5,154,63,91,1,Iredell,2021-12-21
2,85,23,62,0,Randolph,2021-12-21
0,15,0,15,0,Pender,2021-12-19
2,42,8,34,0,Chatham,2021-12-21
5,73,4,69,1,Onslow,2021-12-21
1,20,0,20,0,Dare,2021-12-21
3,88,10,78,1,Rowan,2021-12-21
1,19,7,12,0,Columbus,2021-12-21
1,28,4,24,1,Lee,2021-12-21
1,19,7,12,0,Currituck,2021-12-21
4,64,23,41,1,Robeson,2021-12-21
0,5,2,3,0,Jones,2021-12-21
0,16,7,9,0,Ashe,2021-12-21
29,402,88,314,0,Brunswick,2022-01-05
14,161,51,110,0,Wilkes,2022-01-05
421,6272,228,6044,2,Wake,2022-01-05
43,456,37,419,0,Nash,2022-01-05
45,530,202,328,2,Catawba,2022-01-05
81,646,37,609,1,Pitt,2022-01-05
2,39,20,19,0,Swain,2022-01-05
110,1383,80,1303,1,Durham,2022-01-05
7,110,47,63,3,Iredell,2021-12-26
4,64,3,61,1,Rowan,2021-12-26
77,749,86,663,3,Gaston,2022-01-05
19,204,56,148,0,Scotland,2022-01-05
5,36,10,26,0,Pender,2021-12-26
39,788,113,675,0,Wake,2021-12-26
15,194,88,106,0,Surry,2022-01-05
4,112,14,98,0,Pender,2022-01-05
38,480,69,411,3,Davidson,2022-01-05
30,553,147,406,1,New Hanover,2022-01-05
5,107,18,89,1,Alamance,2021-12-26
14,395,42,353,2,Guilford,2021-12-26
20,229,54,175,0,Craven,2022-01-05
2,27,5,22,0,Jackson,2021-12-26
26,395,20,375,0,Franklin,2022-01-05
10,85,15,70,0,Anson,2022-01-05
2,57,18,39,0,Surry,2021-12-26
1,32,4,28,0,Perquimans,2022-01-05
107,1267,119,1148,2,Cumberland,2022-01-05
4,181,25,156,1,Vance,2022-01-05
6,82,7,75,0,Madison,2022-01-05
3,46,5,41,0,Lincoln,2021-12-26
7,128,18,110,1,Union,2021-12-26
19,263,8,255,1,Edgecombe,2022-01-05
11,108,25,83,0,Pasquotank,2022-01-05
6,127,20,107,2,Hertford,2022-01-05
2,33,13,20,1,Henderson,2021-12-26
2,130,51,79,0,Carteret,2022-01-05
6,78,8,70,0,Martin,2022-01-05
2,12,9,3,0,Yancey,2021-12-26
4,118,23,95,0,Person,2022-01-05
2,25,5,20,0,Alleghany,2022-01-05
6,52,21,31,0,Greene,2022-01-05
1,18,3,15,0,Clay,2022-01-05
1,35,16,19,0,Polk,2022-01-05
76,1023,108,915,4,Forsyth,2022-01-07
33,348,56,292,1,Rowan,2022-01-07
31,441,90,351,2,Harnett,2022-01-07
99,1383,219,1164,4,Guilford,2022-01-07
13,258,50,208,1,Rockingham,2022-01-07
13,161,12,149,0,Lee,2022-01-07
0,11,0,11,1,Gates,2022-01-07
44,555,84,471,2,Gaston,2022-01-07
7,94,25,69,0,Yadkin,2022-01-07
4,49,1,48,0,Caswell,2022-01-07
2,46,2,44,2,Bertie,2022-01-07
14,142,25,117,0,Beaufort,2022-01-07
23,573,79,494,2,Onslow,2022-01-07
9,91,20,71,0,Stokes,2022-01-07
8,140,55,85,0,Carteret,2022-01-07
7,78,0,78,0,Dare,2022-01-07
19,167,14,153,0,Richmond,2022-01-07
3,41,6,35,0,Greene,2022-01-07
5,88,23,65,1,Haywood,2022-01-07
116,1756,267,1489,1,Guilford,2022-01-13
89,1424,150,1274,3,Forsyth,2022-01-13
29,261,57,204,2,Richmond,2022-01-13
48,399,80,319,1,Cleveland,2022-01-13
6,109,1,108,0,Dare,2022-01-13
46,640,61,579,3,Alamance,2022-01-13
70,692,144,548,0,Gaston,2022-01-13
16,273,29,244,1,Rockingham,2022-01-13
21,285,49,236,0,Lee,2022-01-13
7,125,14,111,0,Greene,2022-01-13
12,151,29,122,0,Yadkin,2022-01-13
11,182,34,148,1,Randolph,2022-01-09
9,76,8,68,0,Caswell,2022-01-13
10,85,35,50,0,Stanly,2022-01-09
6,67,16,51,1,Lee,2022-01-09
24,359,71,288,1,Johnston,2022-01-09
15,224,48,176,0,Onslow,2022-01-09
12,220,27,193,0,Pender,2022-01-13
8,123,16,107,0,Jackson,2022-01-13
25,275,59,216,1,Lenoir,2022-01-13
16,276,44,232,0,Alamance,2022-01-09
15,163,44,119,1,Wayne,2022-01-09
3,24,6,18,0,Northampton,2022-01-09
5,25,2,23,0,Clay,2022-01-07
1,40,7,33,0,Columbus,2022-01-09
29,259,45,214,5,Gaston,2022-01-09
10,211,86,125,1,Iredell,2022-01-09
20,205,31,174,0,Beaufort,2022-01-13
11,125,31,94,1,Rowan,2022-01-09
8,93,37,56,1,Wilson,2022-01-09
4,65,33,32,0,Pasquotank,2022-01-13
9,195,85,110,2,Carteret,2022-01-13
21,275,40,235,0,Buncombe,2022-01-09
2,49,9,40,0,Granville,2022-01-09
8,92,5,87,0,Martin,2022-01-13
2,56,13,43,0,Chatham,2022-01-09
2,34,0,34,1,Dare,2022-01-09
2,55,4,51,0,Haywood,2022-01-09
12,158,10,148,1,Vance,2022-01-13
3,39,15,24,0,Swain,2022-01-13
1,14,1,13,0,Warren,2022-01-09
3,48,30,18,0,Watauga,2022-02-14
31,611,51,560,1,Wake,2022-02-14
5,55,21,34,0,Henderson,2022-02-14
28,361,62,299,2,Mecklenburg,2022-02-14
1,19,0,19,0,Halifax,2022-02-14
13,76,32,44,0,Burke,2022-02-14
12,182,18,164,2,Cumberland,2022-02-14
7,117,15,102,2,Onslow,2022-02-14
1,19,1,18,0,Caswell,2022-01-09
7,48,15,33,0,Lincoln,2022-02-14
4,55,14,41,1,Harnett,2022-02-14
1,8,0,8,0,Northampton,2022-02-14
5,54,12,42,1,Caldwell,2022-02-14
3,26,12,14,1,Rutherford,2022-02-14
3,14,8,6,0,Haywood,2022-02-19
1,2,1,1,0,Scotland,2022-02-19
2,13,0,13,0,Edgecombe,2022-02-14
1,13,5,8,0,Alexander,2022-02-14
4,35,14,21,1,Sampson,2022-02-14
4,20,11,9,1,Randolph,2022-02-19
0,35,11,24,1,Union,2022-02-19
0,12,10,2,0,Iredell,2022-02-26
0,2,0,2,0,Currituck,2022-02-26
0,4,0,4,0,Lenoir,2022-02-19
1,26,14,12,0,Henderson,2022-02-19
1,26,8,18,5,Guilford,2022-02-26
12,148,17,131,0,Wake,2022-03-02
1,21,5,16,2,Gaston,2022-03-02
0,10,0,10,0,Dare,2022-03-03
1,6,0,6,0,Avery,2022-03-03
6,51,5,46,1,Cumberland,2022-03-03
1,13,1,12,0,Alamance,2022-03-07
1,16,4,12,0,Davidson,2022-03-07
2,15,1,14,1,Alamance,2022-03-08
0,1,0,1,0,Montgomery,2022-03-08
2,22,4,18,1,Forsyth,2022-03-14
1,30,2,28,1,Cumberland,2022-03-14
0,3,0,3,0,Rockingham,2022-03-14
2,5,3,2,0,Davidson,2022-03-23
1,6,1,5,0,Haywood,2022-03-23
1,5,1,4,0,Chatham,2022-02-19
1,1,0,1,0,Columbus,2022-04-02
0,7,1,6,1,Alamance,2022-04-02
0,2,0,2,0,Perquimans,2022-03-02
1,9,1,8,0,Cleveland,2022-03-02
2,6,4,2,1,Jackson,2022-03-02
2,15,4,11,0,Harnett,2022-03-03
2,17,5,12,0,Cabarrus,2022-03-03
0,3,3,0,0,Henderson,2022-04-04
8,151,18,133,0,Wake,2022-04-05
0,1,1,0,0,Hoke,2022-04-05
1,12,7,5,0,Iredell,2022-04-05
0,14,2,12,1,Gaston,2022-03-07
0,3,1,2,0,Pasquotank,2022-03-07
3,21,8,13,0,Catawba,2022-03-07
4,37,8,29,1,Guilford,2022-03-07
0,14,4,10,0,New Hanover,2022-03-07
0,8,1,7,0,Lenoir,2022-03-07
5,31,6,25,0,Guilford,2022-03-14
5,37,8,29,1,Guilford,2022-03-23
1,21,6,15,6,Rowan,2022-02-19
1,10,2,8,0,Rockingham,2022-02-19
1,4,2,2,1,Randolph,2022-04-12
10,155,26,129,0,Mecklenburg,2022-04-12
0,8,1,7,0,Wayne,2022-04-12
0,1,0,1,0,Onslow,2022-04-02
0,3,1,2,0,Chatham,2022-04-02
0,18,3,15,0,Alamance,2022-04-05
4,25,4,21,0,Cumberland,2022-04-05
0,6,4,2,0,Nash,2022-03-02
3,21,9,12,0,Iredell,2022-03-02
1,11,2,9,0,Carteret,2022-03-02
0,1,0,1,0,Granville,2022-03-06
0,5,0,5,0,Polk,2022-02-26
1,24,6,18,1,Cumberland,2022-04-12
0,4,0,4,0,Vance,2022-03-07
0,8,1,7,0,Moore,2022-03-07
1,3,1,2,1,Davie,2022-03-08
0,1,0,1,0,Greene,2022-03-08
1,24,5,19,1,Union,2022-03-02
1,17,4,13,0,Onslow,2022-03-03
1,15,3,12,4,Guilford,2022-03-06
1,15,3,12,0,Pitt,2022-03-07
3,9,2,7,0,Lee,2022-03-14
1,4,1,3,0,Onslow,2022-03-23
4,12,3,9,1,Cleveland,2022-04-25
12,112,18,94,0,Cumberland,2022-04-25
1,4,0,4,0,Stanly,2022-04-25
11,160,42,118,1,Guilford,2022-04-25
0,21,6,15,0,Davidson,2022-04-25
0,1,0,1,0,Gates,2022-04-25
1,6,4,2,0,Yancey,2022-04-25
0,5,2,3,0,Haywood,2022-04-04
0,6,1,5,0,Harnett,2022-04-05
0,1,0,1,0,Perquimans,2022-04-25
4,57,11,46,0,Alamance,2022-04-25
1,16,2,14,0,Chatham,2022-04-28
4,84,12,72,0,Forsyth,2022-04-28
1,6,2,4,0,Rowan,2022-04-04
3,37,9,28,0,Johnston,2022-04-28
8,112,21,91,0,Guilford,2022-04-28
0,1,0,1,0,Washington,2022-04-05
0,5,4,1,0,Burke,2022-04-28
2,11,4,7,0,Robeson,2022-04-12
11,138,27,111,0,Forsyth,2022-05-02
3,9,4,5,0,Edgecombe,2022-05-02
1,12,4,8,0,Stanly,2022-05-02
2,29,17,12,0,Watauga,2022-05-02
2,14,3,11,0,Halifax,2022-05-02
6,84,22,62,0,Cumberland,2022-05-02
4,27,8,19,0,Chatham,2022-05-03
2,5,2,3,0,Greene,2022-05-03
2,29,11,18,0,Catawba,2022-05-03
1,9,0,9,0,Rockingham,2022-05-03
0,14,6,8,0,Scotland,2022-05-03
2,16,4,12,0,Carteret,2022-05-03
5,33,23,10,0,Robeson,2022-05-05
5,55,10,45,0,Union,2022-05-05
0,10,6,4,0,Columbus,2022-05-02
3,39,10,29,0,Johnston,2022-04-25
8,72,13,59,0,Union,2022-05-03
7,60,10,50,0,Alamance,2022-05-03
2,45,21,24,0,Iredell,2022-05-03
1,11,1,10,0,Lee,2022-05-08
2,4,0,4,0,Wilkes,2022-04-25
0,27,2,25,0,Brunswick,2022-04-25
3,20,10,10,0,Henderson,2022-05-02
0,7,0,7,0,Caswell,2022-04-25
3,12,0,12,0,Dare,2022-05-03
4,33,5,28,0,Pitt,2022-05-03
1,10,1,9,0,Pender,2022-05-03
4,27,3,24,0,Franklin,2022-05-03
2,13,4,9,0,Cleveland,2022-05-03
2,16,2,14,0,Rowan,2022-04-28
2,14,6,8,0,Hoke,2022-05-05
2,4,0,4,0,Halifax,2022-05-14
3,37,6,31,0,Alamance,2022-05-14
1,17,5,12,0,Henderson,2022-05-14
0,5,2,3,0,Greene,2022-05-05
39,642,51,591,0,Wake,2022-05-14
0,2,2,0,0,Polk,2022-05-05
1,42,6,36,0,Johnston,2022-05-14
12,138,24,114,2,Guilford,2022-05-14
2,5,0,5,0,Montgomery,2022-05-02
3,40,10,30,0,New Hanover,2022-05-03
2,7,1,6,0,Lenoir,2022-05-03
1,33,5,28,0,Gaston,2022-05-03
1,56,8,48,0,Forsyth,2022-05-08
3,22,6,16,0,Harnett,2022-05-08
22,235,45,190,0,Guilford,2022-05-17
7,83,7,76,0,Gaston,2022-05-17
14,105,17,88,0,Union,2022-05-17
7,72,16,56,0,Davidson,2022-05-17
2,20,0,20,0,Rowan,2022-05-14
2,11,2,9,0,Caldwell,2022-05-14
0,15,4,11,0,Haywood,2022-05-17
1,12,2,10,0,Stanly,2022-05-14
2,12,4,8,0,Haywood,2022-05-14
1,11,5,6,0,Robeson,2022-05-08
2,27,6,21,0,Hoke,2022-05-17
9,63,22,41,0,Catawba,2022-05-17
6,79,15,64,0,New Hanover,2022-05-17
3,23,5,18,0,Lincoln,2022-05-17
5,22,6,16,0,Columbus,2022-05-17
1,13,8,5,0,Scotland,2022-05-17
2,35,7,28,0,New Hanover,2022-05-21
3,25,10,15,0,Robeson,2022-05-21
3,38,2,36,0,Alamance,2022-05-21
2,17,7,10,0,Lincoln,2022-05-14
1,9,6,3,0,Haywood,2022-05-21
3,16,6,10,0,Watauga,2022-05-14
0,4,1,3,0,Martin,2022-05-14
7,93,11,82,0,Forsyth,2022-05-21
3,63,30,33,1,Craven,2022-05-17
4,30,5,25,0,Rockingham,2022-05-17
15,181,40,141,0,Forsyth,2022-05-25
9,107,23,84,0,Cumberland,2022-05-25
1,17,3,14,0,Pender,2022-05-25
18,209,32,177,0,Guilford,2022-05-25
1,6,0,6,0,Montgomery,2022-05-25
10,69,44,25,0,Robeson,2022-05-25
1,25,14,11,0,Haywood,2022-05-25
5,76,13,63,1,Gaston,2022-05-25
0,5,0,5,0,Bertie,2022-05-17
0,9,0,9,0,Currituck,2022-05-17
11,50,7,43,0,Franklin,2022-05-17
1,12,3,9,0,Beaufort,2022-05-17
4,18,10,8,0,Lenoir,2022-05-25
1,22,4,18,0,Chatham,2022-05-25
8,47,32,15,0,Randolph,2022-05-25
1,9,7,2,0,Yancey,2022-05-25
5,43,6,37,0,Gaston,2022-05-21
25,89,50,39,0,Robeson,2022-05-31
0,17,5,12,0,Columbus,2022-05-31
13,147,26,121,0,Onslow,2022-05-31
4,40,18,22,1,Randolph,2022-05-31
22,224,35,189,0,Forsyth,2022-05-31
2,42,7,35,0,Granville,2022-05-31
25,215,33,182,0,Cumberland,2022-05-31
1,8,3,5,0,Greene,2022-05-31
12,87,18,69,0,Davidson,2022-05-31
1,14,2,12,0,Stokes,2022-05-21
11,72,25,47,0,Harnett,2022-05-31
2,32,7,25,0,Lee,2022-05-31
2,8,5,3,0,Perquimans,2022-05-31
1,26,4,22,0,Burke,2022-05-31
4,35,4,31,0,Rockingham,2022-05-31
3,24,3,21,0,Bladen,2022-05-31
1,4,2,2,0,Pamlico,2022-05-31
0,15,6,9,0,Pasquotank,2022-06-02
2,14,6,8,0,Burke,2022-06-02
10,106,9,97,0,Onslow,2022-06-02
9,34,15,19,0,Randolph,2022-06-02
1,8,2,6,0,Columbus,2022-06-02
2,5,2,3,0,Greene,2022-05-25
0,3,1,2,0,Martin,2022-05-25
0,5,0,5,0,Perquimans,2022-05-25
2,22,8,14,0,Carteret,2022-05-25
15,60,36,24,0,Robeson,2022-06-02
2,14,7,7,0,Wilkes,2022-06-05
1,19,7,12,0,Moore,2022-06-05
5,46,9,37,1,Cabarrus,2022-06-05
26,338,68,270,0,Wake,2022-06-05
5,55,19,36,0,Buncombe,2022-06-05
1,6,0,6,0,Pender,2022-06-05
1,3,0,3,0,Clay,2022-06-05
1,15,0,15,0,Vance,2022-06-05
3,27,11,16,0,Haywood,2022-05-31
0,8,0,8,0,Watauga,2022-06-05
0,13,0,13,0,Burke,2022-06-05
0,10,1,9,0,Currituck,2022-05-31
1,21,11,10,0,Watauga,2022-05-31
2,33,6,27,0,Harnett,2022-06-02
14,156,20,136,0,Cumberland,2022-06-02
2,30,4,26,0,Granville,2022-06-02
2,16,1,15,0,Caswell,2022-06-02
0,22,2,20,0,Harnett,2022-06-05
2,17,2,15,0,Nash,2022-06-05
0,27,19,8,2,Wilkes,2021-12-16
0,9,3,6,0,Perquimans,2021-12-16
0,8,3,5,0,Duplin,2021-12-17
0,15,4,11,1,Pender,2021-12-16
1,7,1,6,0,Northampton,2021-12-17
0,19,6,13,1,Robeson,2021-12-19
0,15,7,8,2,Yadkin,2021-12-19
0,17,4,13,0,Carteret,2021-12-19
2,40,2,38,0,Chatham,2021-12-26
1,4,3,1,1,Mitchell,2021-12-26
4,25,6,19,0,Halifax,2021-12-26
1,15,6,9,0,Mitchell,2022-01-07
2,9,0,9,0,Bertie,2022-01-09
1,4,2,2,1,Yancey,2022-01-09
0,11,5,6,0,Avery,2022-01-09
1,28,4,24,0,Clay,2022-01-13
5,25,12,13,0,Ashe,2022-02-14
3,8,3,5,4,Robeson,2022-02-19
2,33,5,28,1,Forsyth,2022-02-19
0,6,2,4,0,Lee,2022-02-19
0,1,1,0,0,Scotland,2022-02-26
0,2,1,1,0,Macon,2022-02-26
2,7,1,6,2,Lincoln,2022-03-02
2,15,7,8,1,Surry,2022-03-02
1,11,5,6,0,Watauga,2022-03-02
2,17,0,17,1,Brunswick,2022-03-02
2,8,0,8,0,Rowan,2022-02-26
0,1,0,1,0,Pender,2022-03-02
0,3,1,2,0,Mitchell,2022-02-26
0,5,2,3,0,Madison,2022-03-02
2,7,4,3,0,Wayne,2022-03-03
0,14,4,10,0,Forsyth,2022-03-06
0,11,2,9,0,Iredell,2022-03-07
0,4,0,4,0,Richmond,2022-03-07
0,8,1,7,0,Iredell,2022-03-06
0,3,0,3,0,Rockingham,2022-03-06
1,2,0,2,0,Martin,2022-03-07
3,18,7,11,0,Wilkes,2022-03-02
0,5,3,2,0,Clay,2022-03-02
0,3,1,2,0,Tyrrell,2022-03-03
0,4,0,4,0,Yadkin,2022-03-07
0,5,2,3,0,Surry,2022-03-08
1,6,0,6,0,Dare,2022-03-07
0,4,1,3,1,Onslow,2022-03-14
0,12,1,11,0,Rockingham,2022-03-07
1,14,5,9,1,Harnett,2022-03-14
1,13,4,9,0,Cabarrus,2022-03-08
1,3,0,3,0,Pender,2022-03-08
0,9,2,7,0,Johnston,2022-03-08
0,2,0,2,0,Currituck,2022-03-08
0,4,1,3,1,Sampson,2022-03-07
1,5,2,3,1,Cleveland,2022-03-07
1,8,0,8,0,Gaston,2022-03-14
1,4,0,4,0,Rowan,2022-03-23
0,5,1,4,0,Harnett,2022-03-23
1,9,1,8,0,Forsyth,2022-04-02
0,1,0,1,0,Burke,2022-04-02
0,1,0,1,0,Yancey,2022-04-04
0,2,1,1,0,Onslow,2022-04-04
1,9,1,8,0,Gaston,2022-04-05
0,1,1,0,0,Scotland,2022-04-05
3,11,4,7,1,Guilford,2022-04-02
0,4,0,4,0,Caldwell,2022-04-02
0,3,1,2,0,Madison,2022-04-05
4,15,6,9,0,Davidson,2022-04-05
1,24,5,19,0,Henderson,2022-04-12
1,20,3,17,2,Gaston,2022-04-12
0,9,0,9,0,Onslow,2022-04-12
0,1,0,1,0,Camden,2022-04-12
0,6,1,5,0,Beaufort,2022-04-28
1,6,1,5,0,Haywood,2022-04-28
1,2,1,1,0,Perquimans,2022-04-28
1,1,0,1,0,Montgomery,2022-04-28
2,25,5,20,0,Gaston,2022-04-28
0,3,0,3,0,Northampton,2022-05-02
0,16,6,10,0,Person,2022-05-02
0,27,5,22,0,Granville,2022-05-02
0,6,4,2,0,Pamlico,2022-05-02
2,29,1,28,0,Davidson,2022-05-03
1,9,1,8,0,Beaufort,2022-05-02
1,7,3,4,1,Jackson,2022-05-02
2,13,8,5,0,Hoke,2022-05-03
3,9,1,8,1,Wilkes,2022-05-03
6,19,8,11,0,Randolph,2022-05-05
1,29,6,23,0,Chatham,2022-05-05
1,3,3,0,0,Yancey,2022-05-05
1,5,3,2,0,Currituck,2022-05-08
2,39,8,31,0,Cumberland,2022-05-08
2,16,10,6,0,Randolph,2022-05-08
2,14,5,9,1,Onslow,2022-05-08
0,1,0,1,0,Bertie,2022-05-14
2,5,2,3,0,Montgomery,2022-05-14
2,3,3,0,0,Yancey,2022-05-14
1,9,1,8,0,Pender,2022-05-14
1,18,2,16,0,Rockingham,2022-05-14
1,15,1,14,0,Chatham,2022-05-14
1,20,5,15,0,Yadkin,2022-05-17
0,21,7,14,0,Carteret,2022-05-17
1,19,5,14,0,Vance,2022-05-17
1,4,0,4,0,Bertie,2022-05-21
1,16,6,10,0,Yadkin,2022-05-25
2,48,15,33,0,Harnett,2022-05-25
1,26,6,20,0,Lee,2022-05-25
1,4,2,2,0,Bertie,2022-05-25
2,8,3,5,0,Northampton,2022-05-25
0,15,4,11,0,Martin,2022-05-31
2,14,6,8,0,Northampton,2022-05-31
0,16,9,7,0,Haywood,2022-06-02
2,25,7,18,0,Lee,2022-06-02
1,22,3,19,0,Watauga,2022-06-02
1,6,2,4,0,Rutherford,2022-06-05
6,55,9,46,0,Cumberland,2022-06-05
3,28,2,26,0,Brunswick,2022-06-05
0,6,1,5,0,Duplin,2022-06-05
0,1,0,1,0,Pamlico,2022-06-05
0,13,2,11,0,Lenoir,2021-12-16
0,13,1,12,0,Carteret,2021-12-16
1,10,1,9,0,Lee,2021-12-19
1,8,0,8,0,Dare,2021-12-19
0,4,1,3,0,Jones,2021-12-17
0,3,0,3,0,Chowan,2021-12-19
0,6,2,4,0,Mitchell,2021-12-21
0,14,2,12,0,Onslow,2021-12-19
0,1,1,0,0,Swain,2021-12-19
0,5,1,4,0,Pamlico,2021-12-26
0,5,0,5,0,Tyrrell,2022-01-07
0,9,2,7,1,Martin,2022-02-26
0,1,0,1,0,Scotland,2022-03-02
0,9,3,6,2,Iredell,2022-03-08
0,2,0,2,0,Duplin,2022-04-05
0,4,2,2,0,Surry,2022-04-05
0,7,0,7,0,Franklin,2022-02-19
1,4,1,3,0,Greene,2022-03-03
0,2,0,2,1,Swain,2022-03-07
0,8,2,6,0,Robeson,2022-03-14
0,5,4,1,0,Pender,2022-03-14
1,13,4,9,0,Pender,2022-04-25
1,3,0,3,0,Caldwell,2022-03-14
1,4,0,4,0,Lee,2022-04-04
1,11,8,3,0,Robeson,2022-04-04
4,16,4,12,0,Harnett,2022-04-28
0,1,1,0,0,Bertie,2022-04-12
1,1,1,0,0,Currituck,2022-05-02
0,4,0,4,0,Chatham,2022-02-26
1,7,0,7,0,Jackson,2022-02-26
1,4,3,1,0,Ashe,2022-03-03
0,3,1,2,0,Jackson,2022-05-05
0,1,0,1,0,Jackson,2022-03-07
2,10,0,10,0,Dare,2022-04-25
0,2,1,1,0,Greene,2022-04-25
0,4,0,4,0,Bertie,2022-04-28
0,4,1,3,0,Lenoir,2022-04-28
2,14,4,10,0,Brunswick,2022-04-05
0,3,0,3,0,Pasquotank,2022-04-12
0,10,5,5,0,Jackson,2022-05-03
4,20,5,15,0,Stokes,2022-05-17
0,4,1,3,0,Macon,2022-05-17
0,2,2,0,0,Swain,2022-05-17
1,10,1,9,0,Pender,2022-05-05
2,11,4,7,0,Surry,2022-04-25
0,10,3,7,0,Currituck,2022-05-21
0,4,2,2,0,Warren,2022-05-02
2,7,0,7,0,Beaufort,2022-05-03
5,21,7,14,0,Halifax,2022-05-25
1,12,9,3,0,Richmond,2022-05-17
0,9,0,9,0,Caswell,2022-05-31
0,3,0,3,0,Montgomery,2022-05-21
1,14,0,14,0,Caldwell,2022-06-05
3,6,3,3,0,Alleghany,2022-06-02
3,7,0,7,0,Bladen,2022-06-05
0,6,0,6,0,Pasquotank,2022-06-05
0,4,2,2,0,Pamlico,2022-06-02
0,5,0,5,0,Granville,2022-06-05
0,2,0,2,0,Gates,2021-12-17
0,1,0,1,0,Clay,2021-12-16
0,6,2,4,0,Scotland,2021-12-16
0,7,0,7,0,Bertie,2021-12-16
0,1,0,1,0,Clay,2021-12-19
0,6,1,5,0,Warren,2021-12-21
0,1,0,1,0,Hyde,2021-12-26
0,3,0,3,0,Gates,2022-01-09
0,5,1,4,0,Camden,2022-01-09
0,3,0,3,0,Hyde,2022-01-09
2,13,0,13,1,Montgomery,2022-02-14
0,4,2,2,0,Yancey,2022-02-19
2,14,4,10,1,Union,2022-02-26
0,7,3,4,0,Moore,2022-02-26
0,3,0,3,1,Stanly,2022-03-03
0,10,2,8,1,Union,2022-03-07
0,16,1,15,0,Rowan,2022-03-02
0,3,0,3,0,Hoke,2022-02-26
0,4,3,1,0,Henderson,2022-03-08
0,7,0,7,0,Caldwell,2022-03-06
2,9,5,4,0,Scotland,2022-03-07
1,4,0,4,1,Beaufort,2022-03-07
0,7,1,6,0,Lenoir,2022-03-02
0,3,1,2,0,Edgecombe,2022-03-07
0,4,0,4,0,Dare,2022-03-08
1,8,3,5,0,Lincoln,2022-03-07
3,11,3,8,0,Caldwell,2022-03-03
1,3,2,1,0,Avery,2022-03-08
2,9,1,8,1,Harnett,2022-03-08
0,3,0,3,0,Currituck,2022-03-06
0,4,3,1,0,Ashe,2022-03-08
3,10,4,6,0,Iredell,2022-03-24
1,8,0,8,0,Alamance,2022-03-23
1,3,1,2,0,Randolph,2022-04-04
0,3,0,3,0,Onslow,2022-03-24
0,2,0,2,0,Surry,2022-03-24
1,2,1,1,1,Henderson,2022-03-24
0,1,1,0,0,Burke,2022-04-04
1,1,0,1,0,Warren,2022-04-12
0,4,0,4,0,Caldwell,2022-04-12
0,11,3,8,0,Johnston,2022-04-12
0,3,1,2,0,Granville,2022-04-12
0,1,0,1,0,Davie,2022-04-12
0,4,0,4,0,Macon,2022-04-25
1,8,3,5,0,Beaufort,2022-04-25
2,9,2,7,0,Hoke,2022-04-25
0,2,0,2,0,Stanly,2022-04-28
0,4,0,4,0,Cherokee,2022-05-03
4,23,8,15,0,Rowan,2022-05-05
1,1,0,1,0,Macon,2022-05-05
0,5,1,4,0,Richmond,2022-05-03
1,7,2,5,0,Surry,2022-05-05
0,6,1,5,0,Lee,2022-05-05
0,7,6,1,0,Watauga,2022-05-08
0,1,0,1,0,Martin,2022-05-08
0,2,0,2,0,Bladen,2022-05-08
0,8,0,8,0,Burke,2022-05-14
0,5,0,5,0,Anson,2022-05-25
5,21,12,9,0,Richmond,2022-05-25
1,9,4,5,0,Martin,2022-06-02
4,17,3,14,0,Caldwell,2022-06-02
0,7,3,4,0,Wilson,2022-06-05
1,11,0,11,0,Bladen,2022-06-02
0,9,6,3,0,Sampson,2022-06-05
0,4,0,4,0,Hertford,2021-12-17
0,3,1,2,0,Gates,2021-12-26
0,3,1,2,0,Martin,2022-02-19
0,1,0,1,0,Caswell,2022-03-03
2,2,2,0,1,Avery,2022-03-06
0,5,1,4,0,Rockingham,2022-03-08
1,2,2,0,0,Wayne,2022-03-24
1,5,1,4,0,Stokes,2022-02-19
0,2,0,2,0,Henderson,2022-04-02
1,3,1,2,0,Lenoir,2022-04-05
0,3,2,1,0,Haywood,2022-03-14
0,4,2,2,0,Carteret,2022-02-19
0,4,4,0,0,Avery,2022-04-12
0,1,1,0,0,Columbus,2022-03-06
0,4,1,3,1,Alexander,2022-03-07
0,6,1,5,0,Granville,2022-03-03
0,7,1,6,0,Randolph,2022-03-14
0,4,0,4,0,Lincoln,2022-04-02
0,1,0,1,0,Greene,2022-04-28
0,3,0,3,0,Halifax,2022-04-28
0,8,2,6,0,Craven,2022-04-12
0,3,0,3,0,Martin,2022-05-03
0,8,0,8,0,Dare,2022-05-05
0,10,7,3,0,Henderson,2022-04-28
0,4,3,1,0,Ashe,2022-05-08
1,7,0,7,0,Halifax,2022-05-21
0,12,5,7,2,Rutherford,2021-12-17
0,9,3,6,1,Richmond,2021-12-19
0,4,1,3,0,Caswell,2021-12-19
0,9,4,5,0,Chatham,2021-12-19
0,3,0,3,0,Montgomery,2021-12-26
0,7,2,5,1,Hoke,2022-03-08
0,2,1,1,0,Bertie,2022-03-02
0,1,1,0,0,Jones,2022-03-08
0,3,0,3,0,Rockingham,2022-03-23
0,5,0,5,0,Johnston,2022-04-02
0,3,1,2,0,Lee,2022-04-12
0,5,1,4,0,Rockingham,2022-04-12
0,1,0,1,0,Jones,2022-04-12
0,1,1,0,0,Vance,2022-04-12
1,1,0,1,0,Northampton,2022-04-28
0,5,1,4,0,Montgomery,2022-05-03
0,4,1,3,0,Gates,2022-05-05
0,3,2,1,0,Madison,2022-05-08
1,4,1,3,0,Perquimans,2022-05-14
0,1,0,1,0,Northampton,2022-05-14
0,4,0,4,0,Martin,2022-05-17
0,3,2,1,0,Martin,2022-05-21
0,7,1,6,0,Richmond,2022-05-21
1,2,1,1,0,Pamlico,2022-05-25
0,2,0,2,0,Gates,2022-05-31
0,2,1,1,1,Alleghany,2022-05-31
0,3,0,3,0,Northampton,2022-06-05
0,1,0,1,0,Pender,2022-02-26
1,3,0,3,0,Pamlico,2022-02-14
1,6,4,2,0,Harnett,2022-04-12
0,1,0,1,0,Hoke,2022-03-23
2,4,2,2,0,Davie,2022-03-24
1,3,2,1,0,Haywood,2022-03-24
2,4,2,2,0,Haywood,2022-04-12
0,3,2,1,0,Lincoln,2022-02-26
0,4,0,4,1,Henderson,2022-03-06
0,5,4,1,0,Lee,2022-04-25
1,8,2,6,0,Johnston,2022-03-23
0,1,0,1,0,Caswell,2022-05-21
0,2,1,1,0,Duplin,2022-05-02
0,4,2,2,0,Clay,2022-05-17
0,1,0,1,0,Pamlico,2022-02-19
1,1,0,1,0,Mitchell,2022-02-19
0,4,0,4,2,Halifax,2022-02-19
0,1,1,0,0,Granville,2022-03-23
0,1,1,0,0,Lee,2022-04-02
0,1,1,0,0,Watauga,2022-04-02
1,6,2,4,0,Chatham,2022-04-04
0,1,0,1,1,Stanly,2022-03-23
0,1,0,1,0,Bladen,2022-04-05
0,2,0,2,0,Dare,2022-03-23
0,2,0,2,0,Nash,2022-04-05
0,1,0,1,0,Cherokee,2022-04-05
0,2,1,1,0,Jones,2022-05-02
0,2,1,1,0,Hertford,2022-05-02
0,3,2,1,0,Ashe,2022-05-05
1,6,1,5,0,Greene,2022-06-02
0,3,0,3,0,Caswell,2022-06-05
0,1,0,1,0,Hyde,2021-12-16
2,4,3,1,0,Alleghany,2021-12-19
0,3,0,3,1,Lee,2022-02-26
0,3,0,3,0,Franklin,2022-03-02
0,1,0,1,0,Greene,2022-03-23
1,1,1,0,1,Columbus,2022-04-04
0,2,0,2,0,Alexander,2022-03-02
0,1,0,1,0,McDowell,2022-04-05
1,2,1,1,0,Sampson,2022-04-12
0,2,0,2,0,Avery,2022-05-02
0,1,1,0,0,Northampton,2022-05-21
0,1,0,1,0,Ashe,2022-06-05
0,5,0,5,0,Martin,2021-12-16
0,5,3,2,0,Hoke,2022-03-02
0,2,0,2,0,Hertford,2022-03-03
0,1,0,1,0,Haywood,2022-03-06
0,6,0,6,1,Carteret,2022-03-07
0,3,0,3,0,Stanly,2022-03-08
0,1,0,1,1,Lee,2022-03-23
0,1,0,1,0,Macon,2022-04-05
0,2,0,2,0,Halifax,2022-04-04
0,3,0,3,0,Currituck,2022-05-05
0,1,0,1,0,Hyde,2022-05-25
0,1,0,1,0,Dare,2022-02-26
0,1,0,1,1,Burke,2022-03-06
0,2,0,2,0,Jackson,2022-03-08
0,1,1,0,0,Vance,2022-04-05
1,1,0,1,0,Martin,2022-03-02
0,1,1,0,0,Mitchell,2022-03-03
0,4,0,4,0,Clay,2022-03-14
0,2,1,1,0,Swain,2022-04-12
0,2,0,2,0,Columbus,2022-05-08
0,1,1,0,0,Alleghany,2022-05-08
0,1,0,1,0,Hertford,2022-06-05
1,2,1,1,0,Greene,2022-06-05
0,1,1,0,0,Polk,2022-06-05
0,2,0,2,0,Caswell,2021-12-17
1,2,0,2,0,Clay,2022-03-07
1,1,0,1,0,Stanly,2022-03-14
0,1,0,1,0,Martin,2022-03-23
0,4,3,1,0,Martin,2022-04-25
0,1,0,1,0,Madison,2022-05-03
0,2,0,2,0,Washington,2022-05-17
0,2,1,1,0,Carteret,2022-04-05
1,1,0,1,1,Bertie,2022-03-06
0,1,0,1,0,Hyde,2022-02-26
0,1,0,1,0,Vance,2022-03-02
0,1,1,0,0,Granville,2022-03-24
0,1,0,1,0,Pasquotank,2022-04-05
0,1,0,1,0,Perquimans,2022-05-03
0,1,1,0,0,Pamlico,2022-04-28
0,3,0,3,0,Caswell,2022-05-08
0,1,1,0,0,Gates,2022-05-17
0,2,0,2,0,Pamlico,2022-05-21
0,1,0,1,0,Hyde,2022-05-17
0,1,0,1,0,Bladen,2022-03-06
0,1,0,1,0,Pasquotank,2022-03-03
0,1,0,1,0,Beaufort,2022-03-23
0,1,0,1,0,Cleveland,2022-04-05
0,1,1,0,0,Halifax,2022-04-02
6,221,39,182,0,Guilford,2021-12-16
0,24,0,24,0,Dare,2021-12-16
0,34,11,23,0,Stokes,2021-12-16
4,177,25,152,3,Forsyth,2021-12-16
1,88,8,80,0,Durham,2021-12-16
1,13,2,11,0,Montgomery,2021-12-16
0,33,16,17,0,Yancey,2021-12-16
4,115,37,78,0,Cabarrus,2021-12-16
3,137,23,114,1,Cumberland,2021-12-16
5,107,24,83,0,Johnston,2021-12-16
0,62,29,33,1,Randolph,2021-12-16
0,29,5,24,0,Rockingham,2021-12-16
0,14,2,12,1,Richmond,2021-12-16
2,53,10,43,1,Onslow,2021-12-16
4,38,12,26,0,Robeson,2021-12-16
0,22,12,10,0,Transylvania,2021-12-16
4,212,32,180,0,Guilford,2021-12-17
22,510,50,460,1,Wake,2021-12-17
34,635,61,574,2,Mecklenburg,2021-12-17
3,34,14,20,0,Craven,2021-12-17
1,53,2,51,1,Orange,2021-12-17
4,133,21,112,0,Cumberland,2021-12-17
4,58,19,39,0,Harnett,2021-12-17
1,110,19,91,1,Gaston,2021-12-17
0,24,14,10,0,Wilkes,2021-12-17
1,59,7,52,0,Brunswick,2021-12-17
1,23,5,18,0,Caldwell,2021-12-17
3,15,4,11,0,Halifax,2021-12-16
2,49,6,43,0,Lincoln,2021-12-17
2,96,41,55,0,Buncombe,2021-12-17
1,20,4,16,0,Vance,2021-12-17
0,18,7,11,1,Person,2021-12-17
0,16,3,13,0,Alleghany,2021-12-17
1,15,7,8,0,Alexander,2021-12-17
0,10,0,10,0,Northampton,2021-12-16
0,12,7,5,0,Haywood,2021-12-16
1,68,14,54,0,New Hanover,2021-12-17
0,49,3,46,0,Onslow,2021-12-17
1,29,6,23,0,Burke,2021-12-17
0,6,2,4,0,Pasquotank,2021-12-17
0,12,4,8,1,Alleghany,2021-12-16
0,2,0,2,0,Camden,2021-12-17
0,14,9,5,0,McDowell,2021-12-17
0,70,7,63,0,Cumberland,2021-12-19
1,66,4,62,0,Durham,2021-12-19
1,63,13,50,1,Cabarrus,2021-12-19
1,56,13,43,0,Johnston,2021-12-19
0,5,1,4,1,Person,2021-12-19
0,4,1,3,0,Pamlico,2021-12-19
1,12,1,11,0,Hoke,2021-12-19
77,1419,166,1253,2,Mecklenburg,2021-12-21
6,158,23,135,0,Buncombe,2021-12-21
1,22,3,19,0,Halifax,2021-12-21
0,47,7,40,0,Davie,2021-12-21
0,13,1,12,0,Stanly,2021-12-19
0,31,6,25,1,Granville,2021-12-21
3,45,26,19,0,Wayne,2021-12-21
0,13,9,4,0,Yancey,2021-12-19
12,238,36,202,0,Cumberland,2021-12-21
7,175,27,148,1,Cabarrus,2021-12-21
7,142,21,121,0,Johnston,2021-12-21
9,115,10,105,0,Orange,2021-12-21
5,43,6,37,0,Stanly,2021-12-21
3,60,16,44,0,Henderson,2021-12-21
5,75,13,62,0,Moore,2021-12-21
0,13,3,10,0,Montgomery,2021-12-21
1,34,11,23,0,Wilson,2021-12-21
0,18,6,12,0,Avery,2021-12-21
2,42,10,32,0,Caldwell,2021-12-21
1,35,6,29,0,Burke,2021-12-21
119,1298,128,1170,2,Forsyth,2022-01-05
64,674,123,551,1,Union,2022-01-05
6,55,3,52,0,Bertie,2022-01-05
4,56,5,51,0,Washington,2022-01-05
47,359,60,299,1,Cleveland,2022-01-05
3,122,24,98,0,Johnston,2021-12-26
48,764,78,686,0,Alamance,2022-01-05
19,271,11,260,0,Durham,2021-12-26
4,65,2,63,1,Davidson,2021-12-26
93,1517,224,1293,5,Guilford,2022-01-05
21,163,53,110,0,Lenoir,2022-01-05
78,879,83,796,0,Johnston,2022-01-05
2,50,9,41,0,Harnett,2021-12-26
13,194,32,162,0,Cumberland,2021-12-26
10,60,8,52,0,Nash,2021-12-26
24,307,27,280,2,Hoke,2022-01-05
1,16,0,16,0,Beaufort,2021-12-26
1,47,4,43,0,Lee,2021-12-26
32,328,79,249,0,Rockingham,2022-01-05
20,184,31,153,1,Richmond,2022-01-05
13,115,24,91,1,Beaufort,2022-01-05
17,166,42,124,1,Jackson,2022-01-05
0,9,3,6,0,Columbus,2021-12-26
3,56,25,31,0,Transylvania,2022-01-05
5,44,9,35,2,Caldwell,2021-12-26
7,77,14,63,1,Yancey,2022-01-05
2,38,4,34,1,Rockingham,2021-12-26
0,11,0,11,0,Hertford,2021-12-26
9,67,12,55,0,Northampton,2022-01-05
14,210,30,180,1,Lee,2022-01-05
8,96,16,80,2,Yadkin,2022-01-05
7,57,2,55,0,Chowan,2022-01-05
1,63,10,53,0,Macon,2022-01-05
0,8,0,8,0,Hyde,2022-01-05
2,18,4,14,0,Avery,2022-01-07
23,259,17,242,0,Halifax,2022-01-07
62,686,51,635,2,Pitt,2022-01-07
40,409,130,279,4,Robeson,2022-01-07
85,976,95,881,1,Cumberland,2022-01-07
16,166,7,159,0,Edgecombe,2022-01-07
14,266,86,180,0,Craven,2022-01-07
77,1067,43,1024,2,Durham,2022-01-07
8,75,6,69,0,Davie,2022-01-07
27,285,89,196,1,Randolph,2022-01-07
12,113,29,84,0,Columbus,2022-01-07
6,55,3,52,1,Montgomery,2022-01-07
55,703,97,606,0,Johnston,2022-01-07
7,112,24,88,0,Chatham,2022-01-07
1,39,6,33,0,Currituck,2022-01-07
5,68,25,43,0,Pasquotank,2022-01-07
3,31,4,27,0,Pamlico,2022-01-07
20,191,92,99,0,Sampson,2022-01-07
4,79,15,64,0,Person,2022-01-07
13,158,12,146,1,Granville,2022-01-07
15,86,12,74,0,Northampton,2022-01-07
2,29,10,19,0,Ashe,2022-01-07
7,62,13,49,0,Warren,2022-01-07
0,7,5,2,0,Alleghany,2022-01-07
1,24,10,14,0,Jones,2022-01-07
61,765,115,650,0,Johnston,2022-01-13
15,119,48,71,0,Bertie,2022-01-13
73,667,253,414,0,Robeson,2022-01-13
1,36,2,34,0,Pamlico,2022-01-13
105,1274,180,1094,2,Cumberland,2022-01-13
1,14,1,13,0,Edgecombe,2021-12-16
0,8,1,7,0,Bladen,2021-12-16
25,531,72,459,2,Mecklenburg,2021-12-16
4,90,18,72,1,Union,2021-12-16
20,453,36,417,0,Wake,2021-12-16
0,18,5,13,0,Burke,2021-12-16
1,63,2,61,0,Orange,2021-12-16
2,56,20,36,0,Lincoln,2021-12-16
0,29,7,22,0,McDowell,2021-12-16
2,52,15,37,0,Henderson,2021-12-16
0,10,1,9,2,Macon,2021-12-16
0,4,0,4,0,Chowan,2021-12-16
2,34,9,25,0,Vance,2021-12-16
1,18,11,7,0,Alexander,2021-12-16
0,25,4,21,0,Chatham,2021-12-17
2,112,17,95,0,Johnston,2021-12-17
2,52,6,46,2,Rowan,2021-12-17
1,59,22,37,1,Randolph,2021-12-17
1,112,21,91,0,Cabarrus,2021-12-17
0,46,14,32,1,Surry,2021-12-17
0,19,0,19,0,Dare,2021-12-17
0,62,8,54,0,Alamance,2021-12-17
0,153,16,137,1,Forsyth,2021-12-17
1,31,18,13,1,Wayne,2021-12-16
0,47,14,33,0,Robeson,2021-12-17
1,6,1,5,0,Warren,2021-12-17
0,35,4,31,0,Stokes,2021-12-17
0,8,3,5,0,Currituck,2021-12-17
4,54,5,49,0,Pitt,2021-12-16
3,52,7,45,0,Rowan,2021-12-16
2,30,24,6,0,Yancey,2021-12-17
0,9,2,7,1,Jackson,2021-12-17
1,17,5,12,0,Watauga,2021-12-16
2,20,2,18,0,Hoke,2021-12-17
0,11,8,3,0,Mitchell,2021-12-17
20,503,49,454,2,Mecklenburg,2021-12-19
0,14,5,9,0,Lenoir,2021-12-19
12,259,47,212,2,Wake,2021-12-19
1,19,4,15,0,Lincoln,2021-12-19
0,36,2,34,1,Davidson,2021-12-19
0,31,4,27,0,Orange,2021-12-19
2,19,1,18,2,Nash,2021-12-19
3,37,10,27,0,New Hanover,2021-12-19
2,15,3,12,0,Vance,2021-12-19
1,34,8,26,0,Catawba,2021-12-19
3,68,10,58,1,Union,2021-12-19
0,20,4,16,0,Caldwell,2021-12-19
0,28,5,23,0,Brunswick,2021-12-19
1,8,4,4,0,Jackson,2021-12-19
1,64,22,42,2,Iredell,2021-12-19
0,27,8,19,1,Surry,2021-12-19
1,43,12,31,0,Hoke,2021-12-21
10,161,36,125,1,Gaston,2021-12-21
9,325,54,271,3,Guilford,2021-12-21
0,44,9,35,0,Yadkin,2021-12-21
0,5,2,3,0,Pasquotank,2021-12-19
1,27,5,22,1,Cleveland,2021-12-19
3,14,1,13,0,Bertie,2021-12-21
5,55,1,54,0,Franklin,2021-12-21
5,172,25,147,1,Union,2021-12-21
10,154,33,121,0,New Hanover,2021-12-21
0,40,5,35,0,Stokes,2021-12-21
2,35,10,25,0,Richmond,2021-12-21
2,32,12,20,0,Vance,2021-12-21
4,98,24,74,3,Catawba,2021-12-21
3,48,4,44,0,Rockingham,2021-12-21
1,78,8,70,1,Davidson,2021-12-21
0,5,2,3,0,Martin,2021-12-21
1,16,5,11,0,Scotland,2021-12-21
332,4389,635,3754,4,Mecklenburg,2022-01-05
19,264,94,170,1,Sampson,2022-01-05
3,25,9,16,0,Wilson,2021-12-26
28,235,88,147,0,Duplin,2022-01-05
1,104,20,84,0,New Hanover,2021-12-26
39,470,61,409,0,Harnett,2022-01-05
2,78,1,77,1,Moore,2021-12-26
30,272,49,223,2,Halifax,2022-01-05
48,681,230,451,0,Buncombe,2022-01-05
1,35,6,29,0,Hoke,2021-12-26
17,179,56,123,0,Watauga,2022-01-05
2,34,10,24,0,Vance,2021-12-26
19,213,43,170,0,Caldwell,2022-01-05
29,419,66,353,1,Wilson,2022-01-05
13,180,37,143,0,Gaston,2021-12-26
36,489,24,465,0,Orange,2022-01-05
2,98,18,80,1,Buncombe,2021-12-26
20,252,44,208,0,Lincoln,2022-01-05
0,21,1,20,0,Alamance,2022-03-03
0,8,0,8,0,Alamance,2022-03-10
0,4,0,4,0,Alamance,2022-03-16
0,8,0,8,0,Alamance,2022-03-18
0,1,0,1,0,Alamance,2022-03-19
0,14,1,13,0,Alamance,2022-03-21
0,7,0,7,0,Alamance,2022-03-22
0,6,2,4,0,Alamance,2022-03-25
0,7,2,5,0,Alamance,2022-03-27
0,11,7,4,0,Alamance,2022-03-29
0,8,2,6,0,Alamance,2022-04-09
0,10,1,9,0,Alamance,2022-04-10
0,32,11,21,0,Alamance,2022-04-13
0,7,1,6,0,Alamance,2022-04-16
0,9,0,9,0,Alamance,2022-04-17
0,21,3,18,0,Alamance,2022-04-24
1,81,5,76,0,Alamance,2021-12-15
1,31,6,25,0,Alamance,2021-12-25
1,16,2,14,0,Alamance,2022-02-25
1,14,4,10,0,Alamance,2022-02-26
1,34,6,28,0,Alamance,2022-02-28
1,8,0,8,0,Alamance,2022-03-11
1,5,1,4,0,Alamance,2022-03-12
1,8,0,8,0,Alamance,2022-03-15
1,2,0,2,0,Alamance,2022-03-26
1,7,2,5,0,Alamance,2022-04-03
1,17,3,14,0,Alamance,2022-04-04
1,26,7,19,0,Alamance,2022-04-07
1,37,9,28,0,Alamance,2022-04-19
1,27,10,17,0,Alamance,2022-04-20
1,20,5,15,0,Alamance,2022-04-21
1,24,3,21,0,Alamance,2022-04-22
1,34,3,31,0,Alamance,2022-04-27
1,46,8,38,0,Alamance,2022-04-29
1,21,1,20,0,Alamance,2022-04-30
1,29,3,26,0,Alamance,2022-05-29
1,27,2,25,0,Alamance,2022-06-05
2,19,1,18,0,Alamance,2022-03-04
2,8,1,7,0,Alamance,2022-03-05
2,12,1,11,0,Alamance,2022-03-30
2,31,7,24,0,Alamance,2022-04-08
2,26,4,22,0,Alamance,2022-04-14
2,24,0,24,0,Alamance,2022-05-01
2,69,18,51,0,Alamance,2022-05-05
2,32,6,26,0,Alamance,2022-05-08
2,39,3,36,0,Alamance,2022-05-28
2,28,3,25,0,Alamance,2022-06-11
3,25,4,21,0,Alamance,2022-02-24
3,33,6,27,0,Alamance,2022-03-02
3,28,9,19,0,Alamance,2022-04-15
3,32,4,28,0,Alamance,2022-04-28
3,76,15,61,0,Alamance,2022-05-10
3,30,2,28,0,Alamance,2022-06-10
4,80,5,75,0,Alamance,2022-01-22
4,29,2,27,0,Alamance,2022-03-01
4,32,5,27,0,Alamance,2022-04-12
4,37,13,24,0,Alamance,2022-04-18
4,76,8,68,0,Alamance,2022-05-19
4,82,13,69,0,Alamance,2022-05-24
5,85,10,75,0,Alamance,2022-01-30
5,63,10,53,0,Alamance,2022-05-04
5,30,7,23,0,Alamance,2022-05-07
5,37,9,28,0,Alamance,2022-05-15
5,67,17,50,0,Alamance,2022-06-07
6,69,12,57,0,Alamance,2022-05-20
6,37,9,28,0,Alamance,2022-05-30
7,50,3,47,0,Alamance,2022-02-18
7,55,18,37,0,Alamance,2022-05-02
7,103,22,81,0,Alamance,2022-05-16
7,50,8,42,0,Alamance,2022-06-03
7,48,10,38,0,Alamance,2022-06-04
7,52,11,41,0,Alamance,2022-06-09
8,94,11,83,0,Alamance,2022-02-09
8,68,15,53,0,Alamance,2022-05-06
9,107,26,81,0,Alamance,2022-02-14
9,84,7,77,0,Alamance,2022-05-26
10,104,20,84,0,Alamance,2022-01-01
10,85,11,74,0,Alamance,2022-05-13
11,144,14,130,0,Alamance,2021-12-22
11,77,11,66,0,Alamance,2022-05-11
11,74,14,60,0,Alamance,2022-05-12
12,159,25,134,0,Alamance,2021-12-23
12,91,11,80,0,Alamance,2022-06-01
12,91,17,74,0,Alamance,2022-06-06
12,64,8,56,0,Alamance,2022-06-08
13,80,7,73,0,Alamance,2022-05-25
14,205,41,164,0,Alamance,2022-01-17
14,111,9,102,0,Alamance,2022-05-23
22,174,26,148,0,Alamance,2022-02-03
23,353,55,298,0,Alamance,2022-01-25
35,446,74,372,0,Alamance,2021-12-27
39,499,55,444,0,Alamance,2021-12-29
42,504,68,436,0,Alamance,2021-12-30
46,478,41,437,0,Alamance,2021-12-28
47,537,41,496,0,Alamance,2022-01-20
,0,0,0,0,Alexander,2022-03-06
,0,0,0,0,Alexander,2022-03-20
,0,0,0,0,Alexander,2022-03-26
,0,0,0,0,Alexander,2022-03-27
,0,0,0,0,Alexander,2022-03-28
,0,0,0,0,Alexander,2022-03-29
,0,0,0,0,Alexander,2022-03-30
,0,0,0,0,Alexander,2022-04-01
,0,0,0,0,Alexander,2022-04-02
,0,0,0,0,Alexander,2022-04-03
,0,0,0,0,Alexander,2022-04-07
,0,0,0,0,Alexander,2022-04-09
,0,0,0,0,Alexander,2022-04-10
,0,0,0,0,Alexander,2022-04-15
,0,0,0,0,Alexander,2022-04-17
,0,0,0,0,Alexander,2022-04-23
,0,0,0,0,Alexander,2022-05-01
,0,0,0,0,Alexander,2022-06-05
0,11,4,7,0,Alexander,2021-12-14
0,15,9,6,0,Alexander,2021-12-15
0,8,6,2,0,Alexander,2021-12-18
0,8,5,3,0,Alexander,2021-12-19
0,19,9,10,0,Alexander,2021-12-21
0,2,0,2,0,Alexander,2021-12-25
0,14,11,3,0,Alexander,2021-12-26
0,20,10,10,0,Alexander,2022-01-01
0,13,3,10,0,Alexander,2022-01-29
0,13,3,10,0,Alexander,2022-02-15
0,5,0,5,0,Alexander,2022-02-19
0,2,0,2,0,Alexander,2022-02-22
0,1,0,1,0,Alexander,2022-02-25
0,4,1,3,0,Alexander,2022-03-03
0,1,0,1,0,Alexander,2022-03-04
0,2,1,1,0,Alexander,2022-03-05
0,1,0,1,0,Alexander,2022-03-08
0,3,0,3,0,Alexander,2022-03-09
0,1,0,1,0,Alexander,2022-03-11
0,2,2,0,0,Alexander,2022-03-14
0,1,0,1,0,Alexander,2022-03-16
0,1,0,1,0,Alexander,2022-03-17
0,2,1,1,0,Alexander,2022-03-18
0,1,0,1,0,Alexander,2022-03-19
0,2,0,2,0,Alexander,2022-03-21
0,2,0,2,0,Alexander,2022-03-23
0,2,0,2,0,Alexander,2022-03-24
0,1,0,1,0,Alexander,2022-03-25
0,1,0,1,0,Alexander,2022-03-31
0,1,1,0,0,Alexander,2022-04-04
0,2,1,1,0,Alexander,2022-04-08
0,1,1,0,0,Alexander,2022-04-11
0,3,2,1,0,Alexander,2022-04-13
0,1,0,1,0,Alexander,2022-04-14
0,1,1,0,0,Alexander,2022-04-18
0,1,0,1,0,Alexander,2022-04-20
0,1,1,0,0,Alexander,2022-04-21
0,5,2,3,0,Alexander,2022-04-22
0,1,0,1,0,Alexander,2022-04-24
0,2,0,2,0,Alexander,2022-04-30
0,2,1,1,0,Alexander,2022-05-02
0,2,1,1,0,Alexander,2022-05-06
0,1,0,1,0,Alexander,2022-05-07
0,1,1,0,0,Alexander,2022-05-08
0,5,3,2,0,Alexander,2022-05-10
0,4,1,3,0,Alexander,2022-05-11
0,4,0,4,0,Alexander,2022-05-13
0,2,1,1,0,Alexander,2022-05-14
0,2,0,2,0,Alexander,2022-05-15
0,1,1,0,0,Alexander,2022-05-21
0,2,0,2,0,Alexander,2022-05-22
0,9,1,8,0,Alexander,2022-05-25
0,2,1,1,0,Alexander,2022-05-28
0,6,2,4,0,Alexander,2022-05-29
0,3,2,1,0,Alexander,2022-05-30
0,1,0,1,0,Alexander,2022-06-04
0,7,2,5,0,Alexander,2022-06-08
0,1,1,0,0,Alexander,2022-06-11
1,25,10,15,0,Alexander,2021-12-20
1,56,16,40,0,Alexander,2022-01-07
1,17,2,15,0,Alexander,2022-01-30
1,21,7,14,0,Alexander,2022-02-11
1,9,3,6,0,Alexander,2022-02-13
1,8,2,6,0,Alexander,2022-02-28
1,3,0,3,0,Alexander,2022-03-12
1,1,1,0,0,Alexander,2022-03-13
1,2,0,2,0,Alexander,2022-03-15
1,2,2,0,0,Alexander,2022-03-22
1,2,0,2,0,Alexander,2022-04-05
1,1,1,0,0,Alexander,2022-04-06
1,2,1,1,0,Alexander,2022-04-12
1,5,4,1,0,Alexander,2022-04-25
1,7,4,3,0,Alexander,2022-04-28
1,3,2,1,0,Alexander,2022-04-29
1,6,3,3,0,Alexander,2022-05-03
1,3,0,3,0,Alexander,2022-05-04
1,3,0,3,0,Alexander,2022-05-05
1,9,6,3,0,Alexander,2022-05-09
1,3,0,3,0,Alexander,2022-05-12
1,11,3,8,0,Alexander,2022-05-19
1,8,3,5,0,Alexander,2022-05-23
1,5,0,5,0,Alexander,2022-05-27
1,6,3,3,0,Alexander,2022-06-02
1,6,1,5,0,Alexander,2022-06-03
1,10,3,7,0,Alexander,2022-06-07
1,6,0,6,0,Alexander,2022-06-09
1,8,4,4,0,Alexander,2022-06-10
2,21,13,8,0,Alexander,2021-12-22
2,31,12,19,0,Alexander,2021-12-23
2,62,35,27,0,Alexander,2021-12-27
2,62,14,48,0,Alexander,2022-01-28
2,31,12,19,0,Alexander,2022-02-08
2,13,2,11,0,Alexander,2022-02-17
2,8,1,7,0,Alexander,2022-02-23
2,3,2,1,0,Alexander,2022-04-19
2,6,1,5,0,Alexander,2022-04-26
2,8,4,4,0,Alexander,2022-04-27
2,11,5,6,0,Alexander,2022-05-17
2,9,0,9,0,Alexander,2022-05-24
2,8,3,5,0,Alexander,2022-05-26
2,8,4,4,0,Alexander,2022-06-06
3,32,4,28,0,Alexander,2022-01-02
3,23,13,10,0,Alexander,2022-01-17
3,42,10,32,0,Alexander,2022-02-04
3,23,5,18,0,Alexander,2022-02-05
3,15,3,12,0,Alexander,2022-02-12
3,13,1,12,0,Alexander,2022-02-20
3,6,1,5,0,Alexander,2022-05-16
3,13,1,12,0,Alexander,2022-05-20
4,47,29,18,0,Alexander,2021-12-28
4,53,11,42,0,Alexander,2022-01-08
4,40,8,32,0,Alexander,2022-01-09
4,65,18,47,0,Alexander,2022-01-27
4,9,3,6,0,Alexander,2022-05-31
5,46,15,31,0,Alexander,2022-02-01
6,43,1,42,0,Alexander,2022-01-15
6,39,7,32,0,Alexander,2022-02-02
6,49,16,33,0,Alexander,2022-02-07
7,64,35,29,0,Alexander,2021-12-29
7,81,39,42,0,Alexander,2021-12-30
7,78,22,56,0,Alexander,2022-01-04
7,91,31,60,0,Alexander,2022-01-05
8,96,28,68,0,Alexander,2022-01-06
8,53,23,30,0,Alexander,2022-01-22
9,37,20,17,0,Alexander,2021-12-31
9,85,19,66,0,Alexander,2022-01-21
9,72,25,47,0,Alexander,2022-01-31
10,86,21,65,0,Alexander,2022-01-25
11,104,17,87,0,Alexander,2022-01-14
12,121,27,94,0,Alexander,2022-01-13
16,98,42,56,0,Alexander,2022-01-03
16,146,44,102,0,Alexander,2022-01-19
16,129,29,100,0,Alexander,2022-01-20
17,150,44,106,0,Alexander,2022-01-11
21,130,42,88,0,Alexander,2022-01-12
23,145,63,82,0,Alexander,2022-01-10
,0,0,0,0,Alleghany,2022-02-12
,0,0,0,0,Alleghany,2022-02-27
,0,0,0,0,Alleghany,2022-03-06
,0,0,0,0,Alleghany,2022-03-07
,0,0,0,0,Alleghany,2022-03-11
,0,0,0,0,Alleghany,2022-03-12
,0,0,0,0,Alleghany,2022-03-13
,0,0,0,0,Alleghany,2022-03-14
,0,0,0,0,Alleghany,2022-03-15
,0,0,0,0,Alleghany,2022-03-17
,0,0,0,0,Alleghany,2022-03-21
,0,0,0,0,Alleghany,2022-03-22
,0,0,0,0,Alleghany,2022-03-24
,0,0,0,0,Alleghany,2022-03-26
,0,0,0,0,Alleghany,2022-03-27
,0,0,0,0,Alleghany,2022-03-28
,0,0,0,0,Alleghany,2022-03-31
,0,0,0,0,Alleghany,2022-04-01
,0,0,0,0,Alleghany,2022-04-02
,0,0,0,0,Alleghany,2022-04-03
,0,0,0,0,Alleghany,2022-04-04
,0,0,0,0,Alleghany,2022-04-05
,0,0,0,0,Alleghany,2022-04-07
,0,0,0,0,Alleghany,2022-04-09
,0,0,0,0,Alleghany,2022-04-10
,0,0,0,0,Alleghany,2022-04-11
,0,0,0,0,Alleghany,2022-04-12
,0,0,0,0,Alleghany,2022-04-14
,0,0,0,0,Alleghany,2022-04-16
,0,0,0,0,Alleghany,2022-04-17
,0,0,0,0,Alleghany,2022-04-19
,0,0,0,0,Alleghany,2022-04-20
,0,0,0,0,Alleghany,2022-04-22
,0,0,0,0,Alleghany,2022-04-24
,0,0,0,0,Alleghany,2022-04-25
,0,0,0,0,Alleghany,2022-04-26
,0,0,0,0,Alleghany,2022-04-27
,0,0,0,0,Alleghany,2022-04-30
,0,0,0,0,Alleghany,2022-05-03
,0,0,0,0,Alleghany,2022-05-12
,0,0,0,0,Alleghany,2022-06-04
,0,0,0,0,Alleghany,2022-06-05
,0,0,0,0,Alleghany,2022-06-09
,0,0,0,0,Alleghany,2022-06-10
0,9,2,7,0,Alleghany,2021-12-15
0,2,2,0,0,Alleghany,2021-12-18
0,11,4,7,0,Alleghany,2021-12-20
0,8,2,6,0,Alleghany,2021-12-21
0,4,2,2,0,Alleghany,2021-12-23
0,2,1,1,0,Alleghany,2021-12-24
0,2,2,0,0,Alleghany,2021-12-25
0,3,0,3,0,Alleghany,2021-12-26
0,15,5,10,0,Alleghany,2021-12-30
0,4,2,2,0,Alleghany,2022-01-02
0,9,6,3,0,Alleghany,2022-01-08
0,9,7,2,0,Alleghany,2022-01-09
0,37,10,27,0,Alleghany,2022-01-11
0,3,3,0,0,Alleghany,2022-01-15
0,8,5,3,0,Alleghany,2022-01-17
0,11,3,8,0,Alleghany,2022-01-18
0,4,3,1,0,Alleghany,2022-01-22
0,4,1,3,0,Alleghany,2022-01-30
0,3,0,3,0,Alleghany,2022-02-11
0,5,0,5,0,Alleghany,2022-02-16
0,6,2,4,0,Alleghany,2022-02-17
0,7,4,3,0,Alleghany,2022-02-18
0,1,0,1,0,Alleghany,2022-02-19
0,1,0,1,0,Alleghany,2022-02-20
0,9,1,8,0,Alleghany,2022-02-22
0,6,2,4,0,Alleghany,2022-02-24
0,4,0,4,0,Alleghany,2022-02-25
0,4,0,4,0,Alleghany,2022-02-26
0,4,0,4,0,Alleghany,2022-02-28
0,4,2,2,0,Alleghany,2022-03-03
0,1,1,0,0,Alleghany,2022-03-05
0,1,1,0,0,Alleghany,2022-03-08
0,3,2,1,0,Alleghany,2022-03-09
0,1,0,1,0,Alleghany,2022-03-10
0,2,2,0,0,Alleghany,2022-03-16
0,1,1,0,0,Alleghany,2022-03-19
0,3,2,1,0,Alleghany,2022-03-20
0,1,0,1,0,Alleghany,2022-03-29
0,1,1,0,0,Alleghany,2022-04-06
0,1,0,1,0,Alleghany,2022-04-08
0,1,0,1,0,Alleghany,2022-04-13
0,1,1,0,0,Alleghany,2022-04-15
0,1,1,0,0,Alleghany,2022-04-18
0,2,0,2,0,Alleghany,2022-04-21
0,1,1,0,0,Alleghany,2022-04-23
0,2,1,1,0,Alleghany,2022-04-28
0,1,0,1,0,Alleghany,2022-04-29
0,1,0,1,0,Alleghany,2022-05-01
0,1,0,1,0,Alleghany,2022-05-02
0,2,1,1,0,Alleghany,2022-05-04
0,3,1,2,0,Alleghany,2022-05-05
0,1,0,1,0,Alleghany,2022-05-06
0,1,0,1,0,Alleghany,2022-05-07
0,3,0,3,0,Alleghany,2022-05-09
0,1,0,1,0,Alleghany,2022-05-10
0,2,1,1,0,Alleghany,2022-05-11
0,1,0,1,0,Alleghany,2022-05-13
0,1,0,1,0,Alleghany,2022-05-14
0,1,0,1,0,Alleghany,2022-05-15
0,1,0,1,0,Alleghany,2022-05-16
0,11,5,6,0,Alleghany,2022-05-17
0,5,2,3,0,Alleghany,2022-05-18
0,1,0,1,0,Alleghany,2022-05-19
0,3,2,1,0,Alleghany,2022-05-21
0,1,0,1,0,Alleghany,2022-05-26
0,2,1,1,0,Alleghany,2022-05-28
0,1,1,0,0,Alleghany,2022-05-29
0,3,2,1,0,Alleghany,2022-05-30
0,3,3,0,0,Alleghany,2022-06-03
0,1,1,0,0,Alleghany,2022-06-11
1,14,6,8,0,Alleghany,2021-12-14
1,8,1,7,0,Alleghany,2021-12-22
1,7,4,3,0,Alleghany,2021-12-27
1,3,1,2,0,Alleghany,2022-01-01
1,31,12,19,0,Alleghany,2022-01-14
1,3,3,0,0,Alleghany,2022-01-16
1,24,4,20,0,Alleghany,2022-01-21
1,23,3,20,0,Alleghany,2022-01-27
1,20,6,14,0,Alleghany,2022-01-28
1,4,2,2,0,Alleghany,2022-01-29
1,22,4,18,0,Alleghany,2022-02-02
1,21,10,11,0,Alleghany,2022-02-04
1,3,2,1,0,Alleghany,2022-02-05
1,3,2,1,0,Alleghany,2022-02-06
1,13,5,8,0,Alleghany,2022-02-07
1,8,1,7,0,Alleghany,2022-02-09
1,11,5,6,0,Alleghany,2022-02-10
1,2,1,1,0,Alleghany,2022-02-13
1,11,2,9,0,Alleghany,2022-02-14
1,10,7,3,0,Alleghany,2022-02-15
1,6,1,5,0,Alleghany,2022-02-23
1,3,0,3,0,Alleghany,2022-03-01
1,2,0,2,0,Alleghany,2022-03-04
1,1,0,1,0,Alleghany,2022-03-23
1,1,1,0,0,Alleghany,2022-03-25
1,1,1,0,0,Alleghany,2022-03-30
1,2,2,0,0,Alleghany,2022-05-22
1,7,5,2,0,Alleghany,2022-05-23
1,3,2,1,0,Alleghany,2022-05-27
1,5,3,2,0,Alleghany,2022-06-07
2,28,7,21,0,Alleghany,2022-01-06
2,38,5,33,0,Alleghany,2022-01-12
2,30,10,20,0,Alleghany,2022-01-25
2,17,5,12,0,Alleghany,2022-02-03
2,7,2,5,0,Alleghany,2022-02-08
2,10,8,2,0,Alleghany,2022-02-21
2,5,2,3,0,Alleghany,2022-03-02
2,5,4,1,0,Alleghany,2022-05-20
2,5,3,2,0,Alleghany,2022-06-06
2,7,6,1,0,Alleghany,2022-06-08
3,50,12,38,0,Alleghany,2022-01-10
3,37,8,29,0,Alleghany,2022-01-19
3,21,2,19,0,Alleghany,2022-01-20
3,23,4,19,0,Alleghany,2022-01-26
3,26,7,19,0,Alleghany,2022-01-31
3,9,7,2,0,Alleghany,2022-05-24
3,5,5,0,0,Alleghany,2022-05-25
3,6,3,3,0,Alleghany,2022-06-01
4,5,4,1,0,Alleghany,2022-01-23
4,41,8,33,0,Alleghany,2022-01-24
,0,0,0,0,Anson,2022-03-02
,0,0,0,0,Anson,2022-03-08
,0,0,0,0,Anson,2022-03-09
,0,0,0,0,Anson,2022-03-11
,0,0,0,0,Anson,2022-03-17
,0,0,0,0,Anson,2022-03-19
,0,0,0,0,Anson,2022-03-23
,0,0,0,0,Anson,2022-03-24
,0,0,0,0,Anson,2022-03-25
,0,0,0,0,Anson,2022-03-26
,0,0,0,0,Anson,2022-03-27
,0,0,0,0,Anson,2022-03-28
,0,0,0,0,Anson,2022-03-29
,0,0,0,0,Anson,2022-03-30
,0,0,0,0,Anson,2022-03-31
,0,0,0,0,Anson,2022-04-01
,0,0,0,0,Anson,2022-04-02
,0,0,0,0,Anson,2022-04-03
,0,0,0,0,Anson,2022-04-04
,0,0,0,0,Anson,2022-04-05
,0,0,0,0,Anson,2022-04-07
,0,0,0,0,Anson,2022-04-08
,0,0,0,0,Anson,2022-04-09
,0,0,0,0,Anson,2022-04-10
,0,0,0,0,Anson,2022-04-11
,0,0,0,0,Anson,2022-04-12
,0,0,0,0,Anson,2022-04-13
,0,0,0,0,Anson,2022-04-15
,0,0,0,0,Anson,2022-04-16
,0,0,0,0,Anson,2022-04-17
,0,0,0,0,Anson,2022-04-18
,0,0,0,0,Anson,2022-04-19
,0,0,0,0,Anson,2022-04-21
,0,0,0,0,Anson,2022-04-22
,0,0,0,0,Anson,2022-04-23
,0,0,0,0,Anson,2022-04-24
,0,0,0,0,Anson,2022-04-25
,0,0,0,0,Anson,2022-04-26
,0,0,0,0,Anson,2022-04-27
,0,0,0,0,Anson,2022-05-01
,0,0,0,0,Anson,2022-06-04
0,8,4,4,0,Anson,2021-12-15
0,3,0,3,0,Anson,2021-12-17
0,6,0,6,0,Anson,2021-12-18
0,4,0,4,0,Anson,2021-12-19
0,13,2,11,0,Anson,2021-12-20
0,4,2,2,0,Anson,2021-12-24
0,5,0,5,0,Anson,2021-12-25
0,8,0,8,0,Anson,2022-01-16
0,24,6,18,0,Anson,2022-02-01
0,12,1,11,0,Anson,2022-02-05
0,3,1,2,0,Anson,2022-02-12
0,7,0,7,0,Anson,2022-02-15
0,3,0,3,0,Anson,2022-02-17
0,6,2,4,0,Anson,2022-02-21
0,1,1,0,0,Anson,2022-02-22
0,3,2,1,0,Anson,2022-02-24
0,2,0,2,0,Anson,2022-02-26
0,1,0,1,0,Anson,2022-02-27
0,5,1,4,0,Anson,2022-02-28
0,1,0,1,0,Anson,2022-03-03
0,1,0,1,0,Anson,2022-03-04
0,1,0,1,0,Anson,2022-03-06
0,1,0,1,0,Anson,2022-03-10
0,1,0,1,0,Anson,2022-03-12
0,1,0,1,0,Anson,2022-03-13
0,1,0,1,0,Anson,2022-03-14
0,1,0,1,0,Anson,2022-03-15
0,1,0,1,0,Anson,2022-03-16
0,1,0,1,0,Anson,2022-03-18
0,2,0,2,0,Anson,2022-03-20
0,2,0,2,0,Anson,2022-03-22
0,2,1,1,0,Anson,2022-04-14
0,1,0,1,0,Anson,2022-04-28
0,1,1,0,0,Anson,2022-04-29
0,1,1,0,0,Anson,2022-04-30
0,2,0,2,0,Anson,2022-05-02
0,4,0,4,0,Anson,2022-05-03
0,1,1,0,0,Anson,2022-05-04
0,1,0,1,0,Anson,2022-05-05
0,3,1,2,0,Anson,2022-05-06
0,3,0,3,0,Anson,2022-05-07
0,4,1,3,0,Anson,2022-05-08
0,2,0,2,0,Anson,2022-05-10
0,9,1,8,0,Anson,2022-05-12
0,5,1,4,0,Anson,2022-05-13
0,4,2,2,0,Anson,2022-05-15
0,7,0,7,0,Anson,2022-05-18
0,5,0,5,0,Anson,2022-05-19
0,5,0,5,0,Anson,2022-05-20
0,3,1,2,0,Anson,2022-05-21
0,3,0,3,0,Anson,2022-05-22
0,2,0,2,0,Anson,2022-05-30
0,9,0,9,0,Anson,2022-06-02
0,4,0,4,0,Anson,2022-06-06
0,10,0,10,0,Anson,2022-06-08
0,4,1,3,0,Anson,2022-06-10
1,17,5,12,0,Anson,2021-12-21
1,14,2,12,0,Anson,2021-12-22
1,10,1,9,0,Anson,2021-12-26
1,17,4,13,0,Anson,2022-01-22
1,21,3,18,0,Anson,2022-02-02
1,16,3,13,0,Anson,2022-02-04
1,20,4,16,0,Anson,2022-02-07
1,3,0,3,0,Anson,2022-02-18
1,6,5,1,0,Anson,2022-02-19
1,3,0,3,0,Anson,2022-02-25
1,1,0,1,0,Anson,2022-03-01
1,3,2,1,0,Anson,2022-03-07
1,1,0,1,0,Anson,2022-04-06
1,2,0,2,0,Anson,2022-04-20
1,3,0,3,0,Anson,2022-05-14
1,6,2,4,0,Anson,2022-05-16
1,3,1,2,0,Anson,2022-05-17
1,7,1,6,0,Anson,2022-05-24
1,9,3,6,0,Anson,2022-05-26
1,4,1,3,0,Anson,2022-05-28
1,5,1,4,0,Anson,2022-05-29
1,6,1,5,0,Anson,2022-06-01
1,4,0,4,0,Anson,2022-06-03
1,4,2,2,0,Anson,2022-06-05
1,8,0,8,0,Anson,2022-06-09
1,4,2,2,0,Anson,2022-06-11
2,33,7,26,0,Anson,2021-12-31
2,26,2,24,0,Anson,2022-01-08
2,14,2,12,0,Anson,2022-01-23
2,12,3,9,0,Anson,2022-01-29
2,44,10,34,0,Anson,2022-01-31
2,10,1,9,0,Anson,2022-02-11
2,7,1,6,0,Anson,2022-05-09
2,4,1,3,0,Anson,2022-05-11
2,8,0,8,0,Anson,2022-05-23
2,6,0,6,0,Anson,2022-05-27
2,8,1,7,0,Anson,2022-06-07
3,22,3,19,0,Anson,2022-01-01
3,85,18,67,0,Anson,2022-01-03
3,31,2,29,0,Anson,2022-01-15
3,36,12,24,0,Anson,2022-01-21
3,82,21,61,0,Anson,2022-01-24
3,55,16,39,0,Anson,2022-01-26
3,8,0,8,0,Anson,2022-05-31
4,53,8,45,0,Anson,2021-12-30
4,19,7,12,0,Anson,2022-02-14
5,38,7,31,0,Anson,2022-01-28
6,50,15,35,0,Anson,2021-12-27
6,44,5,39,0,Anson,2021-12-29
6,107,12,95,0,Anson,2022-01-04
6,63,10,53,0,Anson,2022-01-06
6,85,9,76,0,Anson,2022-01-07
6,105,9,96,0,Anson,2022-01-11
6,49,10,39,0,Anson,2022-01-27
7,45,6,39,0,Anson,2022-01-17
8,94,16,78,0,Anson,2022-01-13
8,57,13,44,0,Anson,2022-01-25
9,65,2,63,0,Anson,2021-12-28
9,114,19,95,0,Anson,2022-01-10
9,88,11,77,0,Anson,2022-01-12
10,110,29,81,0,Anson,2022-01-18
12,75,11,64,0,Anson,2022-01-14
,0,0,0,0,Ashe,2022-03-05
,0,0,0,0,Ashe,2022-03-13
,0,0,0,0,Ashe,2022-03-15
,0,0,0,0,Ashe,2022-03-16
,0,0,0,0,Ashe,2022-03-17
,0,0,0,0,Ashe,2022-03-20
,0,0,0,0,Ashe,2022-03-22
,0,0,0,0,Ashe,2022-03-23
,0,0,0,0,Ashe,2022-03-24
,0,0,0,0,Ashe,2022-03-25
,0,0,0,0,Ashe,2022-03-26
,0,0,0,0,Ashe,2022-03-27
,0,0,0,0,Ashe,2022-03-29
,0,0,0,0,Ashe,2022-03-31
,0,0,0,0,Ashe,2022-04-02
,0,0,0,0,Ashe,2022-04-03
,0,0,0,0,Ashe,2022-04-07
,0,0,0,0,Ashe,2022-04-09
,0,0,0,0,Ashe,2022-04-13
,0,0,0,0,Ashe,2022-04-15
,0,0,0,0,Ashe,2022-04-16
,0,0,0,0,Ashe,2022-04-17
,0,0,0,0,Ashe,2022-04-19
,0,0,0,0,Ashe,2022-04-30
,0,0,0,0,Ashe,2022-05-30
0,15,7,8,0,Ashe,2021-12-17
0,8,2,6,0,Ashe,2021-12-18
0,4,0,4,0,Ashe,2021-12-19
0,14,3,11,0,Ashe,2021-12-22
0,6,0,6,0,Ashe,2021-12-23
0,9,3,6,0,Ashe,2021-12-24
0,3,1,2,0,Ashe,2021-12-25
0,19,9,10,0,Ashe,2021-12-27
0,19,11,8,0,Ashe,2022-01-08
0,17,11,6,0,Ashe,2022-01-17
0,5,2,3,0,Ashe,2022-01-29
0,31,13,18,0,Ashe,2022-02-09
0,17,14,3,0,Ashe,2022-02-12
0,2,1,1,0,Ashe,2022-02-13
0,14,8,6,0,Ashe,2022-02-17
0,4,3,1,0,Ashe,2022-02-27
0,2,2,0,0,Ashe,2022-03-02
0,1,0,1,0,Ashe,2022-03-06
0,2,0,2,0,Ashe,2022-03-11
0,1,1,0,0,Ashe,2022-03-12
0,6,1,5,0,Ashe,2022-03-14
0,1,0,1,0,Ashe,2022-03-19
0,1,1,0,0,Ashe,2022-03-21
0,1,1,0,0,Ashe,2022-03-30
0,1,0,1,0,Ashe,2022-04-04
0,3,2,1,0,Ashe,2022-04-05
0,2,2,0,0,Ashe,2022-04-06
0,2,0,2,0,Ashe,2022-04-08
0,1,1,0,0,Ashe,2022-04-10
0,1,1,0,0,Ashe,2022-04-11
0,2,0,2,0,Ashe,2022-04-12
0,2,2,0,0,Ashe,2022-04-14
0,5,0,5,0,Ashe,2022-04-20
0,3,1,2,0,Ashe,2022-04-21
0,4,4,0,0,Ashe,2022-04-24
0,3,2,1,0,Ashe,2022-04-27
0,1,1,0,0,Ashe,2022-04-29
0,9,6,3,0,Ashe,2022-05-06
0,5,4,1,0,Ashe,2022-05-07
0,4,4,0,0,Ashe,2022-05-09
0,6,6,0,0,Ashe,2022-05-11
0,7,2,5,0,Ashe,2022-05-12
0,7,7,0,0,Ashe,2022-05-14
0,2,1,1,0,Ashe,2022-05-15
0,3,3,0,0,Ashe,2022-05-19
0,4,3,1,0,Ashe,2022-05-20
0,4,3,1,0,Ashe,2022-05-22
0,7,5,2,0,Ashe,2022-05-24
0,7,1,6,0,Ashe,2022-05-25
0,10,5,5,0,Ashe,2022-05-26
0,4,2,2,0,Ashe,2022-05-28
0,3,0,3,0,Ashe,2022-06-02
0,1,0,1,0,Ashe,2022-06-03
0,1,0,1,0,Ashe,2022-06-11
1,14,4,10,0,Ashe,2021-12-15
1,48,10,38,0,Ashe,2021-12-29
1,8,5,3,0,Ashe,2022-01-16
1,16,10,6,0,Ashe,2022-01-23
1,13,9,4,0,Ashe,2022-01-30
1,22,9,13,0,Ashe,2022-02-10
1,19,7,12,0,Ashe,2022-02-18
1,7,6,1,0,Ashe,2022-02-19
1,5,5,0,0,Ashe,2022-02-20
1,15,9,6,0,Ashe,2022-02-23
1,10,3,7,0,Ashe,2022-03-01
1,5,3,2,0,Ashe,2022-03-07
1,4,1,3,0,Ashe,2022-03-09
1,1,0,1,0,Ashe,2022-03-18
1,2,0,2,0,Ashe,2022-03-28
1,2,0,2,0,Ashe,2022-04-01
1,3,1,2,0,Ashe,2022-04-18
1,7,6,1,0,Ashe,2022-04-28
1,4,2,2,0,Ashe,2022-05-02
1,8,5,3,0,Ashe,2022-05-04
1,5,2,3,0,Ashe,2022-05-10
1,6,3,3,0,Ashe,2022-05-13
1,4,1,3,0,Ashe,2022-05-17
1,6,4,2,0,Ashe,2022-05-18
1,6,3,3,0,Ashe,2022-05-27
1,2,1,1,0,Ashe,2022-05-29
1,9,2,7,0,Ashe,2022-06-01
1,6,3,3,0,Ashe,2022-06-04
1,8,2,6,0,Ashe,2022-06-07
1,1,1,0,0,Ashe,2022-06-10
2,24,9,15,0,Ashe,2021-12-20
2,12,7,5,0,Ashe,2021-12-26
2,37,12,25,0,Ashe,2021-12-30
2,19,12,7,0,Ashe,2021-12-31
2,22,16,6,0,Ashe,2022-01-02
2,28,9,19,0,Ashe,2022-01-03
2,10,5,5,0,Ashe,2022-01-09
2,20,10,10,0,Ashe,2022-01-15
2,33,10,23,0,Ashe,2022-01-28
2,45,19,26,0,Ashe,2022-02-02
2,29,17,12,0,Ashe,2022-02-15
2,15,9,6,0,Ashe,2022-02-22
2,13,5,8,0,Ashe,2022-02-28
2,8,4,4,0,Ashe,2022-04-26
2,7,3,4,0,Ashe,2022-05-03
2,11,8,3,0,Ashe,2022-05-23
2,9,5,4,0,Ashe,2022-05-31
2,12,5,7,0,Ashe,2022-06-09
3,18,4,14,0,Ashe,2021-12-14
3,26,16,10,0,Ashe,2022-02-25
3,6,4,2,0,Ashe,2022-05-21
3,11,4,7,0,Ashe,2022-06-06
3,7,6,1,0,Ashe,2022-06-08
4,55,11,44,0,Ashe,2022-01-05
4,13,9,4,0,Ashe,2022-02-05
5,48,10,38,0,Ashe,2021-12-28
5,44,7,37,0,Ashe,2022-01-26
5,45,27,18,0,Ashe,2022-02-07
5,43,23,20,0,Ashe,2022-02-08
6,71,15,56,0,Ashe,2022-01-04
7,39,18,21,0,Ashe,2022-01-27
8,43,24,19,0,Ashe,2022-02-04
10,53,20,33,0,Ashe,2022-01-18
10,53,29,24,0,Ashe,2022-02-03
11,70,30,40,0,Ashe,2022-01-13
11,96,30,66,0,Ashe,2022-01-24
13,95,27,68,0,Ashe,2022-01-10
,0,0,0,0,Avery,2021-12-25
,0,0,0,0,Avery,2022-01-16
,0,0,0,0,Avery,2022-02-26
,0,0,0,0,Avery,2022-03-05
,0,0,0,0,Avery,2022-03-20
,0,0,0,0,Avery,2022-03-24
,0,0,0,0,Avery,2022-03-28
,0,0,0,0,Avery,2022-03-29
,0,0,0,0,Avery,2022-04-02
,0,0,0,0,Avery,2022-04-03
,0,0,0,0,Avery,2022-04-04
,0,0,0,0,Avery,2022-04-05
,0,0,0,0,Avery,2022-04-06
,0,0,0,0,Avery,2022-04-07
,0,0,0,0,Avery,2022-04-08
,0,0,0,0,Avery,2022-04-14
,0,0,0,0,Avery,2022-05-01
,0,0,0,0,Avery,2022-05-11
,0,0,0,0,Avery,2022-05-15
,0,0,0,0,Avery,2022-05-21
0,14,10,4,0,Avery,2021-12-16
0,20,7,13,0,Avery,2021-12-18
0,8,5,3,0,Avery,2021-12-19
0,6,3,3,0,Avery,2021-12-24
0,7,3,4,0,Avery,2021-12-26
0,26,13,13,0,Avery,2021-12-29
0,10,5,5,0,Avery,2021-12-31
0,5,1,4,0,Avery,2022-01-01
0,8,0,8,0,Avery,2022-01-02
0,14,1,13,0,Avery,2022-01-03
0,5,1,4,0,Avery,2022-01-17
0,28,4,24,0,Avery,2022-01-26
0,17,0,17,0,Avery,2022-01-28
0,3,0,3,0,Avery,2022-01-30
0,7,4,3,0,Avery,2022-02-28
0,5,1,4,0,Avery,2022-03-01
0,2,0,2,0,Avery,2022-03-02
0,5,4,1,0,Avery,2022-03-07
0,2,2,0,0,Avery,2022-03-09
0,1,0,1,0,Avery,2022-03-11
0,1,0,1,0,Avery,2022-03-12
0,1,0,1,0,Avery,2022-03-13
0,1,1,0,0,Avery,2022-03-14
0,3,3,0,0,Avery,2022-03-15
0,1,1,0,0,Avery,2022-03-16
0,1,1,0,0,Avery,2022-03-18
0,6,4,2,0,Avery,2022-03-19
0,2,1,1,0,Avery,2022-03-21
0,1,0,1,0,Avery,2022-03-25
0,1,0,1,0,Avery,2022-03-27
0,2,1,1,0,Avery,2022-03-30
0,4,2,2,0,Avery,2022-03-31
0,1,0,1,0,Avery,2022-04-09
0,1,1,0,0,Avery,2022-04-10
0,1,1,0,0,Avery,2022-04-11
0,2,0,2,0,Avery,2022-04-13
0,1,1,0,0,Avery,2022-04-15
0,1,0,1,0,Avery,2022-04-16
0,2,0,2,0,Avery,2022-04-17
0,2,0,2,0,Avery,2022-04-18
0,4,1,3,0,Avery,2022-04-19
0,1,0,1,0,Avery,2022-04-20
0,5,2,3,0,Avery,2022-04-21
0,2,1,1,0,Avery,2022-04-22
0,1,0,1,0,Avery,2022-04-23
0,3,1,2,0,Avery,2022-04-24
0,2,2,0,0,Avery,2022-04-25
0,1,0,1,0,Avery,2022-04-27
0,1,1,0,0,Avery,2022-04-28
0,2,1,1,0,Avery,2022-04-30
0,3,1,2,0,Avery,2022-05-03
0,2,0,2,0,Avery,2022-05-04
0,2,1,1,0,Avery,2022-05-05
0,3,2,1,0,Avery,2022-05-06
0,2,0,2,0,Avery,2022-05-07
0,1,1,0,0,Avery,2022-05-08
0,2,1,1,0,Avery,2022-05-09
0,3,1,2,0,Avery,2022-05-10
0,1,0,1,0,Avery,2022-05-12
0,5,1,4,0,Avery,2022-05-13
0,5,1,4,0,Avery,2022-05-18
0,1,0,1,0,Avery,2022-05-19
0,6,3,3,0,Avery,2022-05-20
0,1,0,1,0,Avery,2022-05-22
0,7,2,5,0,Avery,2022-05-24
0,3,2,1,0,Avery,2022-05-25
0,1,0,1,0,Avery,2022-05-27
0,3,1,2,0,Avery,2022-05-28
0,1,1,0,0,Avery,2022-05-29
0,5,2,3,0,Avery,2022-06-01
0,5,2,3,0,Avery,2022-06-03
0,1,0,1,0,Avery,2022-06-05
0,8,3,5,0,Avery,2022-06-06
0,2,0,2,0,Avery,2022-06-08
0,7,2,5,0,Avery,2022-06-09
0,1,0,1,0,Avery,2022-06-11
1,6,4,2,0,Avery,2021-12-14
1,15,6,9,0,Avery,2021-12-15
1,29,12,17,0,Avery,2021-12-20
1,17,6,11,0,Avery,2021-12-23
1,25,7,18,0,Avery,2021-12-30
1,16,3,13,0,Avery,2022-01-08
1,18,0,18,0,Avery,2022-01-15
1,12,1,11,0,Avery,2022-01-22
1,35,3,32,0,Avery,2022-01-27
1,4,1,3,0,Avery,2022-01-29
1,14,1,13,0,Avery,2022-02-04
1,8,2,6,0,Avery,2022-02-11
1,7,2,5,0,Avery,2022-02-19
1,12,6,6,0,Avery,2022-02-22
1,5,2,3,0,Avery,2022-02-24
1,2,1,1,0,Avery,2022-02-27
1,7,2,5,0,Avery,2022-03-10
1,2,1,1,0,Avery,2022-03-23
1,1,0,1,0,Avery,2022-03-26
1,3,2,1,0,Avery,2022-04-01
1,4,2,2,0,Avery,2022-05-14
1,3,0,3,0,Avery,2022-05-16
1,8,7,1,0,Avery,2022-05-23
1,2,2,0,0,Avery,2022-05-26
1,4,1,3,0,Avery,2022-06-02
1,2,0,2,0,Avery,2022-06-04
1,8,6,2,0,Avery,2022-06-07
1,15,6,9,0,Avery,2022-06-10
2,12,12,0,0,Avery,2021-12-22
2,36,20,16,0,Avery,2021-12-27
2,28,4,24,0,Avery,2022-01-06
2,34,3,31,0,Avery,2022-01-11
2,23,5,18,0,Avery,2022-01-18
2,16,5,11,0,Avery,2022-01-23
2,21,4,17,0,Avery,2022-01-25
2,24,6,18,0,Avery,2022-02-01
2,22,3,19,0,Avery,2022-02-03
2,30,7,23,0,Avery,2022-02-07
2,17,2,15,0,Avery,2022-02-09
2,15,5,10,0,Avery,2022-02-10
2,9,4,5,0,Avery,2022-02-13
2,13,8,5,0,Avery,2022-02-17
2,16,2,14,0,Avery,2022-02-21
2,5,2,3,0,Avery,2022-02-25
2,13,4,9,0,Avery,2022-05-17
2,4,1,3,0,Avery,2022-05-30
2,10,6,4,0,Avery,2022-05-31
3,42,22,20,0,Avery,2021-12-28
3,43,7,36,0,Avery,2022-01-05
3,37,5,32,0,Avery,2022-01-13
3,46,1,45,0,Avery,2022-01-14
3,36,5,31,0,Avery,2022-01-20
3,59,17,42,0,Avery,2022-01-24
3,16,3,13,0,Avery,2022-02-02
3,14,2,12,0,Avery,2022-02-05
3,25,10,15,0,Avery,2022-02-14
3,17,7,10,0,Avery,2022-02-16
3,18,6,12,0,Avery,2022-02-23
3,10,9,1,0,Avery,2022-03-17
4,39,3,36,0,Avery,2022-01-04
4,44,5,39,0,Avery,2022-01-12
4,64,9,55,0,Avery,2022-01-19
4,29,5,24,0,Avery,2022-01-21
4,22,14,8,0,Avery,2022-02-15
4,17,5,12,0,Avery,2022-02-18
5,44,14,30,0,Avery,2022-01-31
5,18,4,14,0,Avery,2022-02-08
5,12,5,7,0,Avery,2022-02-12
10,73,13,60,0,Avery,2022-01-10
,0,0,0,0,Beaufort,2022-03-11
,0,0,0,0,Beaufort,2022-03-13
,0,0,0,0,Beaufort,2022-03-17
,0,0,0,0,Beaufort,2022-03-18
,0,0,0,0,Beaufort,2022-03-24
,0,0,0,0,Beaufort,2022-03-26
,0,0,0,0,Beaufort,2022-03-27
,0,0,0,0,Beaufort,2022-03-29
,0,0,0,0,Beaufort,2022-04-01
,0,0,0,0,Beaufort,2022-04-02
,0,0,0,0,Beaufort,2022-04-03
,0,0,0,0,Beaufort,2022-04-05
,0,0,0,0,Beaufort,2022-04-10
,0,0,0,0,Beaufort,2022-04-16
,0,0,0,0,Beaufort,2022-04-17
,0,0,0,0,Beaufort,2022-04-20
,0,0,0,0,Beaufort,2022-05-08
0,14,1,13,0,Beaufort,2021-12-14
0,14,1,13,0,Beaufort,2021-12-15
0,3,0,3,0,Beaufort,2021-12-24
0,2,0,2,0,Beaufort,2021-12-25
0,8,0,8,0,Beaufort,2022-01-22
0,8,1,7,0,Beaufort,2022-02-19
0,7,0,7,0,Beaufort,2022-02-28
0,3,1,2,0,Beaufort,2022-03-03
0,2,0,2,0,Beaufort,2022-03-05
0,1,0,1,0,Beaufort,2022-03-06
0,2,1,1,0,Beaufort,2022-03-12
0,3,1,2,0,Beaufort,2022-03-14
0,1,0,1,0,Beaufort,2022-03-15
0,1,0,1,0,Beaufort,2022-03-19
0,1,0,1,0,Beaufort,2022-03-20
0,1,0,1,0,Beaufort,2022-03-22
0,1,0,1,0,Beaufort,2022-03-25
0,1,0,1,0,Beaufort,2022-03-28
0,1,1,0,0,Beaufort,2022-03-30
0,1,0,1,0,Beaufort,2022-04-04
0,1,0,1,0,Beaufort,2022-04-07
0,1,1,0,0,Beaufort,2022-04-08
0,1,1,0,0,Beaufort,2022-04-09
0,1,0,1,0,Beaufort,2022-04-13
0,3,0,3,0,Beaufort,2022-04-14
0,1,0,1,0,Beaufort,2022-04-15
0,6,0,6,0,Beaufort,2022-04-18
0,3,2,1,0,Beaufort,2022-04-19
0,5,0,5,0,Beaufort,2022-04-21
0,5,0,5,0,Beaufort,2022-04-22
0,2,0,2,0,Beaufort,2022-04-29
0,2,2,0,0,Beaufort,2022-04-30
0,1,0,1,0,Beaufort,2022-05-01
0,3,0,3,0,Beaufort,2022-05-05
0,8,3,5,0,Beaufort,2022-05-06
0,3,1,2,0,Beaufort,2022-05-07
0,5,1,4,0,Beaufort,2022-05-10
0,8,1,7,0,Beaufort,2022-05-13
0,2,0,2,0,Beaufort,2022-05-15
0,15,5,10,0,Beaufort,2022-05-18
0,7,2,5,0,Beaufort,2022-05-21
0,8,1,7,0,Beaufort,2022-05-27
0,5,2,3,0,Beaufort,2022-05-28
0,13,2,11,0,Beaufort,2022-06-07
0,12,0,12,0,Beaufort,2022-06-10
1,8,2,6,0,Beaufort,2021-12-18
1,5,0,5,0,Beaufort,2021-12-19
1,20,2,18,0,Beaufort,2021-12-20
1,19,3,16,0,Beaufort,2021-12-21
1,18,0,18,0,Beaufort,2021-12-23
1,31,0,31,0,Beaufort,2022-01-23
1,20,3,17,0,Beaufort,2022-01-29
1,10,1,9,0,Beaufort,2022-02-24
1,5,1,4,0,Beaufort,2022-03-02
1,2,0,2,0,Beaufort,2022-03-09
1,2,0,2,0,Beaufort,2022-03-10
1,2,0,2,0,Beaufort,2022-03-16
1,2,0,2,0,Beaufort,2022-03-21
1,2,0,2,0,Beaufort,2022-04-06
1,4,0,4,0,Beaufort,2022-04-12
1,5,1,4,0,Beaufort,2022-04-23
1,2,0,2,0,Beaufort,2022-04-24
1,7,2,5,0,Beaufort,2022-04-27
1,8,1,7,0,Beaufort,2022-05-04
1,8,2,6,0,Beaufort,2022-05-12
1,14,1,13,0,Beaufort,2022-05-16
1,6,0,6,0,Beaufort,2022-05-22
1,20,4,16,0,Beaufort,2022-05-23
1,15,3,12,0,Beaufort,2022-05-24
1,9,2,7,0,Beaufort,2022-05-25
1,4,0,4,0,Beaufort,2022-05-30
1,6,3,3,0,Beaufort,2022-06-04
1,27,4,23,0,Beaufort,2022-06-06
1,7,0,7,0,Beaufort,2022-06-11
2,17,1,16,0,Beaufort,2022-01-01
2,7,1,6,0,Beaufort,2022-02-12
2,5,1,4,0,Beaufort,2022-04-26
2,13,3,10,0,Beaufort,2022-05-11
2,10,4,6,0,Beaufort,2022-05-14
2,13,4,9,0,Beaufort,2022-05-19
2,22,3,19,0,Beaufort,2022-05-26
2,19,5,14,0,Beaufort,2022-06-01
2,16,5,11,0,Beaufort,2022-06-02
2,16,7,9,0,Beaufort,2022-06-03
2,5,0,5,0,Beaufort,2022-06-05
2,15,6,9,0,Beaufort,2022-06-09
3,20,2,18,0,Beaufort,2022-02-05
3,24,10,14,0,Beaufort,2022-02-11
3,20,3,17,0,Beaufort,2022-02-22
3,10,2,8,0,Beaufort,2022-05-20
3,10,2,8,0,Beaufort,2022-05-29
4,50,6,44,0,Beaufort,2021-12-28
4,71,14,57,0,Beaufort,2021-12-29
4,46,1,45,0,Beaufort,2021-12-31
4,18,5,13,0,Beaufort,2022-02-16
4,13,4,9,0,Beaufort,2022-05-09
5,66,6,60,0,Beaufort,2021-12-30
5,37,0,37,0,Beaufort,2022-01-02
5,60,9,51,0,Beaufort,2022-02-02
5,43,4,39,0,Beaufort,2022-02-03
5,52,14,38,0,Beaufort,2022-02-07
5,37,5,32,0,Beaufort,2022-02-21
5,18,3,15,0,Beaufort,2022-06-08
6,83,18,65,0,Beaufort,2022-01-15
6,28,4,24,0,Beaufort,2022-02-15
7,42,1,41,0,Beaufort,2022-01-16
7,48,6,42,0,Beaufort,2022-02-14
7,34,5,29,0,Beaufort,2022-05-31
8,100,14,86,0,Beaufort,2022-01-31
8,56,8,48,0,Beaufort,2022-02-01
9,57,12,45,0,Beaufort,2021-12-27
10,46,11,35,0,Beaufort,2022-02-09
11,64,20,44,0,Beaufort,2022-01-08
11,122,24,98,0,Beaufort,2022-01-26
16,112,20,92,0,Beaufort,2022-01-04
17,142,18,124,0,Beaufort,2022-01-03
17,193,33,160,0,Beaufort,2022-01-20
18,227,23,204,0,Beaufort,2022-01-12
21,193,22,171,0,Beaufort,2022-01-24
26,281,37,244,0,Beaufort,2022-01-10
29,232,32,200,0,Beaufort,2022-01-11
,0,0,0,0,Bertie,2021-12-19
,0,0,0,0,Bertie,2022-02-15
,0,0,0,0,Bertie,2022-02-19
,0,0,0,0,Bertie,2022-02-23
,0,0,0,0,Bertie,2022-02-24
,0,0,0,0,Bertie,2022-02-26
,0,0,0,0,Bertie,2022-02-27
,0,0,0,0,Bertie,2022-03-01
,0,0,0,0,Bertie,2022-03-08
,0,0,0,0,Bertie,2022-03-09
,0,0,0,0,Bertie,2022-03-12
,0,0,0,0,Bertie,2022-03-13
,0,0,0,0,Bertie,2022-03-14
,0,0,0,0,Bertie,2022-03-16
,0,0,0,0,Bertie,2022-03-17
,0,0,0,0,Bertie,2022-03-18
,0,0,0,0,Bertie,2022-03-19
,0,0,0,0,Bertie,2022-03-20
,0,0,0,0,Bertie,2022-03-21
,0,0,0,0,Bertie,2022-03-22
,0,0,0,0,Bertie,2022-03-23
,0,0,0,0,Bertie,2022-03-25
,0,0,0,0,Bertie,2022-03-26
,0,0,0,0,Bertie,2022-03-29
,0,0,0,0,Bertie,2022-03-30
,0,0,0,0,Bertie,2022-03-31
,0,0,0,0,Bertie,2022-04-01
,0,0,0,0,Bertie,2022-04-02
,0,0,0,0,Bertie,2022-04-03
,0,0,0,0,Bertie,2022-04-04
,0,0,0,0,Bertie,2022-04-05
,0,0,0,0,Bertie,2022-04-06
,0,0,0,0,Bertie,2022-04-07
,0,0,0,0,Bertie,2022-04-09
,0,0,0,0,Bertie,2022-04-15
,0,0,0,0,Bertie,2022-04-16
,0,0,0,0,Bertie,2022-04-17
,0,0,0,0,Bertie,2022-04-19
,0,0,0,0,Bertie,2022-04-20
,0,0,0,0,Bertie,2022-04-22
,0,0,0,0,Bertie,2022-04-23
,0,0,0,0,Bertie,2022-04-24
,0,0,0,0,Bertie,2022-05-07
,0,0,0,0,Bertie,2022-05-09
,0,0,0,0,Bertie,2022-05-20
0,3,0,3,0,Bertie,2021-12-14
0,5,1,4,0,Bertie,2021-12-15
0,4,0,4,0,Bertie,2021-12-17
0,1,0,1,0,Bertie,2021-12-18
0,5,1,4,0,Bertie,2021-12-23
0,2,0,2,0,Bertie,2021-12-25
0,6,0,6,0,Bertie,2021-12-26
0,5,0,5,0,Bertie,2022-01-22
0,6,0,6,0,Bertie,2022-01-30
0,10,0,10,0,Bertie,2022-02-04
0,2,0,2,0,Bertie,2022-02-05
0,11,0,11,0,Bertie,2022-02-07
0,4,0,4,0,Bertie,2022-02-08
0,10,1,9,0,Bertie,2022-02-09
0,12,2,10,0,Bertie,2022-02-10
0,3,1,2,0,Bertie,2022-02-11
0,2,1,1,0,Bertie,2022-02-13
0,3,0,3,0,Bertie,2022-02-16
0,1,0,1,0,Bertie,2022-02-18
0,1,0,1,0,Bertie,2022-02-20
0,1,1,0,0,Bertie,2022-02-21
0,2,0,2,0,Bertie,2022-02-28
0,1,0,1,0,Bertie,2022-03-03
0,2,0,2,0,Bertie,2022-03-04
0,1,0,1,0,Bertie,2022-03-05
0,1,0,1,0,Bertie,2022-03-07
0,1,0,1,0,Bertie,2022-03-10
0,1,0,1,0,Bertie,2022-03-15
0,1,0,1,0,Bertie,2022-03-27
0,2,0,2,0,Bertie,2022-03-28
0,2,0,2,0,Bertie,2022-04-08
0,1,0,1,0,Bertie,2022-04-10
0,1,1,0,0,Bertie,2022-04-11
0,1,0,1,0,Bertie,2022-04-13
0,1,0,1,0,Bertie,2022-04-14
0,3,0,3,0,Bertie,2022-04-18
0,1,0,1,0,Bertie,2022-04-21
0,2,0,2,0,Bertie,2022-04-25
0,5,0,5,0,Bertie,2022-04-26
0,3,0,3,0,Bertie,2022-04-27
0,3,0,3,0,Bertie,2022-04-29
0,2,0,2,0,Bertie,2022-04-30
0,1,0,1,0,Bertie,2022-05-02
0,3,0,3,0,Bertie,2022-05-03
0,3,1,2,0,Bertie,2022-05-04
0,2,0,2,0,Bertie,2022-05-05
0,1,0,1,0,Bertie,2022-05-06
0,1,0,1,0,Bertie,2022-05-08
0,3,0,3,0,Bertie,2022-05-11
0,6,3,3,0,Bertie,2022-05-13
0,5,0,5,0,Bertie,2022-05-15
0,3,0,3,0,Bertie,2022-05-16
0,3,2,1,0,Bertie,2022-05-18
0,2,0,2,0,Bertie,2022-05-19
0,4,0,4,0,Bertie,2022-05-23
0,4,0,4,0,Bertie,2022-06-03
0,2,1,1,0,Bertie,2022-06-04
0,3,0,3,0,Bertie,2022-06-05
0,5,1,4,0,Bertie,2022-06-08
0,10,1,9,0,Bertie,2022-06-10
1,10,2,8,0,Bertie,2021-12-20
1,7,0,7,0,Bertie,2021-12-22
1,5,0,5,0,Bertie,2021-12-24
1,35,7,28,0,Bertie,2022-01-17
1,30,1,29,0,Bertie,2022-01-25
1,26,3,23,0,Bertie,2022-01-27
1,11,3,8,0,Bertie,2022-02-02
1,2,0,2,0,Bertie,2022-02-12
1,4,1,3,0,Bertie,2022-02-14
1,2,1,1,0,Bertie,2022-02-17
1,1,0,1,0,Bertie,2022-02-22
1,6,0,6,0,Bertie,2022-02-25
1,2,0,2,0,Bertie,2022-03-24
1,2,0,2,0,Bertie,2022-05-01
1,3,0,3,0,Bertie,2022-05-10
1,5,0,5,0,Bertie,2022-05-12
1,6,0,6,0,Bertie,2022-05-24
1,8,1,7,0,Bertie,2022-05-26
1,5,1,4,0,Bertie,2022-05-27
1,2,0,2,0,Bertie,2022-05-28
1,6,1,5,0,Bertie,2022-05-30
1,9,1,8,0,Bertie,2022-05-31
1,4,0,4,0,Bertie,2022-06-11
2,27,1,26,0,Bertie,2021-12-27
2,52,0,52,0,Bertie,2021-12-31
2,18,0,18,0,Bertie,2022-01-01
2,15,0,15,0,Bertie,2022-01-02
2,19,1,18,0,Bertie,2022-01-15
2,38,6,32,0,Bertie,2022-01-20
2,4,1,3,0,Bertie,2022-05-22
2,6,3,3,0,Bertie,2022-06-02
2,11,0,11,0,Bertie,2022-06-06
2,9,1,8,0,Bertie,2022-06-07
3,39,3,36,0,Bertie,2021-12-30
3,9,0,9,0,Bertie,2022-01-16
3,18,2,16,0,Bertie,2022-02-01
3,10,0,10,0,Bertie,2022-02-03
3,6,0,6,0,Bertie,2022-06-09
4,20,2,18,0,Bertie,2022-01-08
4,45,4,41,0,Bertie,2022-01-19
4,45,0,45,0,Bertie,2022-01-24
6,64,6,58,0,Bertie,2022-01-06
6,82,5,77,0,Bertie,2022-01-18
7,56,10,46,0,Bertie,2021-12-29
7,78,3,75,0,Bertie,2022-01-03
8,38,5,33,0,Bertie,2021-12-28
8,84,11,73,0,Bertie,2022-01-11
8,12,11,1,0,Bertie,2022-05-29
11,81,12,69,0,Bertie,2022-01-04
11,99,44,55,0,Bertie,2022-01-12
,0,0,0,0,Bladen,2022-02-26
,0,0,0,0,Bladen,2022-02-27
,0,0,0,0,Bladen,2022-03-05
,0,0,0,0,Bladen,2022-03-11
,0,0,0,0,Bladen,2022-03-15
,0,0,0,0,Bladen,2022-03-16
,0,0,0,0,Bladen,2022-03-19
,0,0,0,0,Bladen,2022-03-20
,0,0,0,0,Bladen,2022-03-21
,0,0,0,0,Bladen,2022-03-22
,0,0,0,0,Bladen,2022-03-23
,0,0,0,0,Bladen,2022-03-24
,0,0,0,0,Bladen,2022-03-27
,0,0,0,0,Bladen,2022-03-28
,0,0,0,0,Bladen,2022-03-30
,0,0,0,0,Bladen,2022-04-02
,0,0,0,0,Bladen,2022-04-03
,0,0,0,0,Bladen,2022-04-06
,0,0,0,0,Bladen,2022-04-07
,0,0,0,0,Bladen,2022-04-08
,0,0,0,0,Bladen,2022-04-09
,0,0,0,0,Bladen,2022-04-16
,0,0,0,0,Bladen,2022-04-17
,0,0,0,0,Bladen,2022-04-24
0,8,2,6,0,Bladen,2021-12-18
0,5,0,5,0,Bladen,2021-12-19
0,11,2,9,0,Bladen,2021-12-20
0,9,0,9,0,Bladen,2021-12-22
0,15,3,12,0,Bladen,2021-12-23
0,16,4,12,0,Bladen,2022-01-29
0,4,0,4,0,Bladen,2022-02-12
0,4,1,3,0,Bladen,2022-02-13
0,5,0,5,0,Bladen,2022-02-15
0,11,1,10,0,Bladen,2022-02-16
0,7,2,5,0,Bladen,2022-02-20
0,12,4,8,0,Bladen,2022-02-21
0,9,2,7,0,Bladen,2022-02-22
0,10,1,9,0,Bladen,2022-02-23
0,12,0,12,0,Bladen,2022-02-24
0,2,0,2,0,Bladen,2022-03-01
0,2,0,2,0,Bladen,2022-03-02
0,2,0,2,0,Bladen,2022-03-03
0,5,0,5,0,Bladen,2022-03-04
0,2,0,2,0,Bladen,2022-03-07
0,2,0,2,0,Bladen,2022-03-13
0,1,1,0,0,Bladen,2022-03-17
0,1,0,1,0,Bladen,2022-03-18
0,1,1,0,0,Bladen,2022-03-25
0,1,0,1,0,Bladen,2022-03-26
0,2,2,0,0,Bladen,2022-03-29
0,1,0,1,0,Bladen,2022-03-31
0,2,0,2,0,Bladen,2022-04-01
0,3,1,2,0,Bladen,2022-04-04
0,1,0,1,0,Bladen,2022-04-10
0,2,1,1,0,Bladen,2022-04-11
0,3,1,2,0,Bladen,2022-04-12
0,1,1,0,0,Bladen,2022-04-13
0,2,1,1,0,Bladen,2022-04-15
0,1,0,1,0,Bladen,2022-04-18
0,3,1,2,0,Bladen,2022-04-19
0,4,0,4,0,Bladen,2022-04-21
0,2,0,2,0,Bladen,2022-04-23
0,2,0,2,0,Bladen,2022-04-28
0,4,0,4,0,Bladen,2022-04-29
0,2,0,2,0,Bladen,2022-04-30
0,1,1,0,0,Bladen,2022-05-01
0,3,1,2,0,Bladen,2022-05-02
0,2,0,2,0,Bladen,2022-05-07
0,5,0,5,0,Bladen,2022-05-11
0,7,1,6,0,Bladen,2022-05-12
0,15,2,13,0,Bladen,2022-05-13
0,4,0,4,0,Bladen,2022-05-14
0,4,0,4,0,Bladen,2022-05-15
0,12,3,9,0,Bladen,2022-05-16
0,14,0,14,0,Bladen,2022-05-24
0,23,4,19,0,Bladen,2022-05-25
0,6,2,4,0,Bladen,2022-05-28
0,8,2,6,0,Bladen,2022-05-29
0,9,0,9,0,Bladen,2022-05-30
0,11,2,9,0,Bladen,2022-06-03
0,4,0,4,0,Bladen,2022-06-04
0,16,3,13,0,Bladen,2022-06-09
0,12,1,11,0,Bladen,2022-06-10
1,16,2,14,0,Bladen,2021-12-21
1,15,1,14,0,Bladen,2021-12-24
1,35,2,33,0,Bladen,2022-01-02
1,42,8,34,0,Bladen,2022-01-16
1,28,4,24,0,Bladen,2022-01-23
1,11,3,8,0,Bladen,2022-02-08
1,9,3,6,0,Bladen,2022-02-18
1,7,1,6,0,Bladen,2022-02-19
1,2,0,2,0,Bladen,2022-03-09
1,3,0,3,0,Bladen,2022-03-14
1,1,0,1,0,Bladen,2022-04-20
1,4,1,3,0,Bladen,2022-04-22
1,3,1,2,0,Bladen,2022-04-26
1,6,1,5,0,Bladen,2022-04-27
1,4,0,4,0,Bladen,2022-05-04
1,11,2,9,0,Bladen,2022-05-09
1,5,1,4,0,Bladen,2022-05-22
1,15,4,11,0,Bladen,2022-06-06
1,13,1,12,0,Bladen,2022-06-08
2,14,1,13,0,Bladen,2021-12-15
2,38,3,35,0,Bladen,2022-01-09
2,60,7,53,0,Bladen,2022-01-27
2,2,0,2,0,Bladen,2022-04-14
2,4,0,4,0,Bladen,2022-05-03
2,8,0,8,0,Bladen,2022-05-10
3,105,14,91,0,Bladen,2022-01-05
3,15,3,12,0,Bladen,2022-01-22
3,22,6,16,0,Bladen,2022-02-02
3,10,1,9,0,Bladen,2022-02-14
3,5,1,4,0,Bladen,2022-05-06
3,16,6,10,0,Bladen,2022-05-17
3,13,1,12,0,Bladen,2022-05-19
3,11,3,8,0,Bladen,2022-05-26
3,10,2,8,0,Bladen,2022-06-11
4,32,3,29,0,Bladen,2021-12-27
4,85,11,74,0,Bladen,2021-12-30
4,25,7,18,0,Bladen,2022-01-21
4,50,14,36,0,Bladen,2022-02-01
4,22,4,18,0,Bladen,2022-05-18
4,16,5,11,0,Bladen,2022-05-20
4,12,3,9,0,Bladen,2022-05-21
4,20,4,16,0,Bladen,2022-06-01
5,32,5,27,0,Bladen,2021-12-31
5,100,9,91,0,Bladen,2022-01-03
5,47,14,33,0,Bladen,2022-01-15
5,9,5,4,0,Bladen,2022-05-05
5,19,0,19,0,Bladen,2022-06-07
6,68,3,65,0,Bladen,2021-12-29
6,92,14,78,0,Bladen,2022-01-07
6,19,5,14,0,Bladen,2022-05-23
7,56,6,50,0,Bladen,2021-12-28
7,145,20,125,0,Bladen,2022-01-04
10,121,16,105,0,Bladen,2022-01-06
11,65,14,51,0,Bladen,2022-01-31
12,158,28,130,0,Bladen,2022-01-11
12,157,33,124,0,Bladen,2022-01-20
14,156,32,124,0,Bladen,2022-01-12
20,221,38,183,0,Bladen,2022-01-10
21,165,33,132,0,Bladen,2022-01-13
0,45,10,35,0,Brunswick,2021-12-14
0,44,10,34,0,Brunswick,2021-12-15
0,63,11,52,0,Brunswick,2021-12-21
0,21,3,18,0,Brunswick,2021-12-25
0,46,2,44,0,Brunswick,2022-01-01
0,67,11,56,0,Brunswick,2022-02-06
0,15,3,12,0,Brunswick,2022-02-20
0,36,8,28,0,Brunswick,2022-02-23
0,13,1,12,0,Brunswick,2022-03-04
0,5,2,3,0,Brunswick,2022-03-08
0,11,2,9,0,Brunswick,2022-03-09
0,8,2,6,0,Brunswick,2022-03-11
0,3,0,3,0,Brunswick,2022-03-12
0,9,0,9,0,Brunswick,2022-03-15
0,2,1,1,0,Brunswick,2022-03-19
0,2,0,2,0,Brunswick,2022-03-20
0,6,1,5,0,Brunswick,2022-03-21
0,2,0,2,0,Brunswick,2022-03-22
0,7,3,4,0,Brunswick,2022-03-23
0,4,2,2,0,Brunswick,2022-03-24
0,2,1,1,0,Brunswick,2022-03-26
0,2,0,2,0,Brunswick,2022-03-27
0,11,2,9,0,Brunswick,2022-03-28
0,7,0,7,0,Brunswick,2022-03-29
0,6,0,6,0,Brunswick,2022-04-01
0,2,0,2,0,Brunswick,2022-04-02
0,1,0,1,0,Brunswick,2022-04-03
0,11,6,5,0,Brunswick,2022-04-04
0,19,2,17,0,Brunswick,2022-04-07
0,7,0,7,0,Brunswick,2022-04-09
0,2,1,1,0,Brunswick,2022-04-10
0,4,0,4,0,Brunswick,2022-04-15
0,16,4,12,0,Brunswick,2022-04-16
0,3,0,3,0,Brunswick,2022-04-17
0,15,1,14,0,Brunswick,2022-04-19
0,23,4,19,0,Brunswick,2022-04-20
0,16,3,13,0,Brunswick,2022-04-23
0,24,1,23,0,Brunswick,2022-04-27
0,26,4,22,0,Brunswick,2022-04-30
0,51,9,42,0,Brunswick,2022-05-19
0,48,9,39,0,Brunswick,2022-06-08
1,42,6,36,0,Brunswick,2022-02-17
1,34,2,32,0,Brunswick,2022-02-22
1,17,1,16,0,Brunswick,2022-02-26
1,4,1,3,0,Brunswick,2022-03-14
1,5,0,5,0,Brunswick,2022-03-16
1,11,0,11,0,Brunswick,2022-03-30
1,13,3,10,0,Brunswick,2022-04-06
1,19,2,17,0,Brunswick,2022-04-11
1,32,8,24,0,Brunswick,2022-04-28
1,33,4,29,0,Brunswick,2022-05-14
1,26,8,18,0,Brunswick,2022-05-21
2,47,13,34,0,Brunswick,2021-12-24
2,75,6,69,0,Brunswick,2022-01-22
2,64,7,57,0,Brunswick,2022-02-14
2,14,2,12,0,Brunswick,2022-02-27
2,22,6,16,0,Brunswick,2022-02-28
2,13,2,11,0,Brunswick,2022-03-31
2,16,1,15,0,Brunswick,2022-04-14
2,19,1,18,0,Brunswick,2022-04-22
2,9,4,5,0,Brunswick,2022-04-24
2,39,6,33,0,Brunswick,2022-04-26
2,44,11,33,0,Brunswick,2022-05-03
2,41,3,38,0,Brunswick,2022-05-06
2,17,1,16,0,Brunswick,2022-05-07
2,31,6,25,0,Brunswick,2022-05-15
2,36,6,30,0,Brunswick,2022-05-22
2,44,6,38,0,Brunswick,2022-05-27
2,30,6,24,0,Brunswick,2022-05-30
2,52,6,46,0,Brunswick,2022-06-02
2,26,9,17,0,Brunswick,2022-06-11
3,74,14,60,0,Brunswick,2021-12-23
3,19,2,17,0,Brunswick,2022-04-13
3,20,2,18,0,Brunswick,2022-05-01
3,65,12,53,0,Brunswick,2022-05-04
3,29,7,22,0,Brunswick,2022-05-08
3,67,6,61,0,Brunswick,2022-05-13
3,52,4,48,0,Brunswick,2022-05-17
3,76,11,65,0,Brunswick,2022-05-18
3,55,8,47,0,Brunswick,2022-06-01
3,40,7,33,0,Brunswick,2022-06-03
3,54,5,49,0,Brunswick,2022-06-06
3,37,5,32,0,Brunswick,2022-06-10
4,17,1,16,0,Brunswick,2022-04-18
4,20,3,17,0,Brunswick,2022-04-21
4,50,8,42,0,Brunswick,2022-05-05
4,64,14,50,0,Brunswick,2022-05-10
4,67,9,58,0,Brunswick,2022-05-31
5,63,3,60,0,Brunswick,2022-02-11
5,36,4,32,0,Brunswick,2022-04-29
5,51,14,37,0,Brunswick,2022-05-29
6,143,21,122,0,Brunswick,2021-12-31
6,132,26,106,0,Brunswick,2022-02-07
6,67,13,54,0,Brunswick,2022-05-11
6,69,13,56,0,Brunswick,2022-05-20
6,34,11,23,0,Brunswick,2022-05-28
7,167,24,143,0,Brunswick,2022-02-02
7,65,11,54,0,Brunswick,2022-05-25
7,52,10,42,0,Brunswick,2022-06-09
8,69,7,62,0,Brunswick,2021-12-22
8,183,27,156,0,Brunswick,2021-12-27
8,87,14,73,0,Brunswick,2022-05-16
8,63,8,55,0,Brunswick,2022-05-24
8,46,12,34,0,Brunswick,2022-06-04
8,60,12,48,0,Brunswick,2022-06-07
9,244,58,186,0,Brunswick,2022-01-26
9,53,9,44,0,Brunswick,2022-05-02
9,74,9,65,0,Brunswick,2022-05-23
10,205,31,174,0,Brunswick,2021-12-28
10,167,27,140,0,Brunswick,2022-01-21
15,412,50,362,0,Brunswick,2022-01-14
17,333,42,291,0,Brunswick,2022-01-07
19,232,27,205,0,Brunswick,2021-12-29
23,317,40,277,0,Brunswick,2022-01-06
24,397,50,347,0,Brunswick,2022-01-13
25,422,44,378,0,Brunswick,2022-01-17
26,454,57,397,0,Brunswick,2022-01-10
0,12,6,6,0,Buncombe,2022-03-05
0,11,5,6,0,Buncombe,2022-03-06
0,15,5,10,0,Buncombe,2022-03-17
0,15,5,10,0,Buncombe,2022-03-18
0,7,1,6,0,Buncombe,2022-03-19
0,18,5,13,0,Buncombe,2022-03-22
0,20,4,16,0,Buncombe,2022-04-01
0,9,2,7,0,Buncombe,2022-04-02
0,23,7,16,0,Buncombe,2022-04-05
0,13,5,8,0,Buncombe,2022-04-09
1,110,43,67,0,Buncombe,2021-12-16
1,58,24,34,0,Buncombe,2021-12-18
1,18,4,14,0,Buncombe,2022-02-27
1,43,15,28,0,Buncombe,2022-03-01
1,17,7,10,0,Buncombe,2022-03-11
1,11,9,2,0,Buncombe,2022-03-21
1,9,4,5,0,Buncombe,2022-03-27
1,25,13,12,0,Buncombe,2022-03-31
1,34,8,26,0,Buncombe,2022-04-08
1,22,7,15,0,Buncombe,2022-04-17
1,110,44,66,0,Buncombe,2022-05-13
1,50,11,39,0,Buncombe,2022-06-04
2,38,8,30,0,Buncombe,2022-03-02
2,22,3,19,0,Buncombe,2022-03-09
2,10,2,8,0,Buncombe,2022-03-12
2,21,7,14,0,Buncombe,2022-03-23
2,21,8,13,0,Buncombe,2022-03-24
2,33,13,20,0,Buncombe,2022-04-04
2,21,3,18,0,Buncombe,2022-04-10
2,26,11,15,0,Buncombe,2022-04-16
2,22,10,12,0,Buncombe,2022-04-23
2,21,10,11,0,Buncombe,2022-04-24
2,75,30,45,0,Buncombe,2022-04-26
2,40,9,31,0,Buncombe,2022-04-30
2,58,21,37,0,Buncombe,2022-05-28
2,42,18,24,0,Buncombe,2022-06-11
3,78,12,66,0,Buncombe,2021-12-24
3,93,32,61,0,Buncombe,2022-02-21
3,20,7,13,0,Buncombe,2022-03-28
3,41,12,29,0,Buncombe,2022-04-11
3,43,16,27,0,Buncombe,2022-04-12
3,42,18,24,0,Buncombe,2022-04-13
3,37,9,28,0,Buncombe,2022-04-15
3,68,19,49,0,Buncombe,2022-04-20
3,49,22,27,0,Buncombe,2022-05-07
3,39,19,20,0,Buncombe,2022-05-08
3,44,16,28,0,Buncombe,2022-05-22
4,130,54,76,0,Buncombe,2021-12-15
4,167,29,138,0,Buncombe,2021-12-22
5,68,17,51,0,Buncombe,2022-04-18
5,79,21,58,0,Buncombe,2022-04-25
5,72,21,51,0,Buncombe,2022-05-29
5,105,44,61,0,Buncombe,2022-06-08
6,108,41,67,0,Buncombe,2022-02-15
6,55,23,32,0,Buncombe,2022-04-14
6,80,34,46,0,Buncombe,2022-04-27
6,77,32,45,0,Buncombe,2022-04-29
6,97,37,60,0,Buncombe,2022-05-10
6,66,18,48,0,Buncombe,2022-05-14
6,115,45,70,0,Buncombe,2022-05-20
6,80,30,50,0,Buncombe,2022-05-27
6,99,35,64,0,Buncombe,2022-06-09
7,76,37,39,0,Buncombe,2022-02-22
7,73,31,42,0,Buncombe,2022-04-21
7,75,24,51,0,Buncombe,2022-04-28
7,85,25,60,0,Buncombe,2022-05-15
7,36,20,16,0,Buncombe,2022-05-30
7,95,31,64,0,Buncombe,2022-06-03
8,127,41,86,0,Buncombe,2022-05-02
8,148,53,95,0,Buncombe,2022-05-09
8,127,60,67,0,Buncombe,2022-05-11
8,118,45,73,0,Buncombe,2022-05-19
8,118,43,75,0,Buncombe,2022-05-26
8,99,37,62,0,Buncombe,2022-06-06
9,103,48,55,0,Buncombe,2022-05-04
9,122,47,75,0,Buncombe,2022-05-17
9,97,42,55,0,Buncombe,2022-06-07
10,122,49,73,0,Buncombe,2022-05-05
12,177,70,107,0,Buncombe,2022-02-09
12,152,58,94,0,Buncombe,2022-05-25
12,122,47,75,0,Buncombe,2022-06-01
12,99,32,67,0,Buncombe,2022-06-02
13,243,46,197,0,Buncombe,2022-01-02
13,182,50,132,0,Buncombe,2022-05-31
14,264,85,179,0,Buncombe,2022-02-02
15,168,69,99,0,Buncombe,2022-05-16
16,87,40,47,0,Buncombe,2022-06-10
19,254,35,219,0,Buncombe,2022-01-22
20,240,82,158,0,Buncombe,2022-02-03
20,158,60,98,0,Buncombe,2022-05-23
39,755,222,533,0,Buncombe,2022-01-04
58,820,312,508,0,Buncombe,2022-01-11
,0,0,0,0,Burke,2022-03-25
,0,0,0,0,Burke,2022-03-26
,0,0,0,0,Burke,2022-04-17
0,14,4,10,0,Burke,2021-12-18
0,28,6,22,0,Burke,2021-12-24
0,3,0,3,0,Burke,2022-02-27
0,5,0,5,0,Burke,2022-03-01
0,17,4,13,0,Burke,2022-03-02
0,5,1,4,0,Burke,2022-03-05
0,2,1,1,0,Burke,2022-03-10
0,1,0,1,0,Burke,2022-03-13
0,4,2,2,0,Burke,2022-03-15
0,5,2,3,0,Burke,2022-03-16
0,2,2,0,0,Burke,2022-03-17
0,3,0,3,0,Burke,2022-03-18
0,1,0,1,0,Burke,2022-03-20
0,3,2,1,0,Burke,2022-03-21
0,4,1,3,0,Burke,2022-03-23
0,1,1,0,0,Burke,2022-03-24
0,3,1,2,0,Burke,2022-03-27
0,13,6,7,0,Burke,2022-03-28
0,3,2,1,0,Burke,2022-03-30
0,3,2,1,0,Burke,2022-04-01
0,1,0,1,0,Burke,2022-04-03
0,10,4,6,0,Burke,2022-04-06
0,4,1,3,0,Burke,2022-04-07
0,3,2,1,0,Burke,2022-04-08
0,4,0,4,0,Burke,2022-04-09
0,1,0,1,0,Burke,2022-04-10
0,6,4,2,0,Burke,2022-04-12
0,11,9,2,0,Burke,2022-04-15
0,2,1,1,0,Burke,2022-04-16
0,5,1,4,0,Burke,2022-04-19
0,3,1,2,0,Burke,2022-04-20
0,12,2,10,0,Burke,2022-04-21
0,2,2,0,0,Burke,2022-04-22
0,3,0,3,0,Burke,2022-04-23
0,8,2,6,0,Burke,2022-04-24
0,15,10,5,0,Burke,2022-04-26
0,4,3,1,0,Burke,2022-04-27
0,10,3,7,0,Burke,2022-04-29
0,4,2,2,0,Burke,2022-05-01
0,3,2,1,0,Burke,2022-05-08
0,12,0,12,0,Burke,2022-05-09
0,16,4,12,0,Burke,2022-05-11
0,16,3,13,0,Burke,2022-05-30
0,10,0,10,0,Burke,2022-06-04
0,20,6,14,0,Burke,2022-06-07
0,21,7,14,0,Burke,2022-06-09
1,33,6,27,0,Burke,2021-12-15
1,16,4,12,0,Burke,2021-12-19
1,39,8,31,0,Burke,2021-12-20
1,27,9,18,0,Burke,2021-12-26
1,25,10,15,0,Burke,2022-01-16
1,36,6,30,0,Burke,2022-02-06
1,17,3,14,0,Burke,2022-02-24
1,10,3,7,0,Burke,2022-03-03
1,6,1,5,0,Burke,2022-03-04
1,6,3,3,0,Burke,2022-03-29
1,7,2,5,0,Burke,2022-03-31
1,5,0,5,0,Burke,2022-04-11
1,10,4,6,0,Burke,2022-04-13
1,15,6,9,0,Burke,2022-05-02
1,6,0,6,0,Burke,2022-05-04
1,13,3,10,0,Burke,2022-05-05
1,12,3,9,0,Burke,2022-05-06
1,9,1,8,0,Burke,2022-05-07
1,16,1,15,0,Burke,2022-05-12
1,22,9,13,0,Burke,2022-05-13
1,22,5,17,0,Burke,2022-05-17
1,27,7,20,0,Burke,2022-05-18
1,6,0,6,0,Burke,2022-05-21
1,18,1,17,0,Burke,2022-05-22
1,19,9,10,0,Burke,2022-05-27
1,16,4,12,0,Burke,2022-05-29
1,14,0,14,0,Burke,2022-06-03
1,5,0,5,0,Burke,2022-06-11
2,38,9,29,0,Burke,2021-12-22
2,53,18,35,0,Burke,2021-12-23
2,20,3,17,0,Burke,2022-02-18
2,26,11,15,0,Burke,2022-02-22
2,6,1,5,0,Burke,2022-03-11
2,11,5,6,0,Burke,2022-04-25
2,9,1,8,0,Burke,2022-05-03
2,10,1,9,0,Burke,2022-05-15
2,26,5,21,0,Burke,2022-05-20
2,19,6,13,0,Burke,2022-05-25
2,21,13,8,0,Burke,2022-05-28
3,8,4,4,0,Burke,2022-03-07
3,27,2,25,0,Burke,2022-05-16
3,32,6,26,0,Burke,2022-05-19
3,25,9,16,0,Burke,2022-05-23
3,28,4,24,0,Burke,2022-06-01
3,29,6,23,0,Burke,2022-06-06
3,19,3,16,0,Burke,2022-06-10
4,54,32,22,0,Burke,2022-01-29
4,88,25,63,0,Burke,2022-02-04
4,30,6,24,0,Burke,2022-05-24
4,28,10,18,0,Burke,2022-05-26
5,58,12,46,0,Burke,2022-01-01
5,19,1,18,0,Burke,2022-06-08
7,96,28,68,0,Burke,2021-12-31
11,77,13,64,0,Burke,2022-01-17
12,130,39,91,0,Burke,2021-12-30
12,98,37,61,0,Burke,2022-01-09
15,192,54,138,0,Burke,2022-01-21
17,214,53,161,0,Burke,2022-01-07
21,187,42,145,0,Burke,2022-01-27
26,256,65,191,0,Burke,2022-01-06
29,252,89,163,0,Burke,2022-01-20
37,393,124,269,0,Burke,2022-01-12
0,87,20,67,0,Cabarrus,2022-02-11
0,8,1,7,0,Cabarrus,2022-03-05
0,4,2,2,0,Cabarrus,2022-03-11
0,5,1,4,0,Cabarrus,2022-03-12
0,5,0,5,0,Cabarrus,2022-03-13
0,6,1,5,0,Cabarrus,2022-03-14
0,3,0,3,0,Cabarrus,2022-03-15
0,4,1,3,0,Cabarrus,2022-03-18
0,4,0,4,0,Cabarrus,2022-03-20
0,5,1,4,0,Cabarrus,2022-03-23
0,3,0,3,0,Cabarrus,2022-03-26
0,6,2,4,0,Cabarrus,2022-03-27
0,6,2,4,0,Cabarrus,2022-03-29
0,4,3,1,0,Cabarrus,2022-03-30
0,8,2,6,0,Cabarrus,2022-04-01
0,3,1,2,0,Cabarrus,2022-04-09
0,5,2,3,0,Cabarrus,2022-04-10
0,20,3,17,0,Cabarrus,2022-04-12
0,12,2,10,0,Cabarrus,2022-04-16
0,9,1,8,0,Cabarrus,2022-04-17
0,20,4,16,0,Cabarrus,2022-04-23
0,20,1,19,0,Cabarrus,2022-05-01
0,53,7,46,0,Cabarrus,2022-05-15
1,9,5,4,0,Cabarrus,2022-03-04
1,10,0,10,0,Cabarrus,2022-03-09
1,6,1,5,0,Cabarrus,2022-03-16
1,6,0,6,0,Cabarrus,2022-03-19
1,5,2,3,0,Cabarrus,2022-03-21
1,12,5,7,0,Cabarrus,2022-03-28
1,6,2,4,0,Cabarrus,2022-03-31
1,7,0,7,0,Cabarrus,2022-04-03
1,13,3,10,0,Cabarrus,2022-04-04
1,7,2,5,0,Cabarrus,2022-04-05
1,9,7,2,0,Cabarrus,2022-04-06
1,12,5,7,0,Cabarrus,2022-04-08
1,29,8,21,0,Cabarrus,2022-04-18
2,11,0,11,0,Cabarrus,2022-03-22
2,7,2,5,0,Cabarrus,2022-03-24
2,6,2,4,0,Cabarrus,2022-03-25
2,36,9,27,0,Cabarrus,2022-04-28
2,35,7,28,0,Cabarrus,2022-05-08
2,48,11,37,0,Cabarrus,2022-05-14
2,30,5,25,0,Cabarrus,2022-05-28
2,33,6,27,0,Cabarrus,2022-05-30
3,104,15,89,0,Cabarrus,2021-12-14
3,117,32,85,0,Cabarrus,2021-12-24
3,69,11,58,0,Cabarrus,2022-02-16
3,70,18,52,0,Cabarrus,2022-02-17
3,26,8,18,0,Cabarrus,2022-02-23
3,18,3,15,0,Cabarrus,2022-04-11
3,22,5,17,0,Cabarrus,2022-04-14
3,23,3,20,0,Cabarrus,2022-04-22
3,42,6,36,0,Cabarrus,2022-05-02
3,68,17,51,0,Cabarrus,2022-05-04
3,36,5,31,0,Cabarrus,2022-05-07
3,62,10,52,0,Cabarrus,2022-05-11
3,75,9,66,0,Cabarrus,2022-05-12
3,40,8,32,0,Cabarrus,2022-05-21
3,55,5,50,0,Cabarrus,2022-05-22
3,59,10,49,0,Cabarrus,2022-05-24
3,42,9,33,0,Cabarrus,2022-05-29
4,41,14,27,0,Cabarrus,2022-02-22
4,40,11,29,0,Cabarrus,2022-04-13
4,58,21,37,0,Cabarrus,2022-05-03
4,57,12,45,0,Cabarrus,2022-05-10
4,72,13,59,0,Cabarrus,2022-05-20
4,41,8,33,0,Cabarrus,2022-06-11
5,150,36,114,0,Cabarrus,2022-01-22
5,18,5,13,0,Cabarrus,2022-04-15
5,37,7,30,0,Cabarrus,2022-04-19
5,30,9,21,0,Cabarrus,2022-04-20
5,38,14,24,0,Cabarrus,2022-04-24
5,38,4,34,0,Cabarrus,2022-04-27
5,32,8,24,0,Cabarrus,2022-04-29
5,47,9,38,0,Cabarrus,2022-05-06
5,76,17,59,0,Cabarrus,2022-05-19
5,97,24,73,0,Cabarrus,2022-05-23
5,64,14,50,0,Cabarrus,2022-05-26
6,117,31,86,0,Cabarrus,2022-02-09
6,74,12,62,0,Cabarrus,2022-05-09
6,93,15,78,0,Cabarrus,2022-06-02
6,78,9,69,0,Cabarrus,2022-06-10
7,161,30,131,0,Cabarrus,2021-12-20
7,146,28,118,0,Cabarrus,2022-02-04
7,46,9,37,0,Cabarrus,2022-05-05
7,86,14,72,0,Cabarrus,2022-05-25
7,75,11,64,0,Cabarrus,2022-05-27
7,55,8,47,0,Cabarrus,2022-06-04
9,30,10,20,0,Cabarrus,2022-04-21
9,91,28,63,0,Cabarrus,2022-05-16
9,98,24,74,0,Cabarrus,2022-05-18
9,120,22,98,0,Cabarrus,2022-06-01
9,62,11,51,0,Cabarrus,2022-06-03
9,108,20,88,0,Cabarrus,2022-06-06
10,106,23,83,0,Cabarrus,2022-05-13
12,74,11,63,0,Cabarrus,2022-06-08
12,76,11,65,0,Cabarrus,2022-06-09
15,68,19,49,0,Cabarrus,2022-04-25
18,131,25,106,0,Cabarrus,2022-05-31
18,79,12,67,0,Cabarrus,2022-06-07
19,279,70,209,0,Cabarrus,2022-01-09
25,353,86,267,0,Cabarrus,2021-12-31
30,505,107,398,0,Cabarrus,2021-12-29
36,504,133,371,0,Cabarrus,2021-12-27
39,398,105,293,0,Cabarrus,2022-01-21
43,639,192,447,0,Cabarrus,2022-01-03
48,578,134,444,0,Cabarrus,2021-12-30
49,529,176,353,0,Cabarrus,2022-01-24
50,704,130,574,0,Cabarrus,2022-01-04
,0,0,0,0,Caldwell,2022-04-05
0,31,9,22,0,Caldwell,2021-12-14
0,21,5,16,0,Caldwell,2021-12-18
0,22,5,17,0,Caldwell,2021-12-25
0,9,0,9,0,Caldwell,2022-03-04
0,4,0,4,0,Caldwell,2022-03-07
0,6,1,5,0,Caldwell,2022-03-08
0,1,0,1,0,Caldwell,2022-03-12
0,2,1,1,0,Caldwell,2022-03-13
0,2,0,2,0,Caldwell,2022-03-15
0,7,3,4,0,Caldwell,2022-03-17
0,2,0,2,0,Caldwell,2022-03-19
0,2,0,2,0,Caldwell,2022-03-20
0,1,0,1,0,Caldwell,2022-03-21
0,3,0,3,0,Caldwell,2022-03-24
0,3,0,3,0,Caldwell,2022-03-25
0,1,0,1,0,Caldwell,2022-03-26
0,1,0,1,0,Caldwell,2022-03-27
0,5,0,5,0,Caldwell,2022-03-28
0,3,0,3,0,Caldwell,2022-03-29
0,4,0,4,0,Caldwell,2022-03-30
0,2,0,2,0,Caldwell,2022-04-01
0,2,0,2,0,Caldwell,2022-04-03
0,2,0,2,0,Caldwell,2022-04-08
0,3,0,3,0,Caldwell,2022-04-09
0,4,0,4,0,Caldwell,2022-04-10
0,2,0,2,0,Caldwell,2022-04-11
0,8,2,6,0,Caldwell,2022-04-13
0,2,0,2,0,Caldwell,2022-04-14
0,2,0,2,0,Caldwell,2022-04-17
0,5,1,4,0,Caldwell,2022-04-18
0,8,2,6,0,Caldwell,2022-04-19
0,10,3,7,0,Caldwell,2022-04-22
0,6,0,6,0,Caldwell,2022-04-23
0,6,0,6,0,Caldwell,2022-04-24
0,3,0,3,0,Caldwell,2022-04-26
0,6,3,3,0,Caldwell,2022-04-28
0,5,1,4,0,Caldwell,2022-04-30
0,4,0,4,0,Caldwell,2022-05-07
0,20,6,14,0,Caldwell,2022-05-10
0,8,0,8,0,Caldwell,2022-05-11
0,8,2,6,0,Caldwell,2022-05-28
0,15,1,14,0,Caldwell,2022-05-29
0,13,1,12,0,Caldwell,2022-06-04
1,26,3,23,0,Caldwell,2022-02-12
1,32,2,30,0,Caldwell,2022-02-16
1,17,3,14,0,Caldwell,2022-02-20
1,13,0,13,0,Caldwell,2022-02-28
1,3,0,3,0,Caldwell,2022-03-10
1,5,1,4,0,Caldwell,2022-03-11
1,2,0,2,0,Caldwell,2022-03-16
1,2,0,2,0,Caldwell,2022-03-22
1,4,0,4,0,Caldwell,2022-04-04
1,6,0,6,0,Caldwell,2022-04-15
1,3,0,3,0,Caldwell,2022-04-16
1,10,1,9,0,Caldwell,2022-04-27
1,6,0,6,0,Caldwell,2022-04-29
1,4,1,3,0,Caldwell,2022-05-03
1,4,1,3,0,Caldwell,2022-05-04
1,11,1,10,0,Caldwell,2022-05-05
1,7,1,6,0,Caldwell,2022-05-06
1,5,0,5,0,Caldwell,2022-05-08
1,13,1,12,0,Caldwell,2022-05-09
1,12,1,11,0,Caldwell,2022-05-13
1,12,3,9,0,Caldwell,2022-05-15
1,22,4,18,0,Caldwell,2022-05-17
1,8,2,6,0,Caldwell,2022-05-21
1,16,3,13,0,Caldwell,2022-05-23
1,14,0,14,0,Caldwell,2022-05-26
1,22,3,19,0,Caldwell,2022-05-27
1,9,1,8,0,Caldwell,2022-05-30
2,52,11,41,0,Caldwell,2021-12-23
2,44,12,32,0,Caldwell,2022-01-01
2,19,2,17,0,Caldwell,2022-02-18
2,18,2,16,0,Caldwell,2022-02-24
2,7,2,5,0,Caldwell,2022-03-09
2,3,0,3,0,Caldwell,2022-04-06
2,6,1,5,0,Caldwell,2022-04-07
2,16,2,14,0,Caldwell,2022-04-21
2,8,1,7,0,Caldwell,2022-05-01
2,18,3,15,0,Caldwell,2022-05-02
2,6,1,5,0,Caldwell,2022-05-12
2,16,3,13,0,Caldwell,2022-05-20
2,12,1,11,0,Caldwell,2022-05-22
2,22,3,19,0,Caldwell,2022-05-25
2,25,5,20,0,Caldwell,2022-06-01
2,22,1,21,0,Caldwell,2022-06-06
2,17,0,17,0,Caldwell,2022-06-11
3,42,7,35,0,Caldwell,2021-12-20
3,54,4,50,0,Caldwell,2021-12-22
3,23,2,21,0,Caldwell,2022-02-17
3,10,0,10,0,Caldwell,2022-02-26
3,10,1,9,0,Caldwell,2022-03-02
3,13,2,11,0,Caldwell,2022-04-20
3,19,4,15,0,Caldwell,2022-05-18
3,15,2,13,0,Caldwell,2022-06-03
3,28,5,23,0,Caldwell,2022-06-08
3,23,3,20,0,Caldwell,2022-06-09
4,112,28,84,0,Caldwell,2022-01-23
4,15,3,12,0,Caldwell,2022-05-16
4,14,1,13,0,Caldwell,2022-05-24
5,138,17,121,0,Caldwell,2021-12-28
5,21,3,18,0,Caldwell,2022-05-19
5,26,7,19,0,Caldwell,2022-05-31
6,21,5,16,0,Caldwell,2022-04-25
6,23,2,21,0,Caldwell,2022-06-07
8,78,11,67,0,Caldwell,2021-12-31
8,71,11,60,0,Caldwell,2022-02-08
8,24,4,20,0,Caldwell,2022-06-10
9,79,11,68,0,Caldwell,2022-01-02
11,98,24,74,0,Caldwell,2022-01-08
22,134,23,111,0,Caldwell,2021-12-30
24,205,42,163,0,Caldwell,2022-01-07
26,219,31,188,0,Caldwell,2022-01-04
28,298,42,256,0,Caldwell,2022-01-10
38,322,76,246,0,Caldwell,2022-01-13
44,397,106,291,0,Caldwell,2022-01-20
,0,0,0,0,Camden,2021-12-25
,0,0,0,0,Camden,2022-02-02
,0,0,0,0,Camden,2022-02-04
,0,0,0,0,Camden,2022-02-05
,0,0,0,0,Camden,2022-02-06
,0,0,0,0,Camden,2022-02-13
,0,0,0,0,Camden,2022-02-14
,0,0,0,0,Camden,2022-02-17
,0,0,0,0,Camden,2022-02-18
,0,0,0,0,Camden,2022-02-20
,0,0,0,0,Camden,2022-02-23
,0,0,0,0,Camden,2022-02-26
,0,0,0,0,Camden,2022-02-28
,0,0,0,0,Camden,2022-03-02
,0,0,0,0,Camden,2022-03-03
,0,0,0,0,Camden,2022-03-04
,0,0,0,0,Camden,2022-03-05
,0,0,0,0,Camden,2022-03-06
,0,0,0,0,Camden,2022-03-07
,0,0,0,0,Camden,2022-03-10
,0,0,0,0,Camden,2022-03-11
,0,0,0,0,Camden,2022-03-12
,0,0,0,0,Camden,2022-03-13
,0,0,0,0,Camden,2022-03-14
,0,0,0,0,Camden,2022-03-15
,0,0,0,0,Camden,2022-03-16
,0,0,0,0,Camden,2022-03-17
,0,0,0,0,Camden,2022-03-18
,0,0,0,0,Camden,2022-03-19
,0,0,0,0,Camden,2022-03-20
,0,0,0,0,Camden,2022-03-21
,0,0,0,0,Camden,2022-03-22
,0,0,0,0,Camden,2022-03-23
,0,0,0,0,Camden,2022-03-25
,0,0,0,0,Camden,2022-03-26
,0,0,0,0,Camden,2022-03-27
,0,0,0,0,Camden,2022-03-28
,0,0,0,0,Camden,2022-03-29
,0,0,0,0,Camden,2022-03-30
,0,0,0,0,Camden,2022-04-02
,0,0,0,0,Camden,2022-04-04
,0,0,0,0,Camden,2022-04-06
,0,0,0,0,Camden,2022-04-08
,0,0,0,0,Camden,2022-04-09
,0,0,0,0,Camden,2022-04-10
,0,0,0,0,Camden,2022-04-11
,0,0,0,0,Camden,2022-04-13
,0,0,0,0,Camden,2022-04-15
,0,0,0,0,Camden,2022-04-16
,0,0,0,0,Camden,2022-04-17
,0,0,0,0,Camden,2022-04-18
,0,0,0,0,Camden,2022-04-20
,0,0,0,0,Camden,2022-04-21
,0,0,0,0,Camden,2022-04-22
,0,0,0,0,Camden,2022-04-23
,0,0,0,0,Camden,2022-04-24
,0,0,0,0,Camden,2022-04-26
,0,0,0,0,Camden,2022-04-27
,0,0,0,0,Camden,2022-04-30
,0,0,0,0,Camden,2022-05-01
,0,0,0,0,Camden,2022-05-10
,0,0,0,0,Camden,2022-05-13
,0,0,0,0,Camden,2022-05-15
,0,0,0,0,Camden,2022-05-21
,0,0,0,0,Camden,2022-05-28
,0,0,0,0,Camden,2022-06-03
,0,0,0,0,Camden,2022-06-05
,0,0,0,0,Camden,2022-06-07
0,4,1,3,0,Camden,2021-12-14
0,2,0,2,0,Camden,2021-12-15
0,6,1,5,0,Camden,2021-12-16
0,1,0,1,0,Camden,2021-12-18
0,5,3,2,0,Camden,2021-12-19
0,6,4,2,0,Camden,2021-12-20
0,2,0,2,0,Camden,2021-12-21
0,4,2,2,0,Camden,2021-12-23
0,3,0,3,0,Camden,2021-12-24
0,5,3,2,0,Camden,2021-12-26
0,7,0,7,0,Camden,2021-12-27
0,15,5,10,0,Camden,2021-12-28
0,5,0,5,0,Camden,2021-12-31
0,4,1,3,0,Camden,2022-01-01
0,7,1,6,0,Camden,2022-01-02
0,12,3,9,0,Camden,2022-01-07
0,5,1,4,0,Camden,2022-01-08
0,12,3,9,0,Camden,2022-01-14
0,7,2,5,0,Camden,2022-01-20
0,1,1,0,0,Camden,2022-01-21
0,1,0,1,0,Camden,2022-01-22
0,3,2,1,0,Camden,2022-01-23
0,16,10,6,0,Camden,2022-01-24
0,5,2,3,0,Camden,2022-01-25
0,11,2,9,0,Camden,2022-01-26
0,12,6,6,0,Camden,2022-01-27
0,6,0,6,0,Camden,2022-01-28
0,5,0,5,0,Camden,2022-01-30
0,1,0,1,0,Camden,2022-01-31
0,1,0,1,0,Camden,2022-02-01
0,2,1,1,0,Camden,2022-02-07
0,3,1,2,0,Camden,2022-02-09
0,1,0,1,0,Camden,2022-02-11
0,3,1,2,0,Camden,2022-02-12
0,1,0,1,0,Camden,2022-02-15
0,1,1,0,0,Camden,2022-02-21
0,4,2,2,0,Camden,2022-02-22
0,2,1,1,0,Camden,2022-02-25
0,1,1,0,0,Camden,2022-02-27
0,1,0,1,0,Camden,2022-03-01
0,1,0,1,0,Camden,2022-03-08
0,1,0,1,0,Camden,2022-03-09
0,1,0,1,0,Camden,2022-03-24
0,2,0,2,0,Camden,2022-03-31
0,1,0,1,0,Camden,2022-04-01
0,2,0,2,0,Camden,2022-04-03
0,3,0,3,0,Camden,2022-04-05
0,1,0,1,0,Camden,2022-04-07
0,1,1,0,0,Camden,2022-04-14
0,1,0,1,0,Camden,2022-04-19
0,2,0,2,0,Camden,2022-04-25
0,2,2,0,0,Camden,2022-04-29
0,3,1,2,0,Camden,2022-05-02
0,1,0,1,0,Camden,2022-05-03
0,1,0,1,0,Camden,2022-05-04
0,1,0,1,0,Camden,2022-05-05
0,2,1,1,0,Camden,2022-05-06
0,1,0,1,0,Camden,2022-05-07
0,1,0,1,0,Camden,2022-05-08
0,2,1,1,0,Camden,2022-05-09
0,3,1,2,0,Camden,2022-05-11
0,1,0,1,0,Camden,2022-05-12
0,4,1,3,0,Camden,2022-05-14
0,2,1,1,0,Camden,2022-05-17
0,2,0,2,0,Camden,2022-05-18
0,1,0,1,0,Camden,2022-05-19
0,3,1,2,0,Camden,2022-05-20
0,2,1,1,0,Camden,2022-05-22
0,3,1,2,0,Camden,2022-05-24
0,2,2,0,0,Camden,2022-05-25
0,3,2,1,0,Camden,2022-05-26
0,4,3,1,0,Camden,2022-05-27
0,4,0,4,0,Camden,2022-05-29
0,2,2,0,0,Camden,2022-05-30
0,3,1,2,0,Camden,2022-06-01
0,1,1,0,0,Camden,2022-06-02
0,1,1,0,0,Camden,2022-06-04
0,1,1,0,0,Camden,2022-06-06
0,3,1,2,0,Camden,2022-06-08
0,2,2,0,0,Camden,2022-06-09
0,3,0,3,0,Camden,2022-06-11
1,3,2,1,0,Camden,2021-12-22
1,10,3,7,0,Camden,2021-12-29
1,15,3,12,0,Camden,2021-12-30
1,20,4,16,0,Camden,2022-01-04
1,20,7,13,0,Camden,2022-01-06
1,14,3,11,0,Camden,2022-01-10
1,9,3,6,0,Camden,2022-01-15
1,5,2,3,0,Camden,2022-01-16
1,7,6,1,0,Camden,2022-01-17
1,17,5,12,0,Camden,2022-01-18
1,14,7,7,0,Camden,2022-01-19
1,1,1,0,0,Camden,2022-01-29
1,2,0,2,0,Camden,2022-02-03
1,2,1,1,0,Camden,2022-02-08
1,3,0,3,0,Camden,2022-02-16
1,1,0,1,0,Camden,2022-02-19
1,3,2,1,0,Camden,2022-04-28
1,2,0,2,0,Camden,2022-05-16
1,4,2,2,0,Camden,2022-05-23
1,4,0,4,0,Camden,2022-05-31
1,3,0,3,0,Camden,2022-06-10
2,20,5,15,0,Camden,2022-01-03
2,26,10,16,0,Camden,2022-01-13
2,3,2,1,0,Camden,2022-02-10
2,2,0,2,0,Camden,2022-02-24
3,21,8,13,0,Camden,2022-01-12
4,21,5,16,0,Camden,2022-01-11
5,25,5,20,0,Camden,2022-01-05
,0,0,0,0,Carteret,2022-03-20
,0,0,0,0,Carteret,2022-03-26
,0,0,0,0,Carteret,2022-03-29
,0,0,0,0,Carteret,2022-04-17
0,15,6,9,0,Carteret,2021-12-17
0,29,5,24,0,Carteret,2021-12-20
0,26,10,16,0,Carteret,2021-12-22
0,24,7,17,0,Carteret,2021-12-26
0,82,27,55,0,Carteret,2021-12-29
0,28,5,23,0,Carteret,2022-02-05
0,24,7,17,0,Carteret,2022-02-06
0,16,4,12,0,Carteret,2022-02-23
0,3,0,3,0,Carteret,2022-02-27
0,6,1,5,0,Carteret,2022-02-28
0,4,0,4,0,Carteret,2022-03-04
0,5,0,5,0,Carteret,2022-03-05
0,3,1,2,0,Carteret,2022-03-06
0,5,2,3,0,Carteret,2022-03-10
0,6,3,3,0,Carteret,2022-03-11
0,3,0,3,0,Carteret,2022-03-12
0,2,0,2,0,Carteret,2022-03-13
0,3,0,3,0,Carteret,2022-03-14
0,5,0,5,0,Carteret,2022-03-15
0,2,1,1,0,Carteret,2022-03-17
0,2,0,2,0,Carteret,2022-03-18
0,1,0,1,0,Carteret,2022-03-19
0,3,1,2,0,Carteret,2022-03-21
0,4,2,2,0,Carteret,2022-03-22
0,1,0,1,0,Carteret,2022-03-23
0,1,0,1,0,Carteret,2022-03-24
0,2,2,0,0,Carteret,2022-03-25
0,3,1,2,0,Carteret,2022-03-28
0,3,0,3,0,Carteret,2022-04-01
0,1,0,1,0,Carteret,2022-04-02
0,2,1,1,0,Carteret,2022-04-04
0,1,0,1,0,Carteret,2022-04-06
0,2,1,1,0,Carteret,2022-04-07
0,2,1,1,0,Carteret,2022-04-08
0,2,1,1,0,Carteret,2022-04-10
0,6,2,4,0,Carteret,2022-04-12
0,4,1,3,0,Carteret,2022-04-14
0,2,1,1,0,Carteret,2022-04-15
0,2,0,2,0,Carteret,2022-04-16
0,8,4,4,0,Carteret,2022-04-20
0,8,6,2,0,Carteret,2022-04-21
0,7,2,5,0,Carteret,2022-04-22
0,7,1,6,0,Carteret,2022-04-23
0,2,0,2,0,Carteret,2022-04-24
0,11,4,7,0,Carteret,2022-04-25
0,9,1,8,0,Carteret,2022-04-26
0,4,0,4,0,Carteret,2022-04-27
0,4,1,3,0,Carteret,2022-04-29
0,2,0,2,0,Carteret,2022-04-30
0,11,8,3,0,Carteret,2022-05-04
0,8,3,5,0,Carteret,2022-05-07
0,7,0,7,0,Carteret,2022-05-08
0,18,10,8,0,Carteret,2022-05-10
0,12,5,7,0,Carteret,2022-05-13
0,11,1,10,0,Carteret,2022-05-14
0,4,3,1,0,Carteret,2022-05-15
0,18,8,10,0,Carteret,2022-05-20
0,10,3,7,0,Carteret,2022-06-04
0,13,1,12,0,Carteret,2022-06-05
0,34,13,21,0,Carteret,2022-06-06
1,19,8,11,0,Carteret,2021-12-15
1,10,2,8,0,Carteret,2021-12-18
1,26,7,19,0,Carteret,2021-12-21
1,16,4,12,0,Carteret,2021-12-24
1,2,1,1,0,Carteret,2021-12-25
1,7,4,3,0,Carteret,2022-01-01
1,30,11,19,0,Carteret,2022-01-08
1,51,14,37,0,Carteret,2022-01-15
1,53,9,44,0,Carteret,2022-01-16
1,29,7,22,0,Carteret,2022-01-22
1,32,7,25,0,Carteret,2022-01-30
1,15,8,7,0,Carteret,2022-02-18
1,6,1,5,0,Carteret,2022-02-20
1,20,7,13,0,Carteret,2022-02-22
1,17,7,10,0,Carteret,2022-02-24
1,9,2,7,0,Carteret,2022-03-01
1,6,2,4,0,Carteret,2022-03-08
1,3,0,3,0,Carteret,2022-03-27
1,2,1,1,0,Carteret,2022-03-30
1,2,2,0,0,Carteret,2022-04-03
1,3,1,2,0,Carteret,2022-04-09
1,6,4,2,0,Carteret,2022-04-13
1,5,4,1,0,Carteret,2022-04-19
1,8,1,7,0,Carteret,2022-05-01
1,12,6,6,0,Carteret,2022-05-02
1,16,3,13,0,Carteret,2022-05-12
1,13,4,9,0,Carteret,2022-05-22
1,8,2,6,0,Carteret,2022-05-30
1,16,5,11,0,Carteret,2022-06-08
1,21,8,13,0,Carteret,2022-06-10
2,61,13,48,0,Carteret,2021-12-27
2,40,9,31,0,Carteret,2022-01-02
2,44,13,31,0,Carteret,2022-02-08
2,42,14,28,0,Carteret,2022-02-10
2,37,17,20,0,Carteret,2022-02-15
2,10,5,5,0,Carteret,2022-05-06
2,15,3,12,0,Carteret,2022-05-16
2,22,8,14,0,Carteret,2022-05-19
2,24,9,15,0,Carteret,2022-05-24
2,21,7,14,0,Carteret,2022-05-28
2,25,7,18,0,Carteret,2022-06-03
2,24,14,10,0,Carteret,2022-06-07
2,19,8,11,0,Carteret,2022-06-09
2,20,7,13,0,Carteret,2022-06-11
3,94,38,56,0,Carteret,2021-12-30
3,55,17,38,0,Carteret,2022-01-09
3,5,3,2,0,Carteret,2022-04-11
3,14,6,8,0,Carteret,2022-05-05
3,11,6,5,0,Carteret,2022-05-09
3,22,12,10,0,Carteret,2022-05-11
3,22,8,14,0,Carteret,2022-05-23
3,23,7,16,0,Carteret,2022-05-26
3,36,9,27,0,Carteret,2022-05-27
3,23,6,17,0,Carteret,2022-06-01
3,30,12,18,0,Carteret,2022-06-02
4,127,55,72,0,Carteret,2022-01-06
4,64,25,39,0,Carteret,2022-01-21
4,31,16,15,0,Carteret,2022-05-18
4,12,6,6,0,Carteret,2022-05-21
4,13,2,11,0,Carteret,2022-05-29
5,39,12,27,0,Carteret,2021-12-31
5,119,47,72,0,Carteret,2022-01-26
5,43,9,34,0,Carteret,2022-02-09
5,52,33,19,0,Carteret,2022-05-31
6,69,21,48,0,Carteret,2021-12-28
6,190,83,107,0,Carteret,2022-01-10
6,93,35,58,0,Carteret,2022-02-01
7,110,35,75,0,Carteret,2022-01-27
7,79,31,48,0,Carteret,2022-02-07
8,193,70,123,0,Carteret,2022-01-14
8,165,56,109,0,Carteret,2022-01-25
9,171,55,116,0,Carteret,2022-01-20
12,212,80,132,0,Carteret,2022-01-19
13,266,109,157,0,Carteret,2022-01-18
17,228,112,116,0,Carteret,2022-01-24
,0,0,0,0,Caswell,2022-03-01
,0,0,0,0,Caswell,2022-03-04
,0,0,0,0,Caswell,2022-03-06
,0,0,0,0,Caswell,2022-03-08
,0,0,0,0,Caswell,2022-03-09
,0,0,0,0,Caswell,2022-03-11
,0,0,0,0,Caswell,2022-03-12
,0,0,0,0,Caswell,2022-03-13
,0,0,0,0,Caswell,2022-03-14
,0,0,0,0,Caswell,2022-03-18
,0,0,0,0,Caswell,2022-03-20
,0,0,0,0,Caswell,2022-03-21
,0,0,0,0,Caswell,2022-03-22
,0,0,0,0,Caswell,2022-03-23
,0,0,0,0,Caswell,2022-03-24
,0,0,0,0,Caswell,2022-03-26
,0,0,0,0,Caswell,2022-03-27
,0,0,0,0,Caswell,2022-03-29
,0,0,0,0,Caswell,2022-04-01
,0,0,0,0,Caswell,2022-04-02
,0,0,0,0,Caswell,2022-04-03
,0,0,0,0,Caswell,2022-04-05
,0,0,0,0,Caswell,2022-04-16
,0,0,0,0,Caswell,2022-04-17
,0,0,0,0,Caswell,2022-04-18
,0,0,0,0,Caswell,2022-04-30
,0,0,0,0,Caswell,2022-05-22
0,8,3,5,0,Caswell,2021-12-14
0,11,0,11,0,Caswell,2021-12-15
0,3,0,3,0,Caswell,2021-12-16
0,2,0,2,0,Caswell,2021-12-18
0,8,0,8,0,Caswell,2021-12-21
0,9,1,8,0,Caswell,2021-12-22
0,7,2,5,0,Caswell,2021-12-24
0,2,1,1,0,Caswell,2021-12-25
0,12,0,12,0,Caswell,2021-12-26
0,25,2,23,0,Caswell,2021-12-29
0,8,1,7,0,Caswell,2022-01-01
0,5,1,4,0,Caswell,2022-01-16
0,28,2,26,0,Caswell,2022-01-26
0,3,0,3,0,Caswell,2022-01-29
0,4,1,3,0,Caswell,2022-01-30
0,4,0,4,0,Caswell,2022-02-06
0,11,1,10,0,Caswell,2022-02-07
0,13,2,11,0,Caswell,2022-02-09
0,11,1,10,0,Caswell,2022-02-10
0,10,1,9,0,Caswell,2022-02-11
0,3,1,2,0,Caswell,2022-02-13
0,7,0,7,0,Caswell,2022-02-15
0,5,1,4,0,Caswell,2022-02-17
0,2,0,2,0,Caswell,2022-02-23
0,1,0,1,0,Caswell,2022-02-26
0,1,0,1,0,Caswell,2022-02-27
0,2,0,2,0,Caswell,2022-02-28
0,1,0,1,0,Caswell,2022-03-05
0,1,0,1,0,Caswell,2022-03-07
0,2,1,1,0,Caswell,2022-03-15
0,4,1,3,0,Caswell,2022-03-16
0,1,0,1,0,Caswell,2022-03-17
0,1,0,1,0,Caswell,2022-03-19
0,2,0,2,0,Caswell,2022-03-25
0,2,0,2,0,Caswell,2022-03-28
0,1,0,1,0,Caswell,2022-03-30
0,3,0,3,0,Caswell,2022-04-04
0,1,0,1,0,Caswell,2022-04-06
0,1,0,1,0,Caswell,2022-04-07
0,1,0,1,0,Caswell,2022-04-08
0,2,0,2,0,Caswell,2022-04-09
0,1,0,1,0,Caswell,2022-04-10
0,3,0,3,0,Caswell,2022-04-11
0,1,0,1,0,Caswell,2022-04-12
0,1,0,1,0,Caswell,2022-04-13
0,1,0,1,0,Caswell,2022-04-14
0,2,1,1,0,Caswell,2022-04-15
0,7,0,7,0,Caswell,2022-04-19
0,1,0,1,0,Caswell,2022-04-20
0,3,1,2,0,Caswell,2022-04-21
0,2,0,2,0,Caswell,2022-04-22
0,3,0,3,0,Caswell,2022-04-23
0,3,0,3,0,Caswell,2022-04-24
0,1,0,1,0,Caswell,2022-04-26
0,4,0,4,0,Caswell,2022-04-27
0,3,1,2,0,Caswell,2022-04-28
0,1,0,1,0,Caswell,2022-04-29
0,2,1,1,0,Caswell,2022-05-01
0,2,1,1,0,Caswell,2022-05-03
0,7,1,6,0,Caswell,2022-05-04
0,2,0,2,0,Caswell,2022-05-06
0,3,0,3,0,Caswell,2022-05-07
0,5,0,5,0,Caswell,2022-05-14
0,4,0,4,0,Caswell,2022-05-15
0,3,0,3,0,Caswell,2022-05-17
0,6,1,5,0,Caswell,2022-05-24
0,5,0,5,0,Caswell,2022-05-28
0,4,1,3,0,Caswell,2022-06-04
0,11,0,11,0,Caswell,2022-06-06
0,9,0,9,0,Caswell,2022-06-08
0,6,1,5,0,Caswell,2022-06-10
0,1,0,1,0,Caswell,2022-06-11
1,11,0,11,0,Caswell,2021-12-23
1,12,3,9,0,Caswell,2021-12-31
1,54,5,49,0,Caswell,2022-01-14
1,45,3,42,0,Caswell,2022-01-21
1,21,0,21,0,Caswell,2022-01-23
1,8,1,7,0,Caswell,2022-02-04
1,4,0,4,0,Caswell,2022-02-05
1,3,2,1,0,Caswell,2022-02-19
1,8,0,8,0,Caswell,2022-02-21
1,5,0,5,0,Caswell,2022-02-24
1,4,0,4,0,Caswell,2022-02-25
1,1,0,1,0,Caswell,2022-03-10
1,1,0,1,0,Caswell,2022-03-31
1,4,0,4,0,Caswell,2022-05-02
1,7,2,5,0,Caswell,2022-05-05
1,13,3,10,0,Caswell,2022-05-09
1,9,2,7,0,Caswell,2022-05-10
1,9,2,7,0,Caswell,2022-05-13
1,9,1,8,0,Caswell,2022-05-18
1,5,1,4,0,Caswell,2022-05-19
1,2,0,2,0,Caswell,2022-05-20
1,8,1,7,0,Caswell,2022-05-25
1,8,0,8,0,Caswell,2022-05-26
1,9,0,9,0,Caswell,2022-05-27
1,7,0,7,0,Caswell,2022-05-29
1,4,2,2,0,Caswell,2022-05-30
1,7,0,7,0,Caswell,2022-06-03
2,19,1,18,0,Caswell,2021-12-20
2,9,0,9,0,Caswell,2022-01-02
2,14,1,13,0,Caswell,2022-01-08
2,22,2,20,0,Caswell,2022-01-15
2,51,4,47,0,Caswell,2022-01-18
2,62,2,60,0,Caswell,2022-01-25
2,25,1,24,0,Caswell,2022-02-08
2,13,2,11,0,Caswell,2022-05-11
2,9,1,8,0,Caswell,2022-05-16
2,8,1,7,0,Caswell,2022-05-23
2,9,2,7,0,Caswell,2022-06-01
2,13,0,13,0,Caswell,2022-06-07
2,10,3,7,0,Caswell,2022-06-09
3,69,0,69,0,Caswell,2022-01-11
3,4,2,2,0,Caswell,2022-05-12
4,38,2,36,0,Caswell,2021-12-28
4,50,6,44,0,Caswell,2021-12-30
4,88,7,81,0,Caswell,2022-01-05
4,17,1,16,0,Caswell,2022-02-02
5,96,8,88,0,Caswell,2022-01-12
5,75,7,68,0,Caswell,2022-01-24
5,33,2,31,0,Caswell,2022-01-27
5,25,3,22,0,Caswell,2022-01-28
5,26,1,25,0,Caswell,2022-01-31
6,49,3,46,0,Caswell,2022-01-03
6,67,2,65,0,Caswell,2022-01-06
6,83,8,75,0,Caswell,2022-01-19
7,89,5,84,0,Caswell,2022-01-10
7,28,1,27,0,Caswell,2022-01-17
8,55,1,54,0,Caswell,2021-12-27
9,63,4,59,0,Caswell,2022-01-04
0,43,13,30,0,Catawba,2021-12-18
0,7,3,4,0,Catawba,2022-03-10
0,9,4,5,0,Catawba,2022-03-18
0,3,1,2,0,Catawba,2022-03-19
0,1,0,1,0,Catawba,2022-03-20
0,1,1,0,0,Catawba,2022-03-25
0,1,1,0,0,Catawba,2022-04-02
0,5,3,2,0,Catawba,2022-04-05
0,3,2,1,0,Catawba,2022-04-08
0,1,0,1,0,Catawba,2022-04-09
0,9,0,9,0,Catawba,2022-04-10
0,9,5,4,0,Catawba,2022-04-15
0,3,2,1,0,Catawba,2022-04-17
0,16,7,9,0,Catawba,2022-04-18
0,8,2,6,0,Catawba,2022-04-23
0,7,1,6,0,Catawba,2022-05-01
1,55,21,34,0,Catawba,2022-01-16
1,32,14,18,0,Catawba,2022-02-25
1,15,9,6,0,Catawba,2022-03-01
1,18,6,12,0,Catawba,2022-03-04
1,13,2,11,0,Catawba,2022-03-06
1,3,2,1,0,Catawba,2022-03-12
1,8,6,2,0,Catawba,2022-03-13
1,6,3,3,0,Catawba,2022-03-16
1,7,4,3,0,Catawba,2022-03-21
1,9,6,3,0,Catawba,2022-03-24
1,6,2,4,0,Catawba,2022-03-28
1,4,2,2,0,Catawba,2022-04-06
1,11,4,7,0,Catawba,2022-04-11
1,4,3,1,0,Catawba,2022-04-12
1,9,3,6,0,Catawba,2022-04-16
1,11,4,7,0,Catawba,2022-04-19
1,9,4,5,0,Catawba,2022-04-26
1,22,8,14,0,Catawba,2022-04-27
1,10,4,6,0,Catawba,2022-04-29
1,24,19,5,0,Catawba,2022-05-05
1,27,9,18,0,Catawba,2022-05-06
1,41,16,25,0,Catawba,2022-05-09
1,16,8,8,0,Catawba,2022-05-30
1,21,3,18,0,Catawba,2022-06-04
2,105,25,80,0,Catawba,2021-12-20
2,57,20,37,0,Catawba,2021-12-24
2,56,23,33,0,Catawba,2022-02-17
2,8,5,3,0,Catawba,2022-03-05
2,16,4,12,0,Catawba,2022-03-11
2,7,3,4,0,Catawba,2022-03-14
2,7,3,4,0,Catawba,2022-03-31
2,2,2,0,0,Catawba,2022-04-03
2,8,5,3,0,Catawba,2022-04-04
2,4,3,1,0,Catawba,2022-04-07
2,12,5,7,0,Catawba,2022-04-14
2,16,7,9,0,Catawba,2022-04-22
2,9,3,6,0,Catawba,2022-04-24
2,19,8,11,0,Catawba,2022-04-25
2,12,4,8,0,Catawba,2022-04-28
2,32,16,16,0,Catawba,2022-05-12
2,28,9,19,0,Catawba,2022-05-14
2,43,10,33,0,Catawba,2022-05-22
2,41,23,18,0,Catawba,2022-06-03
3,67,25,42,0,Catawba,2021-12-14
3,30,15,15,0,Catawba,2022-05-02
3,13,5,8,0,Catawba,2022-05-08
3,30,14,16,0,Catawba,2022-05-11
3,50,22,28,0,Catawba,2022-05-19
3,25,13,12,0,Catawba,2022-05-21
3,41,20,21,0,Catawba,2022-05-27
3,27,7,20,0,Catawba,2022-06-11
4,26,8,18,0,Catawba,2022-03-02
4,16,9,7,0,Catawba,2022-04-21
4,16,5,11,0,Catawba,2022-04-30
4,34,18,16,0,Catawba,2022-05-04
4,17,3,14,0,Catawba,2022-05-07
4,31,14,17,0,Catawba,2022-05-13
4,51,26,25,0,Catawba,2022-05-18
4,37,6,31,0,Catawba,2022-05-28
4,59,29,30,0,Catawba,2022-05-31
4,40,21,19,0,Catawba,2022-06-09
5,27,7,20,0,Catawba,2022-05-15
5,43,27,16,0,Catawba,2022-05-20
6,88,42,46,0,Catawba,2021-12-15
6,75,36,39,0,Catawba,2022-02-21
6,40,15,25,0,Catawba,2022-05-10
6,30,7,23,0,Catawba,2022-05-29
6,55,21,34,0,Catawba,2022-06-01
6,53,20,33,0,Catawba,2022-06-08
7,106,35,71,0,Catawba,2022-01-30
7,62,17,45,0,Catawba,2022-06-02
7,36,12,24,0,Catawba,2022-06-10
8,41,15,26,0,Catawba,2022-06-07
9,100,23,77,0,Catawba,2021-12-26
9,66,28,38,0,Catawba,2022-05-16
9,64,30,34,0,Catawba,2022-05-23
10,56,30,26,0,Catawba,2022-06-06
11,63,28,35,0,Catawba,2022-05-26
12,61,30,31,0,Catawba,2022-05-24
15,216,57,159,0,Catawba,2022-01-22
17,254,75,179,0,Catawba,2021-12-27
22,203,81,122,0,Catawba,2021-12-31
26,317,119,198,0,Catawba,2021-12-29
50,594,219,375,0,Catawba,2022-01-24
62,442,166,276,0,Catawba,2022-01-07
,0,0,0,0,Chatham,2022-03-13
0,17,0,17,0,Chatham,2021-12-14
0,29,4,25,0,Chatham,2021-12-15
0,19,5,14,0,Chatham,2021-12-18
0,13,1,12,0,Chatham,2022-01-16
0,9,5,4,0,Chatham,2022-02-06
0,19,2,17,0,Chatham,2022-02-11
0,8,2,6,0,Chatham,2022-02-12
0,13,6,7,0,Chatham,2022-02-13
0,14,6,8,0,Chatham,2022-02-20
0,15,4,11,0,Chatham,2022-02-23
0,13,4,9,0,Chatham,2022-02-24
0,8,3,5,0,Chatham,2022-02-25
0,4,1,3,0,Chatham,2022-02-27
0,2,0,2,0,Chatham,2022-03-05
0,4,2,2,0,Chatham,2022-03-06
0,10,1,9,0,Chatham,2022-03-07
0,4,0,4,0,Chatham,2022-03-09
0,6,0,6,0,Chatham,2022-03-10
0,1,0,1,0,Chatham,2022-03-12
0,9,3,6,0,Chatham,2022-03-15
0,3,1,2,0,Chatham,2022-03-16
0,3,0,3,0,Chatham,2022-03-17
0,5,0,5,0,Chatham,2022-03-18
0,1,0,1,0,Chatham,2022-03-19
0,5,1,4,0,Chatham,2022-03-20
0,1,0,1,0,Chatham,2022-03-22
0,2,1,1,0,Chatham,2022-03-24
0,1,0,1,0,Chatham,2022-03-26
0,1,0,1,0,Chatham,2022-03-27
0,3,1,2,0,Chatham,2022-03-28
0,4,1,3,0,Chatham,2022-03-31
0,2,2,0,0,Chatham,2022-04-01
0,2,2,0,0,Chatham,2022-04-03
0,8,2,6,0,Chatham,2022-04-05
0,12,4,8,0,Chatham,2022-04-06
0,8,0,8,0,Chatham,2022-04-08
0,9,1,8,0,Chatham,2022-04-09
0,7,1,6,0,Chatham,2022-04-10
0,14,1,13,0,Chatham,2022-04-11
0,11,1,10,0,Chatham,2022-04-14
0,7,3,4,0,Chatham,2022-04-15
0,5,0,5,0,Chatham,2022-04-16
0,5,1,4,0,Chatham,2022-04-17
0,9,0,9,0,Chatham,2022-04-18
0,12,0,12,0,Chatham,2022-04-22
0,4,0,4,0,Chatham,2022-04-23
0,8,0,8,0,Chatham,2022-04-24
0,16,3,13,0,Chatham,2022-04-25
0,18,3,15,0,Chatham,2022-04-27
0,10,1,9,0,Chatham,2022-04-30
0,16,5,11,0,Chatham,2022-05-01
0,18,1,17,0,Chatham,2022-05-15
0,39,7,32,0,Chatham,2022-05-23
0,13,0,13,0,Chatham,2022-06-11
1,38,2,36,0,Chatham,2021-12-20
1,33,2,31,0,Chatham,2021-12-24
1,8,4,4,0,Chatham,2021-12-25
1,146,19,127,0,Chatham,2021-12-27
1,79,12,67,0,Chatham,2022-01-08
1,54,9,45,0,Chatham,2022-02-02
1,49,12,37,0,Chatham,2022-02-04
1,27,3,24,0,Chatham,2022-02-10
1,35,11,24,0,Chatham,2022-02-14
1,23,4,19,0,Chatham,2022-02-21
1,9,5,4,0,Chatham,2022-02-22
1,10,5,5,0,Chatham,2022-02-28
1,11,0,11,0,Chatham,2022-03-02
1,7,3,4,0,Chatham,2022-03-03
1,8,1,7,0,Chatham,2022-03-04
1,8,1,7,0,Chatham,2022-03-08
1,7,0,7,0,Chatham,2022-03-11
1,7,1,6,0,Chatham,2022-03-14
1,9,4,5,0,Chatham,2022-03-21
1,1,0,1,0,Chatham,2022-03-23
1,1,0,1,0,Chatham,2022-03-25
1,12,0,12,0,Chatham,2022-04-19
1,18,6,12,0,Chatham,2022-04-20
1,8,1,7,0,Chatham,2022-04-21
1,18,2,16,0,Chatham,2022-04-29
1,28,5,23,0,Chatham,2022-05-09
1,22,3,19,0,Chatham,2022-05-12
1,32,4,28,0,Chatham,2022-05-17
1,35,4,31,0,Chatham,2022-05-20
1,14,1,13,0,Chatham,2022-05-21
1,37,7,30,0,Chatham,2022-05-26
1,17,5,12,0,Chatham,2022-05-28
1,8,1,7,0,Chatham,2022-05-29
1,14,1,13,0,Chatham,2022-05-30
1,13,0,13,0,Chatham,2022-06-04
1,10,1,9,0,Chatham,2022-06-05
1,24,3,21,0,Chatham,2022-06-06
1,17,3,14,0,Chatham,2022-06-09
2,51,9,42,0,Chatham,2021-12-23
2,121,25,96,0,Chatham,2021-12-28
2,67,15,52,0,Chatham,2021-12-31
2,20,3,17,0,Chatham,2022-01-01
2,31,3,28,0,Chatham,2022-01-22
2,106,25,81,0,Chatham,2022-01-31
2,35,15,20,0,Chatham,2022-02-08
2,18,5,13,0,Chatham,2022-02-17
2,11,4,7,0,Chatham,2022-03-01
2,12,3,9,0,Chatham,2022-04-07
2,15,1,14,0,Chatham,2022-04-12
2,18,2,16,0,Chatham,2022-04-13
2,20,2,18,0,Chatham,2022-04-26
2,26,5,21,0,Chatham,2022-05-06
2,39,4,35,0,Chatham,2022-05-10
2,21,7,14,0,Chatham,2022-05-11
2,32,5,27,0,Chatham,2022-05-13
2,23,4,19,0,Chatham,2022-05-24
2,32,9,23,0,Chatham,2022-05-27
2,18,1,17,0,Chatham,2022-06-07
2,24,2,22,0,Chatham,2022-06-08
3,118,18,100,0,Chatham,2022-01-25
3,111,12,99,0,Chatham,2022-01-26
3,34,11,23,0,Chatham,2022-05-02
3,11,1,10,0,Chatham,2022-05-07
3,22,4,18,0,Chatham,2022-05-08
3,58,7,51,0,Chatham,2022-05-31
3,25,6,19,0,Chatham,2022-06-03
4,37,8,29,0,Chatham,2022-05-04
4,33,8,25,0,Chatham,2022-05-19
4,19,2,17,0,Chatham,2022-05-22
4,31,7,24,0,Chatham,2022-06-01
5,106,18,88,0,Chatham,2021-12-30
5,59,15,44,0,Chatham,2022-01-02
5,87,3,84,0,Chatham,2022-01-17
5,30,9,21,0,Chatham,2022-01-30
5,70,17,53,0,Chatham,2022-02-07
5,41,9,32,0,Chatham,2022-05-16
6,84,13,71,0,Chatham,2022-01-15
6,173,19,154,0,Chatham,2022-01-20
6,71,18,53,0,Chatham,2022-02-03
6,42,7,35,0,Chatham,2022-05-18
7,186,21,165,0,Chatham,2022-01-19
9,205,33,172,0,Chatham,2022-01-24
10,166,27,139,0,Chatham,2022-01-03
10,187,30,157,0,Chatham,2022-01-04
10,170,35,135,0,Chatham,2022-01-05
10,169,6,163,0,Chatham,2022-01-11
10,85,19,66,0,Chatham,2022-01-27
11,128,26,102,0,Chatham,2021-12-29
12,166,24,142,0,Chatham,2022-01-06
12,181,5,176,0,Chatham,2022-01-12
12,245,47,198,0,Chatham,2022-01-18
18,266,44,222,0,Chatham,2022-01-10
,0,0,0,0,Cherokee,2022-03-05
,0,0,0,0,Cherokee,2022-03-08
,0,0,0,0,Cherokee,2022-03-10
,0,0,0,0,Cherokee,2022-03-13
,0,0,0,0,Cherokee,2022-03-15
,0,0,0,0,Cherokee,2022-03-19
,0,0,0,0,Cherokee,2022-03-20
,0,0,0,0,Cherokee,2022-03-21
,0,0,0,0,Cherokee,2022-03-26
,0,0,0,0,Cherokee,2022-03-27
,0,0,0,0,Cherokee,2022-03-28
,0,0,0,0,Cherokee,2022-03-29
,0,0,0,0,Cherokee,2022-04-01
,0,0,0,0,Cherokee,2022-04-02
,0,0,0,0,Cherokee,2022-04-03
,0,0,0,0,Cherokee,2022-04-09
,0,0,0,0,Cherokee,2022-04-10
,0,0,0,0,Cherokee,2022-04-11
,0,0,0,0,Cherokee,2022-04-17
,0,0,0,0,Cherokee,2022-04-19
,0,0,0,0,Cherokee,2022-04-20
,0,0,0,0,Cherokee,2022-04-22
,0,0,0,0,Cherokee,2022-04-24
,0,0,0,0,Cherokee,2022-05-01
,0,0,0,0,Cherokee,2022-05-10
0,5,0,5,0,Cherokee,2021-12-14
0,3,0,3,0,Cherokee,2021-12-15
0,3,0,3,0,Cherokee,2021-12-17
0,2,0,2,0,Cherokee,2021-12-19
0,7,2,5,0,Cherokee,2021-12-20
0,11,1,10,0,Cherokee,2021-12-22
0,6,3,3,0,Cherokee,2021-12-23
0,3,0,3,0,Cherokee,2021-12-24
0,2,1,1,0,Cherokee,2021-12-25
0,10,2,8,0,Cherokee,2021-12-26
0,7,2,5,0,Cherokee,2022-01-01
0,10,0,10,0,Cherokee,2022-01-16
0,24,6,18,0,Cherokee,2022-01-22
0,23,6,17,0,Cherokee,2022-02-15
0,11,1,10,0,Cherokee,2022-02-22
0,3,1,2,0,Cherokee,2022-02-23
0,1,0,1,0,Cherokee,2022-02-26
0,1,0,1,0,Cherokee,2022-02-27
0,1,1,0,0,Cherokee,2022-03-02
0,4,1,3,0,Cherokee,2022-03-07
0,1,0,1,0,Cherokee,2022-03-11
0,1,0,1,0,Cherokee,2022-03-14
0,1,1,0,0,Cherokee,2022-03-17
0,1,1,0,0,Cherokee,2022-03-22
0,1,0,1,0,Cherokee,2022-03-23
0,1,0,1,0,Cherokee,2022-03-24
0,1,0,1,0,Cherokee,2022-03-25
0,1,0,1,0,Cherokee,2022-03-31
0,2,1,1,0,Cherokee,2022-04-04
0,1,1,0,0,Cherokee,2022-04-06
0,1,1,0,0,Cherokee,2022-04-07
0,1,0,1,0,Cherokee,2022-04-08
0,1,1,0,0,Cherokee,2022-04-12
0,1,0,1,0,Cherokee,2022-04-13
0,1,0,1,0,Cherokee,2022-04-14
0,3,0,3,0,Cherokee,2022-04-15
0,2,0,2,0,Cherokee,2022-04-16
0,1,0,1,0,Cherokee,2022-04-23
0,3,0,3,0,Cherokee,2022-04-25
0,2,0,2,0,Cherokee,2022-04-26
0,1,0,1,0,Cherokee,2022-04-27
0,2,2,0,0,Cherokee,2022-04-28
0,2,0,2,0,Cherokee,2022-04-29
0,2,0,2,0,Cherokee,2022-04-30
0,4,0,4,0,Cherokee,2022-05-02
0,2,1,1,0,Cherokee,2022-05-04
0,1,1,0,0,Cherokee,2022-05-05
0,3,0,3,0,Cherokee,2022-05-06
0,1,0,1,0,Cherokee,2022-05-07
0,1,0,1,0,Cherokee,2022-05-08
0,6,1,5,0,Cherokee,2022-05-09
0,4,2,2,0,Cherokee,2022-05-11
0,1,0,1,0,Cherokee,2022-05-12
0,3,1,2,0,Cherokee,2022-05-13
0,2,0,2,0,Cherokee,2022-05-14
0,1,0,1,0,Cherokee,2022-05-15
0,1,0,1,0,Cherokee,2022-05-16
0,1,0,1,0,Cherokee,2022-05-18
0,2,0,2,0,Cherokee,2022-05-20
0,4,2,2,0,Cherokee,2022-05-21
0,4,0,4,0,Cherokee,2022-05-23
0,3,0,3,0,Cherokee,2022-05-25
0,6,2,4,0,Cherokee,2022-05-26
0,3,0,3,0,Cherokee,2022-05-28
0,1,1,0,0,Cherokee,2022-05-29
0,3,0,3,0,Cherokee,2022-05-30
0,1,0,1,0,Cherokee,2022-06-04
0,5,1,4,0,Cherokee,2022-06-05
0,5,1,4,0,Cherokee,2022-06-07
0,3,0,3,0,Cherokee,2022-06-11
1,9,2,7,0,Cherokee,2021-12-16
1,3,0,3,0,Cherokee,2021-12-18
1,9,0,9,0,Cherokee,2021-12-21
1,23,8,15,0,Cherokee,2021-12-27
1,10,5,5,0,Cherokee,2021-12-31
1,15,2,13,0,Cherokee,2022-01-02
1,7,2,5,0,Cherokee,2022-01-29
1,12,1,11,0,Cherokee,2022-02-05
1,23,4,19,0,Cherokee,2022-02-09
1,15,6,9,0,Cherokee,2022-02-14
1,7,2,5,0,Cherokee,2022-02-18
1,6,0,6,0,Cherokee,2022-02-19
1,5,1,4,0,Cherokee,2022-02-21
1,9,2,7,0,Cherokee,2022-02-24
1,4,1,3,0,Cherokee,2022-03-03
1,4,1,3,0,Cherokee,2022-03-09
1,1,0,1,0,Cherokee,2022-04-21
1,3,0,3,0,Cherokee,2022-05-17
1,2,0,2,0,Cherokee,2022-05-19
1,5,0,5,0,Cherokee,2022-05-22
1,1,0,1,0,Cherokee,2022-05-24
1,8,2,6,0,Cherokee,2022-05-27
1,4,1,3,0,Cherokee,2022-05-31
1,7,3,4,0,Cherokee,2022-06-01
1,5,1,4,0,Cherokee,2022-06-03
1,6,1,5,0,Cherokee,2022-06-08
2,16,6,10,0,Cherokee,2022-01-30
2,31,7,24,0,Cherokee,2022-02-01
2,21,9,12,0,Cherokee,2022-02-10
2,11,5,6,0,Cherokee,2022-02-16
2,10,1,9,0,Cherokee,2022-02-28
2,5,3,2,0,Cherokee,2022-03-01
2,4,1,3,0,Cherokee,2022-04-18
2,8,3,5,0,Cherokee,2022-06-02
2,10,1,9,0,Cherokee,2022-06-06
2,9,3,6,0,Cherokee,2022-06-09
2,11,2,9,0,Cherokee,2022-06-10
3,28,9,19,0,Cherokee,2021-12-29
3,29,9,20,0,Cherokee,2022-01-08
3,19,1,18,0,Cherokee,2022-01-09
3,29,8,21,0,Cherokee,2022-01-28
3,36,11,25,0,Cherokee,2022-02-07
3,26,8,18,0,Cherokee,2022-02-08
3,8,1,7,0,Cherokee,2022-02-13
4,69,10,59,0,Cherokee,2022-01-03
4,104,25,79,0,Cherokee,2022-01-18
4,52,13,39,0,Cherokee,2022-01-27
5,84,16,68,0,Cherokee,2022-01-04
5,57,12,45,0,Cherokee,2022-01-25
5,27,5,22,0,Cherokee,2022-02-02
6,70,14,56,0,Cherokee,2022-01-12
6,87,24,63,0,Cherokee,2022-01-14
6,48,10,38,0,Cherokee,2022-01-26
7,55,17,38,0,Cherokee,2021-12-30
7,56,15,41,0,Cherokee,2022-01-06
7,91,27,64,0,Cherokee,2022-01-24
8,76,26,50,0,Cherokee,2022-01-11
13,109,36,73,0,Cherokee,2022-01-10
13,121,33,88,0,Cherokee,2022-01-19
,0,0,0,0,Chowan,2022-02-05
,0,0,0,0,Chowan,2022-02-19
,0,0,0,0,Chowan,2022-02-20
,0,0,0,0,Chowan,2022-02-26
,0,0,0,0,Chowan,2022-03-01
,0,0,0,0,Chowan,2022-03-04
,0,0,0,0,Chowan,2022-03-05
,0,0,0,0,Chowan,2022-03-07
,0,0,0,0,Chowan,2022-03-09
,0,0,0,0,Chowan,2022-03-12
,0,0,0,0,Chowan,2022-03-13
,0,0,0,0,Chowan,2022-03-14
,0,0,0,0,Chowan,2022-03-17
,0,0,0,0,Chowan,2022-03-19
,0,0,0,0,Chowan,2022-03-21
,0,0,0,0,Chowan,2022-03-22
,0,0,0,0,Chowan,2022-03-23
,0,0,0,0,Chowan,2022-03-24
,0,0,0,0,Chowan,2022-03-25
,0,0,0,0,Chowan,2022-03-26
,0,0,0,0,Chowan,2022-03-27
,0,0,0,0,Chowan,2022-03-29
,0,0,0,0,Chowan,2022-03-31
,0,0,0,0,Chowan,2022-04-02
,0,0,0,0,Chowan,2022-04-04
,0,0,0,0,Chowan,2022-04-06
,0,0,0,0,Chowan,2022-04-07
,0,0,0,0,Chowan,2022-04-08
,0,0,0,0,Chowan,2022-04-09
,0,0,0,0,Chowan,2022-04-10
,0,0,0,0,Chowan,2022-04-11
,0,0,0,0,Chowan,2022-04-13
,0,0,0,0,Chowan,2022-04-14
,0,0,0,0,Chowan,2022-04-17
,0,0,0,0,Chowan,2022-04-19
,0,0,0,0,Chowan,2022-04-20
,0,0,0,0,Chowan,2022-04-24
,0,0,0,0,Chowan,2022-04-27
,0,0,0,0,Chowan,2022-04-29
,0,0,0,0,Chowan,2022-05-01
,0,0,0,0,Chowan,2022-06-11
0,5,0,5,0,Chowan,2021-12-14
0,5,1,4,0,Chowan,2021-12-15
0,8,1,7,0,Chowan,2021-12-17
0,4,0,4,0,Chowan,2021-12-18
0,9,1,8,0,Chowan,2021-12-20
0,10,0,10,0,Chowan,2021-12-21
0,7,0,7,0,Chowan,2021-12-22
0,3,1,2,0,Chowan,2021-12-24
0,8,1,7,0,Chowan,2021-12-25
0,2,0,2,0,Chowan,2021-12-26
0,11,0,11,0,Chowan,2022-01-01
0,18,0,18,0,Chowan,2022-01-02
0,12,0,12,0,Chowan,2022-01-23
0,5,0,5,0,Chowan,2022-01-30
0,7,0,7,0,Chowan,2022-02-04
0,4,0,4,0,Chowan,2022-02-08
0,2,0,2,0,Chowan,2022-02-12
0,2,1,1,0,Chowan,2022-02-13
0,3,0,3,0,Chowan,2022-02-14
0,6,0,6,0,Chowan,2022-02-16
0,8,2,6,0,Chowan,2022-02-17
0,7,0,7,0,Chowan,2022-02-18
0,1,0,1,0,Chowan,2022-02-22
0,1,0,1,0,Chowan,2022-02-25
0,1,0,1,0,Chowan,2022-02-27
0,4,0,4,0,Chowan,2022-02-28
0,1,0,1,0,Chowan,2022-03-06
0,2,0,2,0,Chowan,2022-03-08
0,1,0,1,0,Chowan,2022-03-15
0,1,0,1,0,Chowan,2022-03-16
0,1,0,1,0,Chowan,2022-03-18
0,3,3,0,0,Chowan,2022-03-20
0,1,0,1,0,Chowan,2022-03-28
0,1,0,1,0,Chowan,2022-03-30
0,1,0,1,0,Chowan,2022-04-01
0,1,0,1,0,Chowan,2022-04-03
0,1,0,1,0,Chowan,2022-04-05
0,2,0,2,0,Chowan,2022-04-12
0,2,0,2,0,Chowan,2022-04-15
0,1,0,1,0,Chowan,2022-04-16
0,1,0,1,0,Chowan,2022-04-21
0,1,0,1,0,Chowan,2022-04-23
0,3,0,3,0,Chowan,2022-04-25
0,1,0,1,0,Chowan,2022-04-26
0,1,0,1,0,Chowan,2022-04-30
0,1,0,1,0,Chowan,2022-05-02
0,1,0,1,0,Chowan,2022-05-04
0,1,0,1,0,Chowan,2022-05-06
0,1,0,1,0,Chowan,2022-05-07
0,1,0,1,0,Chowan,2022-05-08
0,11,0,11,0,Chowan,2022-05-13
0,2,0,2,0,Chowan,2022-05-14
0,9,0,9,0,Chowan,2022-05-16
0,4,0,4,0,Chowan,2022-05-19
0,4,0,4,0,Chowan,2022-05-20
0,1,0,1,0,Chowan,2022-05-22
0,6,1,5,0,Chowan,2022-05-23
0,5,0,5,0,Chowan,2022-05-25
0,2,0,2,0,Chowan,2022-06-03
0,1,0,1,0,Chowan,2022-06-04
0,2,0,2,0,Chowan,2022-06-05
0,3,1,2,0,Chowan,2022-06-09
0,6,0,6,0,Chowan,2022-06-10
1,11,0,11,0,Chowan,2021-12-23
1,9,0,9,0,Chowan,2022-01-09
1,26,3,23,0,Chowan,2022-01-31
1,9,0,9,0,Chowan,2022-02-03
1,2,0,2,0,Chowan,2022-02-10
1,7,2,5,0,Chowan,2022-02-21
1,1,0,1,0,Chowan,2022-02-23
1,1,0,1,0,Chowan,2022-03-02
1,1,0,1,0,Chowan,2022-03-11
1,2,1,1,0,Chowan,2022-04-22
1,1,0,1,0,Chowan,2022-04-28
1,4,0,4,0,Chowan,2022-05-03
1,3,0,3,0,Chowan,2022-05-05
1,5,1,4,0,Chowan,2022-05-10
1,4,0,4,0,Chowan,2022-05-11
1,6,0,6,0,Chowan,2022-05-17
1,1,0,1,0,Chowan,2022-05-21
1,6,1,5,0,Chowan,2022-05-24
1,8,0,8,0,Chowan,2022-05-27
1,2,1,1,0,Chowan,2022-05-28
1,1,0,1,0,Chowan,2022-05-30
1,5,0,5,0,Chowan,2022-06-01
1,3,0,3,0,Chowan,2022-06-02
1,4,0,4,0,Chowan,2022-06-06
1,2,0,2,0,Chowan,2022-06-07
1,5,0,5,0,Chowan,2022-06-08
2,11,5,6,0,Chowan,2022-01-21
2,8,4,4,0,Chowan,2022-01-22
2,6,0,6,0,Chowan,2022-02-09
2,4,0,4,0,Chowan,2022-02-11
2,2,0,2,0,Chowan,2022-04-18
2,5,0,5,0,Chowan,2022-05-09
2,7,0,7,0,Chowan,2022-05-12
2,7,2,5,0,Chowan,2022-05-15
2,11,0,11,0,Chowan,2022-05-26
2,7,0,7,0,Chowan,2022-05-29
3,44,0,44,0,Chowan,2021-12-31
3,61,0,61,0,Chowan,2022-01-04
3,53,4,49,0,Chowan,2022-01-06
3,30,1,29,0,Chowan,2022-01-15
3,32,1,31,0,Chowan,2022-01-26
3,10,0,10,0,Chowan,2022-05-18
4,43,1,42,0,Chowan,2021-12-27
4,35,0,35,0,Chowan,2021-12-30
4,12,4,8,0,Chowan,2022-01-16
4,8,0,8,0,Chowan,2022-05-31
5,39,4,35,0,Chowan,2022-01-19
6,86,2,84,0,Chowan,2022-01-03
6,59,1,58,0,Chowan,2022-01-11
6,31,6,25,0,Chowan,2022-01-17
6,19,0,19,0,Chowan,2022-02-01
7,61,0,61,0,Chowan,2021-12-29
7,48,1,47,0,Chowan,2022-01-13
10,39,2,37,0,Chowan,2022-01-07
10,86,4,82,0,Chowan,2022-01-12
11,73,4,69,0,Chowan,2022-01-24
16,117,4,113,0,Chowan,2022-01-18
,0,0,0,0,Clay,2021-12-14
,0,0,0,0,Clay,2021-12-20
,0,0,0,0,Clay,2021-12-21
,0,0,0,0,Clay,2021-12-25
,0,0,0,0,Clay,2022-02-15
,0,0,0,0,Clay,2022-02-19
,0,0,0,0,Clay,2022-02-23
,0,0,0,0,Clay,2022-02-24
,0,0,0,0,Clay,2022-02-25
,0,0,0,0,Clay,2022-02-26
,0,0,0,0,Clay,2022-02-27
,0,0,0,0,Clay,2022-03-05
,0,0,0,0,Clay,2022-03-06
,0,0,0,0,Clay,2022-03-09
,0,0,0,0,Clay,2022-03-12
,0,0,0,0,Clay,2022-03-13
,0,0,0,0,Clay,2022-03-16
,0,0,0,0,Clay,2022-03-17
,0,0,0,0,Clay,2022-03-19
,0,0,0,0,Clay,2022-03-21
,0,0,0,0,Clay,2022-03-22
,0,0,0,0,Clay,2022-03-23
,0,0,0,0,Clay,2022-03-24
,0,0,0,0,Clay,2022-03-25
,0,0,0,0,Clay,2022-03-26
,0,0,0,0,Clay,2022-03-27
,0,0,0,0,Clay,2022-03-28
,0,0,0,0,Clay,2022-03-29
,0,0,0,0,Clay,2022-03-30
,0,0,0,0,Clay,2022-03-31
,0,0,0,0,Clay,2022-04-03
,0,0,0,0,Clay,2022-04-04
,0,0,0,0,Clay,2022-04-05
,0,0,0,0,Clay,2022-04-06
,0,0,0,0,Clay,2022-04-07
,0,0,0,0,Clay,2022-04-08
,0,0,0,0,Clay,2022-04-09
,0,0,0,0,Clay,2022-04-10
,0,0,0,0,Clay,2022-04-11
,0,0,0,0,Clay,2022-04-12
,0,0,0,0,Clay,2022-04-13
,0,0,0,0,Clay,2022-04-14
,0,0,0,0,Clay,2022-04-15
,0,0,0,0,Clay,2022-04-16
,0,0,0,0,Clay,2022-04-17
,0,0,0,0,Clay,2022-04-19
,0,0,0,0,Clay,2022-04-20
,0,0,0,0,Clay,2022-04-21
,0,0,0,0,Clay,2022-04-24
,0,0,0,0,Clay,2022-04-25
,0,0,0,0,Clay,2022-04-27
,0,0,0,0,Clay,2022-04-30
,0,0,0,0,Clay,2022-05-03
,0,0,0,0,Clay,2022-05-05
,0,0,0,0,Clay,2022-05-06
,0,0,0,0,Clay,2022-05-20
,0,0,0,0,Clay,2022-05-22
,0,0,0,0,Clay,2022-05-30
,0,0,0,0,Clay,2022-06-02
,0,0,0,0,Clay,2022-06-04
0,3,0,3,0,Clay,2021-12-15
0,5,0,5,0,Clay,2021-12-17
0,1,0,1,0,Clay,2021-12-18
0,3,1,2,0,Clay,2021-12-22
0,5,2,3,0,Clay,2021-12-23
0,3,0,3,0,Clay,2021-12-24
0,4,0,4,0,Clay,2021-12-26
0,9,0,9,0,Clay,2021-12-27
0,10,1,9,0,Clay,2021-12-28
0,13,3,10,0,Clay,2021-12-29
0,9,3,6,0,Clay,2021-12-31
0,1,0,1,0,Clay,2022-01-01
0,7,1,6,0,Clay,2022-01-02
0,9,2,7,0,Clay,2022-01-08
0,20,4,16,0,Clay,2022-01-21
0,11,0,11,0,Clay,2022-01-22
0,18,9,9,0,Clay,2022-01-28
0,3,0,3,0,Clay,2022-01-29
0,11,1,10,0,Clay,2022-01-30
0,10,4,6,0,Clay,2022-02-01
0,9,3,6,0,Clay,2022-02-04
0,12,3,9,0,Clay,2022-02-07
0,4,1,3,0,Clay,2022-02-08
0,11,1,10,0,Clay,2022-02-09
0,7,3,4,0,Clay,2022-02-10
0,2,1,1,0,Clay,2022-02-11
0,1,0,1,0,Clay,2022-02-12
0,2,1,1,0,Clay,2022-02-13
0,5,2,3,0,Clay,2022-02-14
0,5,0,5,0,Clay,2022-02-16
0,6,2,4,0,Clay,2022-02-17
0,1,0,1,0,Clay,2022-02-20
0,2,0,2,0,Clay,2022-02-22
0,2,1,1,0,Clay,2022-02-28
0,1,0,1,0,Clay,2022-03-01
0,1,0,1,0,Clay,2022-03-03
0,1,0,1,0,Clay,2022-03-04
0,1,0,1,0,Clay,2022-03-08
0,1,0,1,0,Clay,2022-03-11
0,1,0,1,0,Clay,2022-03-15
0,1,0,1,0,Clay,2022-03-20
0,1,0,1,0,Clay,2022-04-01
0,1,0,1,0,Clay,2022-04-22
0,1,0,1,0,Clay,2022-04-23
0,2,0,2,0,Clay,2022-04-26
0,1,1,0,0,Clay,2022-04-28
0,1,0,1,0,Clay,2022-04-29
0,1,0,1,0,Clay,2022-05-01
0,2,0,2,0,Clay,2022-05-02
0,1,0,1,0,Clay,2022-05-07
0,1,0,1,0,Clay,2022-05-09
0,3,1,2,0,Clay,2022-05-10
0,1,0,1,0,Clay,2022-05-11
0,1,0,1,0,Clay,2022-05-12
0,1,0,1,0,Clay,2022-05-13
0,1,1,0,0,Clay,2022-05-14
0,1,0,1,0,Clay,2022-05-15
0,2,0,2,0,Clay,2022-05-16
0,3,2,1,0,Clay,2022-05-19
0,1,0,1,0,Clay,2022-05-21
0,2,1,1,0,Clay,2022-05-23
0,3,0,3,0,Clay,2022-05-24
0,3,2,1,0,Clay,2022-05-25
0,1,0,1,0,Clay,2022-05-26
0,3,2,1,0,Clay,2022-05-31
0,1,0,1,0,Clay,2022-06-01
0,2,2,0,0,Clay,2022-06-03
0,7,2,5,0,Clay,2022-06-06
0,3,1,2,0,Clay,2022-06-07
0,4,2,2,0,Clay,2022-06-08
0,4,0,4,0,Clay,2022-06-11
1,34,8,26,0,Clay,2022-01-04
1,19,1,18,0,Clay,2022-01-11
1,32,10,22,0,Clay,2022-01-12
1,11,8,3,0,Clay,2022-01-16
1,22,16,6,0,Clay,2022-01-17
1,16,3,13,0,Clay,2022-01-25
1,29,10,19,0,Clay,2022-01-27
1,19,5,14,0,Clay,2022-01-31
1,8,0,8,0,Clay,2022-02-18
1,1,0,1,0,Clay,2022-03-10
1,1,0,1,0,Clay,2022-03-18
1,4,0,4,0,Clay,2022-04-18
1,2,0,2,0,Clay,2022-05-08
1,5,1,4,0,Clay,2022-05-27
1,1,0,1,0,Clay,2022-05-29
1,6,1,5,0,Clay,2022-06-09
1,5,3,2,0,Clay,2022-06-10
2,29,6,23,0,Clay,2022-01-06
2,13,0,13,0,Clay,2022-01-15
2,35,4,31,0,Clay,2022-01-18
2,31,6,25,0,Clay,2022-01-19
2,19,4,15,0,Clay,2022-01-26
2,8,2,6,0,Clay,2022-02-06
2,6,1,5,0,Clay,2022-05-18
2,5,0,5,0,Clay,2022-05-28
3,14,2,12,0,Clay,2021-12-30
3,31,11,20,0,Clay,2022-01-24
4,30,6,24,0,Clay,2022-01-03
4,29,10,19,0,Clay,2022-01-14
4,27,3,24,0,Clay,2022-01-20
7,43,11,32,0,Clay,2022-01-10
,0,0,0,0,Cleveland,2022-03-09
,0,0,0,0,Cleveland,2022-03-19
,0,0,0,0,Cleveland,2022-03-20
,0,0,0,0,Cleveland,2022-03-27
,0,0,0,0,Cleveland,2022-03-29
,0,0,0,0,Cleveland,2022-03-30
,0,0,0,0,Cleveland,2022-04-09
0,22,5,17,0,Cleveland,2021-12-17
0,12,2,10,0,Cleveland,2022-02-28
0,8,1,7,0,Cleveland,2022-03-03
0,8,1,7,0,Cleveland,2022-03-04
0,3,1,2,0,Cleveland,2022-03-05
0,6,1,5,0,Cleveland,2022-03-10
0,1,1,0,0,Cleveland,2022-03-11
0,2,0,2,0,Cleveland,2022-03-13
0,1,0,1,0,Cleveland,2022-03-14
0,2,0,2,0,Cleveland,2022-03-21
0,2,0,2,0,Cleveland,2022-03-22
0,1,0,1,0,Cleveland,2022-03-24
0,1,0,1,0,Cleveland,2022-03-25
0,1,0,1,0,Cleveland,2022-03-28
0,1,0,1,0,Cleveland,2022-04-01
0,2,0,2,0,Cleveland,2022-04-02
0,1,0,1,0,Cleveland,2022-04-03
0,2,1,1,0,Cleveland,2022-04-04
0,3,0,3,0,Cleveland,2022-04-07
0,4,0,4,0,Cleveland,2022-04-08
0,3,0,3,0,Cleveland,2022-04-10
0,5,1,4,0,Cleveland,2022-04-11
0,2,1,1,0,Cleveland,2022-04-12
0,1,0,1,0,Cleveland,2022-04-14
0,2,0,2,0,Cleveland,2022-04-15
0,4,1,3,0,Cleveland,2022-04-16
0,1,0,1,0,Cleveland,2022-04-17
0,3,1,2,0,Cleveland,2022-04-18
0,5,1,4,0,Cleveland,2022-04-22
0,7,0,7,0,Cleveland,2022-04-23
0,4,1,3,0,Cleveland,2022-04-27
0,4,2,2,0,Cleveland,2022-04-29
0,7,1,6,0,Cleveland,2022-04-30
0,7,4,3,0,Cleveland,2022-05-02
0,10,2,8,0,Cleveland,2022-05-07
0,11,0,11,0,Cleveland,2022-05-14
0,20,1,19,0,Cleveland,2022-05-19
0,12,2,10,0,Cleveland,2022-05-22
0,9,3,6,0,Cleveland,2022-05-30
1,42,6,36,0,Cleveland,2021-12-15
1,23,4,19,0,Cleveland,2021-12-18
1,64,8,56,0,Cleveland,2021-12-21
1,43,10,33,0,Cleveland,2022-02-15
1,5,0,5,0,Cleveland,2022-03-16
1,3,0,3,0,Cleveland,2022-03-31
1,3,0,3,0,Cleveland,2022-04-06
1,10,2,8,0,Cleveland,2022-04-20
1,10,3,7,0,Cleveland,2022-04-21
1,7,1,6,0,Cleveland,2022-04-24
1,20,3,17,0,Cleveland,2022-04-26
1,6,0,6,0,Cleveland,2022-05-01
1,10,1,9,0,Cleveland,2022-05-04
1,15,2,13,0,Cleveland,2022-05-13
1,19,2,17,0,Cleveland,2022-05-18
1,23,3,20,0,Cleveland,2022-05-25
1,18,4,14,0,Cleveland,2022-05-27
1,18,1,17,0,Cleveland,2022-06-04
2,16,4,12,0,Cleveland,2022-02-24
2,10,0,10,0,Cleveland,2022-03-01
2,5,0,5,0,Cleveland,2022-04-13
2,3,1,2,0,Cleveland,2022-04-19
2,6,1,5,0,Cleveland,2022-04-28
2,10,1,9,0,Cleveland,2022-05-06
2,15,2,13,0,Cleveland,2022-05-08
2,16,3,13,0,Cleveland,2022-05-09
2,10,4,6,0,Cleveland,2022-05-28
2,16,2,14,0,Cleveland,2022-05-29
2,22,2,20,0,Cleveland,2022-06-05
2,25,7,18,0,Cleveland,2022-06-07
3,32,3,29,0,Cleveland,2021-12-24
3,63,22,41,0,Cleveland,2022-01-30
3,6,2,4,0,Cleveland,2022-03-08
3,26,2,24,0,Cleveland,2022-05-12
3,18,1,17,0,Cleveland,2022-05-15
3,9,3,6,0,Cleveland,2022-05-21
3,30,8,22,0,Cleveland,2022-05-23
3,18,1,17,0,Cleveland,2022-06-02
3,26,3,23,0,Cleveland,2022-06-08
4,51,6,45,0,Cleveland,2021-12-23
4,16,1,15,0,Cleveland,2022-02-25
4,17,2,15,0,Cleveland,2022-05-05
4,24,3,21,0,Cleveland,2022-05-10
4,15,2,13,0,Cleveland,2022-05-11
4,29,5,24,0,Cleveland,2022-05-17
4,26,10,16,0,Cleveland,2022-05-20
4,26,12,14,0,Cleveland,2022-06-03
4,40,11,29,0,Cleveland,2022-06-06
4,18,0,18,0,Cleveland,2022-06-11
5,23,4,19,0,Cleveland,2022-02-21
5,28,5,23,0,Cleveland,2022-05-16
5,21,7,14,0,Cleveland,2022-05-26
6,62,13,49,0,Cleveland,2022-01-29
6,34,14,20,0,Cleveland,2022-05-31
6,20,3,17,0,Cleveland,2022-06-09
7,59,5,54,0,Cleveland,2021-12-22
7,125,50,75,0,Cleveland,2022-01-02
9,27,4,23,0,Cleveland,2022-06-01
10,105,33,72,0,Cleveland,2022-01-23
12,154,42,112,0,Cleveland,2022-01-08
12,46,7,39,0,Cleveland,2022-02-16
13,169,21,148,0,Cleveland,2022-01-27
14,127,15,112,0,Cleveland,2021-12-27
14,154,41,113,0,Cleveland,2021-12-31
14,96,22,74,0,Cleveland,2022-01-01
14,126,46,80,0,Cleveland,2022-01-09
16,219,56,163,0,Cleveland,2021-12-29
18,153,18,135,0,Cleveland,2022-01-28
19,165,28,137,0,Cleveland,2021-12-28
19,106,16,90,0,Cleveland,2022-01-17
20,241,50,191,0,Cleveland,2021-12-30
22,201,18,183,0,Cleveland,2022-01-26
32,275,50,225,0,Cleveland,2022-01-21
39,302,81,221,0,Cleveland,2022-01-03
48,358,73,285,0,Cleveland,2022-01-12
51,415,85,330,0,Cleveland,2022-01-10
,0,0,0,0,Columbus,2022-03-05
,0,0,0,0,Columbus,2022-03-15
,0,0,0,0,Columbus,2022-03-19
,0,0,0,0,Columbus,2022-03-20
,0,0,0,0,Columbus,2022-03-21
,0,0,0,0,Columbus,2022-03-22
,0,0,0,0,Columbus,2022-03-24
,0,0,0,0,Columbus,2022-03-25
,0,0,0,0,Columbus,2022-03-29
,0,0,0,0,Columbus,2022-03-30
,0,0,0,0,Columbus,2022-04-01
,0,0,0,0,Columbus,2022-04-03
,0,0,0,0,Columbus,2022-04-06
,0,0,0,0,Columbus,2022-04-09
,0,0,0,0,Columbus,2022-04-10
,0,0,0,0,Columbus,2022-04-13
,0,0,0,0,Columbus,2022-04-15
,0,0,0,0,Columbus,2022-04-16
,0,0,0,0,Columbus,2022-04-17
,0,0,0,0,Columbus,2022-05-05
0,14,4,10,0,Columbus,2021-12-17
0,2,0,2,0,Columbus,2021-12-18
0,4,0,4,0,Columbus,2021-12-19
0,7,2,5,0,Columbus,2021-12-25
0,25,9,16,0,Columbus,2022-01-21
0,7,2,5,0,Columbus,2022-02-12
0,5,2,3,0,Columbus,2022-02-25
0,4,0,4,0,Columbus,2022-02-26
0,2,1,1,0,Columbus,2022-02-27
0,6,0,6,0,Columbus,2022-03-01
0,2,1,1,0,Columbus,2022-03-03
0,1,0,1,0,Columbus,2022-03-04
0,1,0,1,0,Columbus,2022-03-07
0,2,0,2,0,Columbus,2022-03-09
0,2,1,1,0,Columbus,2022-03-10
0,1,0,1,0,Columbus,2022-03-13
0,1,0,1,0,Columbus,2022-03-16
0,3,0,3,0,Columbus,2022-03-17
0,2,0,2,0,Columbus,2022-03-18
0,1,0,1,0,Columbus,2022-03-23
0,1,0,1,0,Columbus,2022-03-26
0,1,0,1,0,Columbus,2022-03-27
0,3,0,3,0,Columbus,2022-03-28
0,2,0,2,0,Columbus,2022-04-05
0,1,0,1,0,Columbus,2022-04-07
0,1,0,1,0,Columbus,2022-04-08
0,3,2,1,0,Columbus,2022-04-11
0,1,0,1,0,Columbus,2022-04-14
0,1,0,1,0,Columbus,2022-04-19
0,1,0,1,0,Columbus,2022-04-21
0,2,1,1,0,Columbus,2022-04-23
0,3,2,1,0,Columbus,2022-04-24
0,4,2,2,0,Columbus,2022-04-27
0,7,0,7,0,Columbus,2022-04-28
0,2,1,1,0,Columbus,2022-04-29
0,2,0,2,0,Columbus,2022-04-30
0,5,3,2,0,Columbus,2022-05-03
0,2,0,2,0,Columbus,2022-05-07
0,6,3,3,0,Columbus,2022-05-09
0,3,0,3,0,Columbus,2022-05-15
0,8,0,8,0,Columbus,2022-05-20
0,4,0,4,0,Columbus,2022-05-21
0,6,1,5,0,Columbus,2022-05-24
0,3,1,2,0,Columbus,2022-05-28
0,6,1,5,0,Columbus,2022-05-29
0,3,1,2,0,Columbus,2022-06-03
0,1,0,1,0,Columbus,2022-06-04
0,3,0,3,0,Columbus,2022-06-05
0,6,3,3,0,Columbus,2022-06-08
0,4,2,2,0,Columbus,2022-06-11
1,9,6,3,0,Columbus,2021-12-15
1,21,10,11,0,Columbus,2021-12-16
1,13,2,11,0,Columbus,2021-12-24
1,15,5,10,0,Columbus,2022-01-01
1,21,6,15,0,Columbus,2022-01-30
1,11,1,10,0,Columbus,2022-02-13
1,11,3,8,0,Columbus,2022-02-18
1,3,1,2,0,Columbus,2022-02-20
1,7,2,5,0,Columbus,2022-02-22
1,11,6,5,0,Columbus,2022-02-23
1,7,4,3,0,Columbus,2022-02-24
1,4,1,3,0,Columbus,2022-03-02
1,6,1,5,0,Columbus,2022-03-08
1,2,0,2,0,Columbus,2022-03-11
1,2,2,0,0,Columbus,2022-03-14
1,1,1,0,0,Columbus,2022-04-12
1,4,0,4,0,Columbus,2022-04-18
1,2,0,2,0,Columbus,2022-04-22
1,2,1,1,0,Columbus,2022-05-01
1,4,1,3,0,Columbus,2022-05-04
1,6,2,4,0,Columbus,2022-05-06
1,7,1,6,0,Columbus,2022-05-11
1,2,1,1,0,Columbus,2022-05-14
1,4,1,3,0,Columbus,2022-05-22
1,7,1,6,0,Columbus,2022-05-27
1,5,2,3,0,Columbus,2022-05-30
1,14,11,3,0,Columbus,2022-06-01
1,11,3,8,0,Columbus,2022-06-07
2,25,9,16,0,Columbus,2021-12-20
2,20,2,18,0,Columbus,2021-12-22
2,29,8,21,0,Columbus,2022-01-02
2,40,16,24,0,Columbus,2022-01-08
2,54,9,45,0,Columbus,2022-01-15
2,39,13,26,0,Columbus,2022-01-16
2,15,9,6,0,Columbus,2022-01-29
2,18,11,7,0,Columbus,2022-02-21
2,12,8,4,0,Columbus,2022-02-28
2,6,2,4,0,Columbus,2022-04-25
2,9,3,6,0,Columbus,2022-05-10
2,8,4,4,0,Columbus,2022-05-12
2,23,8,15,0,Columbus,2022-05-16
2,19,6,13,0,Columbus,2022-05-18
2,7,2,5,0,Columbus,2022-05-26
2,6,2,4,0,Columbus,2022-06-06
2,11,4,7,0,Columbus,2022-06-09
2,6,2,4,0,Columbus,2022-06-10
3,26,4,22,0,Columbus,2021-12-23
3,23,13,10,0,Columbus,2022-02-16
3,9,4,5,0,Columbus,2022-04-26
3,11,4,7,0,Columbus,2022-05-13
3,12,3,9,0,Columbus,2022-05-19
4,68,30,38,0,Columbus,2022-02-01
4,16,5,11,0,Columbus,2022-02-05
4,20,9,11,0,Columbus,2022-05-23
4,12,7,5,0,Columbus,2022-05-25
5,25,13,12,0,Columbus,2022-02-09
6,85,11,74,0,Columbus,2021-12-30
6,50,9,41,0,Columbus,2021-12-31
6,56,21,35,0,Columbus,2022-02-07
7,77,4,73,0,Columbus,2021-12-28
8,43,23,20,0,Columbus,2022-02-08
10,96,14,82,0,Columbus,2021-12-29
10,120,26,94,0,Columbus,2022-01-03
12,189,59,130,0,Columbus,2022-01-17
17,161,85,76,0,Columbus,2022-01-05
21,156,78,78,0,Columbus,2022-01-04
26,288,115,173,0,Columbus,2022-01-19
27,259,68,191,0,Columbus,2022-01-11
27,273,117,156,0,Columbus,2022-01-13
0,41,16,25,0,Craven,2021-12-20
0,39,13,26,0,Craven,2021-12-23
0,17,7,10,0,Craven,2021-12-24
0,9,1,8,0,Craven,2021-12-25
0,9,0,9,0,Craven,2022-02-20
0,24,6,18,0,Craven,2022-02-23
0,8,2,6,0,Craven,2022-02-26
0,4,2,2,0,Craven,2022-02-27
0,20,1,19,0,Craven,2022-02-28
0,9,3,6,0,Craven,2022-03-04
0,7,2,5,0,Craven,2022-03-08
0,12,4,8,0,Craven,2022-03-11
0,7,1,6,0,Craven,2022-03-13
0,8,2,6,0,Craven,2022-03-15
0,6,2,4,0,Craven,2022-03-16
0,5,3,2,0,Craven,2022-03-18
0,1,0,1,0,Craven,2022-03-19
0,6,1,5,0,Craven,2022-03-22
0,2,0,2,0,Craven,2022-03-23
0,3,1,2,0,Craven,2022-03-24
0,3,1,2,0,Craven,2022-03-26
0,1,0,1,0,Craven,2022-03-27
0,5,4,1,0,Craven,2022-03-28
0,3,2,1,0,Craven,2022-03-30
0,6,0,6,0,Craven,2022-03-31
0,4,0,4,0,Craven,2022-04-01
0,3,0,3,0,Craven,2022-04-02
0,1,1,0,0,Craven,2022-04-03
0,8,5,3,0,Craven,2022-04-04
0,5,4,1,0,Craven,2022-04-05
0,6,2,4,0,Craven,2022-04-07
0,6,5,1,0,Craven,2022-04-08
0,2,0,2,0,Craven,2022-04-09
0,2,0,2,0,Craven,2022-04-10
0,6,3,3,0,Craven,2022-04-15
0,19,14,5,0,Craven,2022-04-18
0,9,5,4,0,Craven,2022-04-22
0,3,2,1,0,Craven,2022-04-24
0,10,3,7,0,Craven,2022-04-27
0,21,5,16,0,Craven,2022-04-28
0,19,9,10,0,Craven,2022-04-29
0,14,6,8,0,Craven,2022-05-01
0,17,10,7,0,Craven,2022-05-14
1,21,9,12,0,Craven,2021-12-14
1,28,10,18,0,Craven,2021-12-16
1,14,5,9,0,Craven,2021-12-18
1,37,8,29,0,Craven,2022-02-21
1,20,3,17,0,Craven,2022-02-25
1,12,2,10,0,Craven,2022-03-01
1,4,2,2,0,Craven,2022-03-05
1,8,3,5,0,Craven,2022-03-06
1,6,3,3,0,Craven,2022-03-10
1,3,2,1,0,Craven,2022-03-25
1,3,2,1,0,Craven,2022-03-29
1,10,2,8,0,Craven,2022-04-06
1,7,2,5,0,Craven,2022-04-11
1,10,4,6,0,Craven,2022-04-14
1,5,0,5,0,Craven,2022-04-16
1,7,1,6,0,Craven,2022-04-17
1,18,5,13,0,Craven,2022-04-19
1,18,4,14,0,Craven,2022-04-25
1,19,5,14,0,Craven,2022-04-26
1,8,6,2,0,Craven,2022-04-30
1,34,19,15,0,Craven,2022-05-05
1,20,12,8,0,Craven,2022-05-07
1,42,27,15,0,Craven,2022-05-13
1,44,17,27,0,Craven,2022-05-20
1,19,11,8,0,Craven,2022-06-04
1,19,6,13,0,Craven,2022-06-11
2,37,8,29,0,Craven,2021-12-26
2,72,17,55,0,Craven,2022-01-02
2,77,24,53,0,Craven,2022-01-08
2,18,2,16,0,Craven,2022-02-24
2,8,2,6,0,Craven,2022-03-03
2,18,10,8,0,Craven,2022-03-07
2,9,4,5,0,Craven,2022-03-17
2,11,3,8,0,Craven,2022-04-20
2,10,6,4,0,Craven,2022-04-21
2,41,17,24,0,Craven,2022-05-03
2,25,9,16,0,Craven,2022-05-04
2,31,18,13,0,Craven,2022-05-06
2,21,8,13,0,Craven,2022-05-08
2,40,15,25,0,Craven,2022-05-12
2,44,20,24,0,Craven,2022-05-19
2,43,19,24,0,Craven,2022-05-27
2,21,9,12,0,Craven,2022-05-29
3,32,8,24,0,Craven,2021-12-15
3,47,18,29,0,Craven,2021-12-21
3,134,33,101,0,Craven,2021-12-29
3,46,12,34,0,Craven,2022-02-05
3,59,18,41,0,Craven,2022-02-11
3,35,12,23,0,Craven,2022-02-15
3,54,15,39,0,Craven,2022-02-16
3,26,9,17,0,Craven,2022-02-22
3,25,20,5,0,Craven,2022-04-13
3,41,20,21,0,Craven,2022-05-02
3,50,22,28,0,Craven,2022-05-11
3,38,13,25,0,Craven,2022-05-22
3,24,11,13,0,Craven,2022-05-30
4,58,13,45,0,Craven,2021-12-22
4,99,27,72,0,Craven,2021-12-27
4,86,26,60,0,Craven,2022-01-09
4,87,29,58,0,Craven,2022-02-08
4,84,21,63,0,Craven,2022-02-09
4,52,27,25,0,Craven,2022-05-10
4,18,7,11,0,Craven,2022-05-15
4,31,13,18,0,Craven,2022-05-21
4,67,37,30,0,Craven,2022-05-26
4,32,7,25,0,Craven,2022-06-05
4,60,34,26,0,Craven,2022-06-08
5,131,45,86,0,Craven,2021-12-28
5,57,34,23,0,Craven,2022-05-24
5,54,28,26,0,Craven,2022-05-25
5,62,27,35,0,Craven,2022-06-01
5,52,22,30,0,Craven,2022-06-07
6,115,20,95,0,Craven,2021-12-30
6,67,28,39,0,Craven,2022-05-31
6,39,21,18,0,Craven,2022-06-03
6,71,33,38,0,Craven,2022-06-06
6,52,22,30,0,Craven,2022-06-09
7,74,22,52,0,Craven,2021-12-31
7,62,24,38,0,Craven,2022-05-16
7,31,15,16,0,Craven,2022-05-28
7,67,23,44,0,Craven,2022-06-02
8,213,54,159,0,Craven,2022-01-31
9,59,33,26,0,Craven,2022-05-09
9,44,14,30,0,Craven,2022-05-18
9,82,39,43,0,Craven,2022-05-23
10,109,32,77,0,Craven,2022-01-21
10,80,37,43,0,Craven,2022-02-10
15,216,67,149,0,Craven,2022-01-06
15,279,87,192,0,Craven,2022-01-20
17,268,97,171,0,Craven,2022-01-25
19,317,105,212,0,Craven,2022-01-12
20,280,62,218,0,Craven,2022-01-14
21,253,55,198,0,Craven,2022-01-03
25,412,130,282,0,Craven,2022-01-10
26,426,121,305,0,Craven,2022-01-19
28,304,104,200,0,Craven,2022-01-11
31,282,94,188,0,Craven,2022-01-13
0,7,1,6,0,Cumberland,2022-03-06
0,7,2,5,0,Cumberland,2022-03-13
0,11,5,6,0,Cumberland,2022-03-18
0,4,1,3,0,Cumberland,2022-03-20
0,12,1,11,0,Cumberland,2022-03-24
0,9,6,3,0,Cumberland,2022-03-27
0,10,3,7,0,Cumberland,2022-04-01
0,5,1,4,0,Cumberland,2022-04-02
0,3,0,3,0,Cumberland,2022-04-03
0,8,4,4,0,Cumberland,2022-04-17
1,41,1,40,0,Cumberland,2022-03-11
1,11,2,9,0,Cumberland,2022-03-12
1,14,2,12,0,Cumberland,2022-03-17
1,22,2,20,0,Cumberland,2022-03-22
1,14,2,12,0,Cumberland,2022-03-23
1,17,2,15,0,Cumberland,2022-03-25
1,7,2,5,0,Cumberland,2022-03-26
1,15,6,9,0,Cumberland,2022-03-29
1,10,2,8,0,Cumberland,2022-03-30
1,19,5,14,0,Cumberland,2022-04-04
1,25,6,19,0,Cumberland,2022-04-08
1,9,4,5,0,Cumberland,2022-04-09
1,11,3,8,0,Cumberland,2022-04-10
1,60,15,45,0,Cumberland,2022-05-06
1,26,10,16,0,Cumberland,2022-05-07
2,79,13,66,0,Cumberland,2021-12-18
2,30,4,26,0,Cumberland,2022-03-07
2,22,3,19,0,Cumberland,2022-03-09
2,24,5,19,0,Cumberland,2022-03-10
2,22,1,21,0,Cumberland,2022-04-06
2,22,6,16,0,Cumberland,2022-04-16
2,43,6,37,0,Cumberland,2022-04-22
3,168,30,138,0,Cumberland,2021-12-15
3,44,7,37,0,Cumberland,2022-03-01
3,14,3,11,0,Cumberland,2022-03-31
3,23,5,18,0,Cumberland,2022-04-07
3,27,0,27,0,Cumberland,2022-04-15
3,41,3,38,0,Cumberland,2022-04-21
3,37,11,26,0,Cumberland,2022-04-30
3,38,8,30,0,Cumberland,2022-06-11
4,136,21,115,0,Cumberland,2021-12-14
4,23,9,14,0,Cumberland,2022-03-08
4,38,13,25,0,Cumberland,2022-04-13
4,42,5,37,0,Cumberland,2022-04-14
4,49,20,29,0,Cumberland,2022-05-14
4,63,15,48,0,Cumberland,2022-05-21
5,66,1,65,0,Cumberland,2021-12-25
5,20,7,13,0,Cumberland,2022-04-23
5,98,19,79,0,Cumberland,2022-05-03
6,44,6,38,0,Cumberland,2022-04-20
6,35,10,25,0,Cumberland,2022-04-24
7,194,21,173,0,Cumberland,2021-12-20
7,117,17,100,0,Cumberland,2022-02-05
7,46,2,44,0,Cumberland,2022-04-18
7,62,15,47,0,Cumberland,2022-05-05
7,57,23,34,0,Cumberland,2022-05-30
7,88,10,78,0,Cumberland,2022-06-10
8,116,16,100,0,Cumberland,2022-02-15
8,35,8,27,0,Cumberland,2022-04-19
8,69,11,58,0,Cumberland,2022-04-29
8,38,7,31,0,Cumberland,2022-05-01
8,89,23,66,0,Cumberland,2022-05-04
8,75,19,56,0,Cumberland,2022-05-15
8,69,7,62,0,Cumberland,2022-05-22
8,60,20,40,0,Cumberland,2022-06-04
9,119,23,96,0,Cumberland,2022-06-09
10,115,27,88,0,Cumberland,2022-06-07
11,235,36,199,0,Cumberland,2021-12-22
11,74,11,63,0,Cumberland,2022-04-27
11,126,23,103,0,Cumberland,2022-06-08
12,122,22,100,0,Cumberland,2022-05-12
12,144,24,120,0,Cumberland,2022-05-26
12,70,16,54,0,Cumberland,2022-05-28
12,72,21,51,0,Cumberland,2022-05-29
13,123,19,104,0,Cumberland,2022-05-11
14,106,22,84,0,Cumberland,2022-02-21
14,128,26,102,0,Cumberland,2022-05-10
14,142,27,115,0,Cumberland,2022-06-06
15,103,15,88,0,Cumberland,2022-05-13
15,173,29,144,0,Cumberland,2022-05-19
15,179,38,141,0,Cumberland,2022-05-23
15,130,25,105,0,Cumberland,2022-05-27
15,99,22,77,0,Cumberland,2022-06-03
16,141,25,116,0,Cumberland,2022-05-18
17,285,41,244,0,Cumberland,2021-12-23
18,118,15,103,0,Cumberland,2022-05-20
19,158,43,115,0,Cumberland,2022-05-17
19,149,28,121,0,Cumberland,2022-05-24
22,194,34,160,0,Cumberland,2022-06-01
31,524,86,438,0,Cumberland,2021-12-27
37,488,72,416,0,Cumberland,2022-02-01
45,666,87,579,0,Cumberland,2021-12-28
48,609,61,548,0,Cumberland,2021-12-31
72,1011,108,903,0,Cumberland,2021-12-29
76,1188,195,993,0,Cumberland,2022-01-20
100,1408,122,1286,0,Cumberland,2022-01-04
,0,0,0,0,Currituck,2022-02-18
,0,0,0,0,Currituck,2022-02-19
,0,0,0,0,Currituck,2022-02-20
,0,0,0,0,Currituck,2022-02-21
,0,0,0,0,Currituck,2022-02-23
,0,0,0,0,Currituck,2022-02-25
,0,0,0,0,Currituck,2022-02-27
,0,0,0,0,Currituck,2022-03-01
,0,0,0,0,Currituck,2022-03-02
,0,0,0,0,Currituck,2022-03-07
,0,0,0,0,Currituck,2022-03-09
,0,0,0,0,Currituck,2022-03-11
,0,0,0,0,Currituck,2022-03-14
,0,0,0,0,Currituck,2022-03-15
,0,0,0,0,Currituck,2022-03-16
,0,0,0,0,Currituck,2022-03-17
,0,0,0,0,Currituck,2022-03-18
,0,0,0,0,Currituck,2022-03-19
,0,0,0,0,Currituck,2022-03-20
,0,0,0,0,Currituck,2022-03-21
,0,0,0,0,Currituck,2022-03-23
,0,0,0,0,Currituck,2022-03-24
,0,0,0,0,Currituck,2022-03-26
,0,0,0,0,Currituck,2022-03-27
,0,0,0,0,Currituck,2022-03-28
,0,0,0,0,Currituck,2022-03-29
,0,0,0,0,Currituck,2022-03-31
,0,0,0,0,Currituck,2022-04-02
,0,0,0,0,Currituck,2022-04-04
,0,0,0,0,Currituck,2022-04-05
,0,0,0,0,Currituck,2022-04-06
,0,0,0,0,Currituck,2022-04-08
,0,0,0,0,Currituck,2022-04-09
,0,0,0,0,Currituck,2022-04-10
,0,0,0,0,Currituck,2022-04-15
,0,0,0,0,Currituck,2022-04-16
,0,0,0,0,Currituck,2022-04-17
,0,0,0,0,Currituck,2022-04-18
,0,0,0,0,Currituck,2022-04-19
0,8,1,7,0,Currituck,2021-12-14
0,8,1,7,0,Currituck,2021-12-15
0,11,3,8,0,Currituck,2021-12-16
0,11,4,7,0,Currituck,2021-12-18
0,7,0,7,0,Currituck,2021-12-19
0,32,4,28,0,Currituck,2021-12-28
0,27,8,19,0,Currituck,2022-01-02
0,6,2,4,0,Currituck,2022-01-22
0,20,4,16,0,Currituck,2022-01-23
0,3,0,3,0,Currituck,2022-01-28
0,5,2,3,0,Currituck,2022-01-29
0,4,1,3,0,Currituck,2022-01-30
0,12,1,11,0,Currituck,2022-02-03
0,14,0,14,0,Currituck,2022-02-04
0,3,2,1,0,Currituck,2022-02-05
0,3,0,3,0,Currituck,2022-02-06
0,12,1,11,0,Currituck,2022-02-07
0,9,1,8,0,Currituck,2022-02-09
0,6,0,6,0,Currituck,2022-02-10
0,8,0,8,0,Currituck,2022-02-11
0,4,0,4,0,Currituck,2022-02-13
0,9,0,9,0,Currituck,2022-02-14
0,4,0,4,0,Currituck,2022-02-15
0,2,0,2,0,Currituck,2022-02-17
0,3,0,3,0,Currituck,2022-02-28
0,3,1,2,0,Currituck,2022-03-12
0,2,1,1,0,Currituck,2022-03-13
0,2,0,2,0,Currituck,2022-03-30
0,1,0,1,0,Currituck,2022-04-01
0,1,0,1,0,Currituck,2022-04-11
0,1,0,1,0,Currituck,2022-04-12
0,1,0,1,0,Currituck,2022-04-13
0,2,0,2,0,Currituck,2022-04-14
0,2,0,2,0,Currituck,2022-04-20
0,2,0,2,0,Currituck,2022-04-21
0,1,0,1,0,Currituck,2022-04-22
0,3,2,1,0,Currituck,2022-04-23
0,2,0,2,0,Currituck,2022-04-24
0,3,0,3,0,Currituck,2022-04-25
0,6,2,4,0,Currituck,2022-04-26
0,6,2,4,0,Currituck,2022-04-27
0,3,1,2,0,Currituck,2022-04-29
0,2,0,2,0,Currituck,2022-04-30
0,1,0,1,0,Currituck,2022-05-01
0,2,0,2,0,Currituck,2022-05-03
0,6,3,3,0,Currituck,2022-05-04
0,1,1,0,0,Currituck,2022-05-06
0,1,0,1,0,Currituck,2022-05-07
0,7,2,5,0,Currituck,2022-05-09
0,9,0,9,0,Currituck,2022-05-10
0,1,0,1,0,Currituck,2022-05-11
0,5,0,5,0,Currituck,2022-05-12
0,7,0,7,0,Currituck,2022-05-13
0,11,4,7,0,Currituck,2022-05-14
0,4,1,3,0,Currituck,2022-05-15
0,1,1,0,0,Currituck,2022-05-19
0,3,1,2,0,Currituck,2022-05-20
0,7,3,4,0,Currituck,2022-05-24
0,15,4,11,0,Currituck,2022-05-25
0,6,1,5,0,Currituck,2022-05-26
0,2,0,2,0,Currituck,2022-05-30
0,8,6,2,0,Currituck,2022-06-01
0,3,0,3,0,Currituck,2022-06-04
0,4,0,4,0,Currituck,2022-06-05
0,3,0,3,0,Currituck,2022-06-07
0,5,1,4,0,Currituck,2022-06-08
0,4,0,4,0,Currituck,2022-06-10
0,1,0,1,0,Currituck,2022-06-11
1,16,4,12,0,Currituck,2021-12-20
1,16,3,13,0,Currituck,2021-12-23
1,21,6,15,0,Currituck,2021-12-26
1,18,0,18,0,Currituck,2021-12-31
1,52,8,44,0,Currituck,2022-01-05
1,23,3,20,0,Currituck,2022-01-09
1,64,7,57,0,Currituck,2022-01-12
1,29,3,26,0,Currituck,2022-01-16
1,72,10,62,0,Currituck,2022-01-19
1,19,5,14,0,Currituck,2022-01-21
1,20,6,14,0,Currituck,2022-01-27
1,20,5,15,0,Currituck,2022-02-01
1,5,0,5,0,Currituck,2022-02-08
1,3,0,3,0,Currituck,2022-02-22
1,3,3,0,0,Currituck,2022-03-03
1,3,2,1,0,Currituck,2022-03-05
1,2,1,1,0,Currituck,2022-03-10
1,2,0,2,0,Currituck,2022-03-25
1,2,0,2,0,Currituck,2022-04-03
1,3,0,3,0,Currituck,2022-04-07
1,2,0,2,0,Currituck,2022-04-28
1,11,3,8,0,Currituck,2022-05-16
1,7,2,5,0,Currituck,2022-05-18
1,6,0,6,0,Currituck,2022-05-22
1,9,1,8,0,Currituck,2022-05-27
1,5,1,4,0,Currituck,2022-05-29
1,5,0,5,0,Currituck,2022-06-02
1,4,1,3,0,Currituck,2022-06-03
2,10,7,3,0,Currituck,2021-12-25
2,46,5,41,0,Currituck,2021-12-29
2,31,6,25,0,Currituck,2022-01-01
2,58,11,47,0,Currituck,2022-01-04
2,57,4,53,0,Currituck,2022-01-06
2,34,11,23,0,Currituck,2022-01-15
2,52,6,46,0,Currituck,2022-01-20
2,59,8,51,0,Currituck,2022-01-24
2,43,3,40,0,Currituck,2022-01-26
2,5,0,5,0,Currituck,2022-02-12
2,14,3,11,0,Currituck,2022-05-28
2,11,4,7,0,Currituck,2022-06-06
2,7,2,5,0,Currituck,2022-06-09
3,36,4,32,0,Currituck,2021-12-27
3,63,4,59,0,Currituck,2022-01-14
3,12,1,11,0,Currituck,2022-05-23
4,61,13,48,0,Currituck,2022-01-03
4,25,1,24,0,Currituck,2022-01-08
4,66,6,60,0,Currituck,2022-01-13
4,78,9,69,0,Currituck,2022-01-18
4,66,10,56,0,Currituck,2022-01-25
4,27,4,23,0,Currituck,2022-01-31
6,77,11,66,0,Currituck,2022-01-10
8,68,18,50,0,Currituck,2022-01-17
,0,0,0,0,Dare,2021-12-25
,0,0,0,0,Dare,2022-03-10
,0,0,0,0,Dare,2022-03-11
,0,0,0,0,Dare,2022-03-12
,0,0,0,0,Dare,2022-03-24
,0,0,0,0,Dare,2022-03-28
,0,0,0,0,Dare,2022-03-29
,0,0,0,0,Dare,2022-04-04
0,16,0,16,0,Dare,2021-12-14
0,15,1,14,0,Dare,2021-12-15
0,7,0,7,0,Dare,2021-12-18
0,25,0,25,0,Dare,2021-12-22
0,18,0,18,0,Dare,2022-01-01
0,32,0,32,0,Dare,2022-02-04
0,9,0,9,0,Dare,2022-02-05
0,11,0,11,0,Dare,2022-02-09
0,15,0,15,0,Dare,2022-02-11
0,4,0,4,0,Dare,2022-02-12
0,3,0,3,0,Dare,2022-02-19
0,4,0,4,0,Dare,2022-02-23
0,5,0,5,0,Dare,2022-02-24
0,4,0,4,0,Dare,2022-02-25
0,1,0,1,0,Dare,2022-02-27
0,3,0,3,0,Dare,2022-02-28
0,2,0,2,0,Dare,2022-03-01
0,3,0,3,0,Dare,2022-03-02
0,3,0,3,0,Dare,2022-03-04
0,2,0,2,0,Dare,2022-03-05
0,2,0,2,0,Dare,2022-03-06
0,8,0,8,0,Dare,2022-03-09
0,1,0,1,0,Dare,2022-03-14
0,3,0,3,0,Dare,2022-03-15
0,2,0,2,0,Dare,2022-03-16
0,3,0,3,0,Dare,2022-03-18
0,1,0,1,0,Dare,2022-03-19
0,2,0,2,0,Dare,2022-03-20
0,2,0,2,0,Dare,2022-03-21
0,1,0,1,0,Dare,2022-03-22
0,1,0,1,0,Dare,2022-03-25
0,1,0,1,0,Dare,2022-03-26
0,1,0,1,0,Dare,2022-03-27
0,2,1,1,0,Dare,2022-03-30
0,1,0,1,0,Dare,2022-04-01
0,1,0,1,0,Dare,2022-04-02
0,1,0,1,0,Dare,2022-04-03
0,1,0,1,0,Dare,2022-04-05
0,3,0,3,0,Dare,2022-04-06
0,2,0,2,0,Dare,2022-04-07
0,1,0,1,0,Dare,2022-04-08
0,1,0,1,0,Dare,2022-04-10
0,3,0,3,0,Dare,2022-04-11
0,1,0,1,0,Dare,2022-04-12
0,6,0,6,0,Dare,2022-04-14
0,2,0,2,0,Dare,2022-04-16
0,6,0,6,0,Dare,2022-04-18
0,2,0,2,0,Dare,2022-04-20
0,7,0,7,0,Dare,2022-04-22
0,5,0,5,0,Dare,2022-04-23
0,3,0,3,0,Dare,2022-04-24
0,8,0,8,0,Dare,2022-04-26
0,11,0,11,0,Dare,2022-04-27
0,13,0,13,0,Dare,2022-04-28
0,7,0,7,0,Dare,2022-04-29
0,7,0,7,0,Dare,2022-04-30
0,1,0,1,0,Dare,2022-05-01
0,12,1,11,0,Dare,2022-05-02
0,5,0,5,0,Dare,2022-05-07
0,17,0,17,0,Dare,2022-05-10
0,16,0,16,0,Dare,2022-05-12
0,10,0,10,0,Dare,2022-05-14
0,8,0,8,0,Dare,2022-05-15
0,13,0,13,0,Dare,2022-05-16
0,10,0,10,0,Dare,2022-05-22
0,24,2,22,0,Dare,2022-05-24
0,12,1,11,0,Dare,2022-05-26
0,12,0,12,0,Dare,2022-05-28
0,16,0,16,0,Dare,2022-06-03
0,8,0,8,0,Dare,2022-06-04
1,24,2,22,0,Dare,2021-12-20
1,30,0,30,0,Dare,2022-01-21
1,14,0,14,0,Dare,2022-01-23
1,20,0,20,0,Dare,2022-01-30
1,38,0,38,0,Dare,2022-02-01
1,21,1,20,0,Dare,2022-02-02
1,13,0,13,0,Dare,2022-02-06
1,21,2,19,0,Dare,2022-02-07
1,17,1,16,0,Dare,2022-02-08
1,14,0,14,0,Dare,2022-02-10
1,7,0,7,0,Dare,2022-02-13
1,9,0,9,0,Dare,2022-02-14
1,16,0,16,0,Dare,2022-02-15
1,12,0,12,0,Dare,2022-02-16
1,13,0,13,0,Dare,2022-02-17
1,9,0,9,0,Dare,2022-02-18
1,11,0,11,0,Dare,2022-02-21
1,6,0,6,0,Dare,2022-02-22
1,3,0,3,0,Dare,2022-03-13
1,1,0,1,0,Dare,2022-03-17
1,1,0,1,0,Dare,2022-03-31
1,2,0,2,0,Dare,2022-04-09
1,4,0,4,0,Dare,2022-04-13
1,6,0,6,0,Dare,2022-04-15
1,3,0,3,0,Dare,2022-04-17
1,7,0,7,0,Dare,2022-04-19
1,11,0,11,0,Dare,2022-05-04
1,13,0,13,0,Dare,2022-05-09
1,19,1,18,0,Dare,2022-05-13
1,9,0,9,0,Dare,2022-05-21
1,15,0,15,0,Dare,2022-05-29
1,12,0,12,0,Dare,2022-06-05
1,22,0,22,0,Dare,2022-06-08
1,7,0,7,0,Dare,2022-06-09
1,8,0,8,0,Dare,2022-06-11
2,31,0,31,0,Dare,2021-12-23
2,23,0,23,0,Dare,2021-12-24
2,49,0,49,0,Dare,2021-12-27
2,52,0,52,0,Dare,2021-12-31
2,51,0,51,0,Dare,2022-01-15
2,41,1,40,0,Dare,2022-01-16
2,84,1,83,0,Dare,2022-01-20
2,9,0,9,0,Dare,2022-01-29
2,9,0,9,0,Dare,2022-04-21
2,12,1,11,0,Dare,2022-05-06
2,10,0,10,0,Dare,2022-05-08
2,19,0,19,0,Dare,2022-05-18
2,20,0,20,0,Dare,2022-05-27
2,11,1,10,0,Dare,2022-05-30
2,21,0,21,0,Dare,2022-06-01
2,25,0,25,0,Dare,2022-06-02
2,17,0,17,0,Dare,2022-06-06
2,11,0,11,0,Dare,2022-06-10
3,68,1,67,0,Dare,2021-12-28
3,98,0,98,0,Dare,2022-01-04
3,96,0,96,0,Dare,2022-01-18
3,23,0,23,0,Dare,2022-01-22
3,48,0,48,0,Dare,2022-01-27
3,32,1,31,0,Dare,2022-01-28
3,19,0,19,0,Dare,2022-05-11
3,23,0,23,0,Dare,2022-05-17
3,27,0,27,0,Dare,2022-05-19
3,29,0,29,0,Dare,2022-05-23
3,28,0,28,0,Dare,2022-05-31
3,13,0,13,0,Dare,2022-06-07
4,29,0,29,0,Dare,2021-12-26
4,102,0,102,0,Dare,2022-01-05
4,84,0,84,0,Dare,2022-01-24
4,64,2,62,0,Dare,2022-01-25
4,57,2,55,0,Dare,2022-01-26
4,26,1,25,0,Dare,2022-05-20
5,44,1,43,0,Dare,2022-01-02
5,77,0,77,0,Dare,2022-01-17
5,53,2,51,0,Dare,2022-01-31
5,18,0,18,0,Dare,2022-05-25
6,58,1,57,0,Dare,2021-12-29
6,50,0,50,0,Dare,2022-01-08
7,91,0,91,0,Dare,2022-01-03
7,109,0,109,0,Dare,2022-01-11
8,64,0,64,0,Dare,2021-12-30
8,103,0,103,0,Dare,2022-01-06
9,108,2,106,0,Dare,2022-01-19
10,102,1,101,0,Dare,2022-01-12
10,110,1,109,0,Dare,2022-01-14
11,128,0,128,0,Dare,2022-01-10
0,40,2,38,0,Davidson,2021-12-18
0,8,0,8,0,Davidson,2022-03-05
0,5,1,4,0,Davidson,2022-03-09
0,6,4,2,0,Davidson,2022-03-10
0,8,3,5,0,Davidson,2022-03-11
0,2,0,2,0,Davidson,2022-03-13
0,2,0,2,0,Davidson,2022-03-19
0,1,0,1,0,Davidson,2022-03-20
0,8,3,5,0,Davidson,2022-03-21
0,5,2,3,0,Davidson,2022-03-22
0,1,0,1,0,Davidson,2022-03-24
0,2,0,2,0,Davidson,2022-03-25
0,1,0,1,0,Davidson,2022-03-26
0,5,2,3,0,Davidson,2022-03-27
0,2,0,2,0,Davidson,2022-03-28
0,6,1,5,0,Davidson,2022-03-29
0,7,3,4,0,Davidson,2022-03-30
0,5,1,4,0,Davidson,2022-04-01
0,4,2,2,0,Davidson,2022-04-02
0,8,2,6,0,Davidson,2022-04-04
0,10,8,2,0,Davidson,2022-04-06
0,11,3,8,0,Davidson,2022-04-07
0,6,2,4,0,Davidson,2022-04-09
0,6,2,4,0,Davidson,2022-04-15
0,9,1,8,0,Davidson,2022-04-18
0,13,2,11,0,Davidson,2022-04-22
0,6,2,4,0,Davidson,2022-04-23
0,19,1,18,0,Davidson,2022-04-24
0,20,1,19,0,Davidson,2022-04-28
0,20,3,17,0,Davidson,2022-04-29
1,34,5,29,0,Davidson,2022-02-23
1,11,3,8,0,Davidson,2022-02-25
1,26,6,20,0,Davidson,2022-02-28
1,13,5,8,0,Davidson,2022-03-01
1,15,6,9,0,Davidson,2022-03-03
1,3,0,3,0,Davidson,2022-03-12
1,4,1,3,0,Davidson,2022-03-14
1,4,0,4,0,Davidson,2022-03-15
1,5,2,3,0,Davidson,2022-03-18
1,5,0,5,0,Davidson,2022-04-03
1,8,3,5,0,Davidson,2022-04-08
1,9,4,5,0,Davidson,2022-04-10
1,19,6,13,0,Davidson,2022-04-11
1,12,4,8,0,Davidson,2022-04-12
1,7,1,6,0,Davidson,2022-04-14
1,12,3,9,0,Davidson,2022-04-16
1,3,0,3,0,Davidson,2022-04-17
1,10,0,10,0,Davidson,2022-04-30
1,15,1,14,0,Davidson,2022-05-01
1,23,3,20,0,Davidson,2022-05-06
2,77,3,74,0,Davidson,2021-12-14
2,110,15,95,0,Davidson,2021-12-20
2,64,6,58,0,Davidson,2022-02-06
2,71,19,52,0,Davidson,2022-02-14
2,13,2,11,0,Davidson,2022-02-20
2,11,1,10,0,Davidson,2022-03-06
2,5,1,4,0,Davidson,2022-03-17
2,17,7,10,0,Davidson,2022-04-13
2,14,1,13,0,Davidson,2022-04-20
2,14,1,13,0,Davidson,2022-04-21
2,18,3,15,0,Davidson,2022-05-07
2,24,1,23,0,Davidson,2022-05-08
2,24,4,20,0,Davidson,2022-06-04
3,5,1,4,0,Davidson,2022-03-31
3,17,2,15,0,Davidson,2022-04-19
3,31,7,24,0,Davidson,2022-05-11
3,34,8,26,0,Davidson,2022-05-13
3,27,5,22,0,Davidson,2022-05-15
3,22,2,20,0,Davidson,2022-05-21
3,21,3,18,0,Davidson,2022-05-29
3,24,1,23,0,Davidson,2022-06-05
3,44,10,34,0,Davidson,2022-06-07
3,21,0,21,0,Davidson,2022-06-11
4,40,3,37,0,Davidson,2022-02-17
4,48,7,41,0,Davidson,2022-02-18
4,47,23,24,0,Davidson,2022-05-10
4,16,1,15,0,Davidson,2022-05-14
4,45,9,36,0,Davidson,2022-06-09
5,31,7,24,0,Davidson,2022-04-26
5,19,4,15,0,Davidson,2022-04-27
5,28,9,19,0,Davidson,2022-05-05
5,70,26,44,0,Davidson,2022-05-26
5,47,12,35,0,Davidson,2022-05-27
5,44,9,35,0,Davidson,2022-06-03
6,97,15,82,0,Davidson,2021-12-23
6,49,10,39,0,Davidson,2022-02-16
6,55,10,45,0,Davidson,2022-05-12
6,74,26,48,0,Davidson,2022-05-16
6,30,7,23,0,Davidson,2022-05-22
6,59,17,42,0,Davidson,2022-06-02
7,38,11,27,0,Davidson,2022-05-02
7,39,10,29,0,Davidson,2022-05-09
7,46,9,37,0,Davidson,2022-05-18
7,46,17,29,0,Davidson,2022-05-19
7,54,18,36,0,Davidson,2022-05-20
7,36,6,30,0,Davidson,2022-05-30
8,270,36,234,0,Davidson,2021-12-27
8,68,18,50,0,Davidson,2022-05-23
8,34,1,33,0,Davidson,2022-05-28
8,68,18,50,0,Davidson,2022-06-08
9,68,15,53,0,Davidson,2022-05-24
9,65,13,52,0,Davidson,2022-06-01
12,161,19,142,0,Davidson,2022-02-03
12,80,19,61,0,Davidson,2022-06-06
16,228,23,205,0,Davidson,2022-01-15
17,186,18,168,0,Davidson,2022-01-09
18,219,16,203,0,Davidson,2022-01-08
23,253,40,213,0,Davidson,2022-01-28
27,354,40,314,0,Davidson,2021-12-29
40,413,63,350,0,Davidson,2022-01-03
53,556,44,512,0,Davidson,2022-01-18
56,574,59,515,0,Davidson,2022-01-19
,0,0,0,0,Davie,2022-03-05
,0,0,0,0,Davie,2022-03-06
,0,0,0,0,Davie,2022-03-10
,0,0,0,0,Davie,2022-03-20
,0,0,0,0,Davie,2022-04-04
,0,0,0,0,Davie,2022-04-05
0,30,6,24,0,Davie,2021-12-14
0,42,10,32,0,Davie,2021-12-15
0,30,7,23,0,Davie,2021-12-16
0,18,6,12,0,Davie,2021-12-18
0,15,3,12,0,Davie,2021-12-19
0,12,1,11,0,Davie,2021-12-24
0,2,0,2,0,Davie,2021-12-25
0,21,4,17,0,Davie,2021-12-26
0,24,4,20,0,Davie,2022-01-01
0,9,1,8,0,Davie,2022-01-16
0,30,4,26,0,Davie,2022-01-29
0,28,5,23,0,Davie,2022-02-11
0,21,4,17,0,Davie,2022-02-14
0,11,2,9,0,Davie,2022-02-16
0,7,2,5,0,Davie,2022-02-19
0,13,2,11,0,Davie,2022-02-22
0,9,1,8,0,Davie,2022-02-23
0,7,1,6,0,Davie,2022-02-24
0,6,0,6,0,Davie,2022-02-26
0,4,1,3,0,Davie,2022-02-27
0,5,1,4,0,Davie,2022-03-01
0,3,0,3,0,Davie,2022-03-02
0,4,2,2,0,Davie,2022-03-03
0,6,0,6,0,Davie,2022-03-04
0,2,0,2,0,Davie,2022-03-09
0,1,0,1,0,Davie,2022-03-11
0,1,0,1,0,Davie,2022-03-12
0,2,1,1,0,Davie,2022-03-13
0,1,0,1,0,Davie,2022-03-18
0,3,1,2,0,Davie,2022-03-22
0,1,1,0,0,Davie,2022-03-23
0,2,1,1,0,Davie,2022-03-25
0,1,0,1,0,Davie,2022-03-26
0,1,0,1,0,Davie,2022-03-27
0,3,0,3,0,Davie,2022-03-28
0,2,1,1,0,Davie,2022-03-30
0,1,1,0,0,Davie,2022-04-01
0,4,3,1,0,Davie,2022-04-02
0,2,1,1,0,Davie,2022-04-03
0,1,0,1,0,Davie,2022-04-06
0,3,1,2,0,Davie,2022-04-07
0,3,0,3,0,Davie,2022-04-08
0,2,0,2,0,Davie,2022-04-10
0,3,0,3,0,Davie,2022-04-13
0,3,2,1,0,Davie,2022-04-14
0,6,2,4,0,Davie,2022-04-15
0,2,1,1,0,Davie,2022-04-16
0,2,1,1,0,Davie,2022-04-17
0,6,3,3,0,Davie,2022-04-18
0,8,4,4,0,Davie,2022-04-19
0,6,3,3,0,Davie,2022-04-20
0,9,2,7,0,Davie,2022-04-22
0,5,3,2,0,Davie,2022-04-26
0,7,3,4,0,Davie,2022-04-27
0,4,0,4,0,Davie,2022-04-30
0,4,1,3,0,Davie,2022-05-01
0,11,5,6,0,Davie,2022-05-02
0,7,2,5,0,Davie,2022-05-04
0,5,1,4,0,Davie,2022-05-07
0,4,0,4,0,Davie,2022-05-08
0,22,6,16,0,Davie,2022-05-13
0,5,0,5,0,Davie,2022-05-14
0,11,4,7,0,Davie,2022-05-15
0,11,2,9,0,Davie,2022-05-20
0,11,1,10,0,Davie,2022-05-28
0,8,2,6,0,Davie,2022-06-02
0,2,0,2,0,Davie,2022-06-03
0,2,0,2,0,Davie,2022-06-04
0,4,0,4,0,Davie,2022-06-05
1,27,1,26,0,Davie,2021-12-22
1,32,6,26,0,Davie,2021-12-23
1,27,9,18,0,Davie,2022-01-23
1,26,7,19,0,Davie,2022-01-30
1,20,3,17,0,Davie,2022-02-10
1,6,0,6,0,Davie,2022-02-12
1,9,3,6,0,Davie,2022-02-20
1,6,4,2,0,Davie,2022-03-14
1,3,1,2,0,Davie,2022-03-15
1,6,1,5,0,Davie,2022-03-16
1,4,2,2,0,Davie,2022-03-21
1,4,3,1,0,Davie,2022-03-29
1,2,0,2,0,Davie,2022-04-09
1,3,1,2,0,Davie,2022-04-11
1,7,5,2,0,Davie,2022-04-29
1,11,6,5,0,Davie,2022-05-03
1,17,6,11,0,Davie,2022-05-06
1,26,11,15,0,Davie,2022-05-10
1,7,2,5,0,Davie,2022-05-21
1,23,10,13,0,Davie,2022-05-23
1,17,9,8,0,Davie,2022-05-24
1,15,6,9,0,Davie,2022-05-26
1,9,0,9,0,Davie,2022-05-29
1,8,1,7,0,Davie,2022-05-30
1,23,7,16,0,Davie,2022-06-01
1,15,4,11,0,Davie,2022-06-09
1,4,0,4,0,Davie,2022-06-11
2,37,8,29,0,Davie,2021-12-20
2,24,3,21,0,Davie,2022-02-06
2,34,8,26,0,Davie,2022-02-09
2,18,4,14,0,Davie,2022-02-17
2,13,1,12,0,Davie,2022-02-18
2,12,8,4,0,Davie,2022-02-28
2,5,2,3,0,Davie,2022-03-31
2,13,4,9,0,Davie,2022-04-25
2,11,3,8,0,Davie,2022-05-05
2,19,8,11,0,Davie,2022-05-11
2,15,9,6,0,Davie,2022-05-12
2,16,4,12,0,Davie,2022-05-16
2,21,6,15,0,Davie,2022-05-17
2,20,7,13,0,Davie,2022-05-19
2,16,1,15,0,Davie,2022-05-27
2,25,6,19,0,Davie,2022-06-06
2,15,0,15,0,Davie,2022-06-08
3,75,9,66,0,Davie,2021-12-28
3,34,5,29,0,Davie,2021-12-31
3,27,2,25,0,Davie,2022-01-09
3,35,7,28,0,Davie,2022-01-22
3,69,14,55,0,Davie,2022-01-26
3,69,15,54,0,Davie,2022-02-01
3,28,8,20,0,Davie,2022-05-18
3,11,4,7,0,Davie,2022-05-22
3,16,2,14,0,Davie,2022-06-07
3,18,6,12,0,Davie,2022-06-10
4,88,10,78,0,Davie,2021-12-27
4,35,7,28,0,Davie,2022-01-15
4,51,14,37,0,Davie,2022-02-03
4,23,7,16,0,Davie,2022-05-25
5,79,8,71,0,Davie,2021-12-30
5,76,13,63,0,Davie,2022-01-03
5,25,10,15,0,Davie,2022-05-09
6,110,23,87,0,Davie,2022-01-04
6,56,15,41,0,Davie,2022-02-07
6,35,8,27,0,Davie,2022-05-31
7,129,28,101,0,Davie,2022-01-13
7,105,19,86,0,Davie,2022-01-21
9,157,29,128,0,Davie,2022-01-14
10,109,17,92,0,Davie,2022-01-05
10,133,26,107,0,Davie,2022-01-24
10,94,17,77,0,Davie,2022-01-25
11,76,10,66,0,Davie,2021-12-29
11,136,20,116,0,Davie,2022-01-10
11,166,16,150,0,Davie,2022-01-11
12,127,30,97,0,Davie,2022-01-18
14,153,23,130,0,Davie,2022-01-12
14,161,35,126,0,Davie,2022-01-20
18,185,27,158,0,Davie,2022-01-19
,0,0,0,0,Duplin,2022-03-06
,0,0,0,0,Duplin,2022-03-12
,0,0,0,0,Duplin,2022-03-13
,0,0,0,0,Duplin,2022-03-19
,0,0,0,0,Duplin,2022-03-20
,0,0,0,0,Duplin,2022-03-21
,0,0,0,0,Duplin,2022-03-23
,0,0,0,0,Duplin,2022-03-26
,0,0,0,0,Duplin,2022-03-27
,0,0,0,0,Duplin,2022-03-31
,0,0,0,0,Duplin,2022-04-10
,0,0,0,0,Duplin,2022-04-11
,0,0,0,0,Duplin,2022-04-17
0,21,6,15,0,Duplin,2021-12-14
0,10,4,6,0,Duplin,2021-12-16
0,2,0,2,0,Duplin,2021-12-18
0,6,1,5,0,Duplin,2021-12-19
0,4,1,3,0,Duplin,2021-12-24
0,15,5,10,0,Duplin,2021-12-26
0,10,3,7,0,Duplin,2022-01-29
0,22,1,21,0,Duplin,2022-01-30
0,28,9,19,0,Duplin,2022-02-09
0,7,0,7,0,Duplin,2022-02-22
0,5,2,3,0,Duplin,2022-03-01
0,6,1,5,0,Duplin,2022-03-02
0,4,2,2,0,Duplin,2022-03-03
0,2,0,2,0,Duplin,2022-03-07
0,3,2,1,0,Duplin,2022-03-09
0,2,0,2,0,Duplin,2022-03-10
0,4,2,2,0,Duplin,2022-03-14
0,3,1,2,0,Duplin,2022-03-17
0,2,2,0,0,Duplin,2022-03-22
0,1,1,0,0,Duplin,2022-03-25
0,1,0,1,0,Duplin,2022-03-29
0,2,1,1,0,Duplin,2022-03-30
0,2,1,1,0,Duplin,2022-04-01
0,1,0,1,0,Duplin,2022-04-02
0,1,0,1,0,Duplin,2022-04-03
0,1,1,0,0,Duplin,2022-04-06
0,1,0,1,0,Duplin,2022-04-08
0,1,0,1,0,Duplin,2022-04-09
0,1,0,1,0,Duplin,2022-04-12
0,1,1,0,0,Duplin,2022-04-13
0,2,1,1,0,Duplin,2022-04-14
0,3,0,3,0,Duplin,2022-04-16
0,2,0,2,0,Duplin,2022-04-20
0,1,1,0,0,Duplin,2022-04-22
0,1,0,1,0,Duplin,2022-04-23
0,3,1,2,0,Duplin,2022-04-26
0,8,3,5,0,Duplin,2022-04-27
0,1,1,0,0,Duplin,2022-04-28
0,2,1,1,0,Duplin,2022-04-30
0,1,0,1,0,Duplin,2022-05-01
0,2,0,2,0,Duplin,2022-05-06
0,2,1,1,0,Duplin,2022-05-08
0,8,4,4,0,Duplin,2022-05-12
0,2,0,2,0,Duplin,2022-05-14
0,2,1,1,0,Duplin,2022-05-15
0,15,6,9,0,Duplin,2022-05-16
0,2,1,1,0,Duplin,2022-05-18
0,4,2,2,0,Duplin,2022-05-20
0,2,1,1,0,Duplin,2022-05-21
0,13,2,11,0,Duplin,2022-05-26
0,4,4,0,0,Duplin,2022-05-27
0,4,1,3,0,Duplin,2022-05-28
0,1,0,1,0,Duplin,2022-05-29
0,3,0,3,0,Duplin,2022-05-30
0,3,1,2,0,Duplin,2022-06-04
0,9,3,6,0,Duplin,2022-06-07
0,6,1,5,0,Duplin,2022-06-10
1,16,7,9,0,Duplin,2021-12-15
1,21,7,14,0,Duplin,2021-12-20
1,20,12,8,0,Duplin,2021-12-21
1,11,2,9,0,Duplin,2022-02-06
1,20,9,11,0,Duplin,2022-02-11
1,26,6,20,0,Duplin,2022-02-14
1,19,6,13,0,Duplin,2022-02-16
1,11,4,7,0,Duplin,2022-02-17
1,14,4,10,0,Duplin,2022-02-21
1,10,2,8,0,Duplin,2022-02-23
1,6,3,3,0,Duplin,2022-02-24
1,5,1,4,0,Duplin,2022-02-27
1,6,2,4,0,Duplin,2022-02-28
1,2,1,1,0,Duplin,2022-03-24
1,3,3,0,0,Duplin,2022-04-04
1,1,0,1,0,Duplin,2022-04-07
1,2,1,1,0,Duplin,2022-04-15
1,2,0,2,0,Duplin,2022-04-18
1,4,1,3,0,Duplin,2022-04-19
1,4,2,2,0,Duplin,2022-04-21
1,3,0,3,0,Duplin,2022-04-24
1,3,1,2,0,Duplin,2022-04-25
1,3,1,2,0,Duplin,2022-05-04
1,9,5,4,0,Duplin,2022-05-05
1,3,1,2,0,Duplin,2022-05-07
1,6,1,5,0,Duplin,2022-05-10
1,10,1,9,0,Duplin,2022-05-13
1,7,1,6,0,Duplin,2022-05-22
1,16,10,6,0,Duplin,2022-05-23
1,20,10,10,0,Duplin,2022-05-31
1,10,5,5,0,Duplin,2022-06-02
1,10,2,8,0,Duplin,2022-06-09
1,12,2,10,0,Duplin,2022-06-11
2,16,7,9,0,Duplin,2021-12-22
2,41,16,25,0,Duplin,2021-12-27
2,49,21,28,0,Duplin,2021-12-31
2,30,4,26,0,Duplin,2022-01-02
2,14,5,9,0,Duplin,2022-02-18
2,5,2,3,0,Duplin,2022-04-29
2,8,4,4,0,Duplin,2022-05-11
2,9,5,4,0,Duplin,2022-05-19
2,16,7,9,0,Duplin,2022-05-24
2,8,3,5,0,Duplin,2022-06-03
2,6,2,4,0,Duplin,2022-06-08
3,44,10,34,0,Duplin,2022-02-03
3,14,8,6,0,Duplin,2022-06-01
4,91,21,70,0,Duplin,2021-12-29
4,9,3,6,0,Duplin,2022-05-03
5,72,25,47,0,Duplin,2021-12-28
5,58,18,40,0,Duplin,2022-01-21
5,20,8,12,0,Duplin,2022-06-06
7,125,59,66,0,Duplin,2022-01-08
7,105,54,51,0,Duplin,2022-01-15
9,141,52,89,0,Duplin,2022-01-26
10,93,43,50,0,Duplin,2021-12-30
11,63,21,42,0,Duplin,2022-02-01
13,110,54,56,0,Duplin,2022-01-31
14,224,95,129,0,Duplin,2022-01-24
18,144,67,77,0,Duplin,2022-01-04
18,196,74,122,0,Duplin,2022-01-07
21,178,52,126,0,Duplin,2022-01-03
21,264,102,162,0,Duplin,2022-01-14
23,256,100,156,0,Duplin,2022-01-06
31,297,147,150,0,Duplin,2022-01-13
36,398,163,235,0,Duplin,2022-01-18
43,292,123,169,0,Duplin,2022-01-11
0,25,9,16,0,Durham,2022-02-26
0,36,4,32,0,Durham,2022-03-01
0,10,0,10,0,Durham,2022-03-06
0,18,0,18,0,Durham,2022-03-08
0,23,3,20,0,Durham,2022-03-10
0,19,2,17,0,Durham,2022-03-11
0,17,1,16,0,Durham,2022-03-12
0,13,2,11,0,Durham,2022-03-13
0,44,7,37,0,Durham,2022-03-14
0,13,4,9,0,Durham,2022-03-20
0,55,6,49,0,Durham,2022-04-04
1,49,1,48,0,Durham,2022-02-20
1,42,2,40,0,Durham,2022-03-02
1,28,1,27,0,Durham,2022-03-07
1,14,2,12,0,Durham,2022-03-27
1,30,3,27,0,Durham,2022-03-28
1,41,3,38,0,Durham,2022-04-09
2,44,7,37,0,Durham,2022-02-25
2,26,5,21,0,Durham,2022-03-04
2,41,4,37,0,Durham,2022-03-22
2,32,3,29,0,Durham,2022-03-30
2,31,1,30,0,Durham,2022-03-31
2,33,7,26,0,Durham,2022-04-03
2,37,3,34,0,Durham,2022-04-17
3,87,7,80,0,Durham,2021-12-18
3,85,3,82,0,Durham,2021-12-25
3,43,4,39,0,Durham,2022-02-28
3,41,1,40,0,Durham,2022-03-16
3,25,3,22,0,Durham,2022-03-24
3,23,0,23,0,Durham,2022-03-25
3,33,3,30,0,Durham,2022-04-01
3,23,1,22,0,Durham,2022-04-02
3,30,1,29,0,Durham,2022-04-10
3,87,5,82,0,Durham,2022-04-11
3,126,7,119,0,Durham,2022-06-04
4,79,10,69,0,Durham,2021-12-15
4,94,6,88,0,Durham,2021-12-17
4,74,4,70,0,Durham,2022-02-23
4,36,11,25,0,Durham,2022-03-23
4,128,14,114,0,Durham,2022-04-20
4,82,2,80,0,Durham,2022-04-23
4,101,8,93,0,Durham,2022-05-08
4,125,7,118,0,Durham,2022-05-14
4,82,11,71,0,Durham,2022-05-30
5,172,6,166,0,Durham,2021-12-24
5,24,0,24,0,Durham,2022-03-15
5,115,8,107,0,Durham,2022-04-12
5,54,3,51,0,Durham,2022-04-16
5,88,8,80,0,Durham,2022-04-24
5,153,9,144,0,Durham,2022-04-25
6,77,3,74,0,Durham,2022-04-08
6,133,6,127,0,Durham,2022-04-13
6,84,7,77,0,Durham,2022-04-30
6,90,5,85,0,Durham,2022-05-21
6,113,10,103,0,Durham,2022-05-22
7,158,8,150,0,Durham,2021-12-20
7,80,20,60,0,Durham,2022-04-15
7,122,9,113,0,Durham,2022-04-22
7,116,4,112,0,Durham,2022-04-29
7,78,8,70,0,Durham,2022-05-01
7,160,12,148,0,Durham,2022-05-02
7,99,8,91,0,Durham,2022-05-07
7,150,13,137,0,Durham,2022-05-28
7,134,8,126,0,Durham,2022-05-29
8,147,10,137,0,Durham,2022-01-29
8,114,10,104,0,Durham,2022-02-17
8,43,4,39,0,Durham,2022-02-24
8,130,7,123,0,Durham,2022-04-28
8,188,14,174,0,Durham,2022-05-04
8,151,12,139,0,Durham,2022-05-06
8,203,28,175,0,Durham,2022-06-06
8,106,2,104,0,Durham,2022-06-11
10,255,13,242,0,Durham,2021-12-22
10,208,17,191,0,Durham,2022-05-12
10,114,4,110,0,Durham,2022-05-15
10,170,10,160,0,Durham,2022-05-20
10,172,8,164,0,Durham,2022-05-26
11,173,6,167,0,Durham,2022-01-22
11,219,8,211,0,Durham,2022-02-09
11,149,5,144,0,Durham,2022-04-19
11,151,9,142,0,Durham,2022-04-26
11,154,19,135,0,Durham,2022-06-09
12,117,14,103,0,Durham,2022-02-14
12,153,7,146,0,Durham,2022-05-13
12,223,14,209,0,Durham,2022-05-17
12,113,16,97,0,Durham,2022-06-05
12,150,7,143,0,Durham,2022-06-10
13,137,10,127,0,Durham,2022-02-10
13,122,11,111,0,Durham,2022-04-21
13,164,4,160,0,Durham,2022-04-27
13,180,15,165,0,Durham,2022-06-07
13,162,7,155,0,Durham,2022-06-08
14,166,11,155,0,Durham,2022-05-03
14,223,8,215,0,Durham,2022-05-19
14,233,16,217,0,Durham,2022-05-25
15,193,16,177,0,Durham,2022-05-05
15,227,12,215,0,Durham,2022-05-11
15,218,17,201,0,Durham,2022-05-24
15,144,12,132,0,Durham,2022-05-27
16,327,16,311,0,Durham,2022-01-01
16,239,14,225,0,Durham,2022-05-10
16,213,14,199,0,Durham,2022-06-03
17,196,20,176,0,Durham,2021-12-21
17,219,14,205,0,Durham,2022-05-09
17,229,12,217,0,Durham,2022-05-18
17,285,17,268,0,Durham,2022-06-01
18,235,15,220,0,Durham,2022-05-16
19,218,16,202,0,Durham,2022-05-23
22,270,12,258,0,Durham,2021-12-23
23,230,11,219,0,Durham,2022-06-02
27,482,30,452,0,Durham,2022-01-27
34,617,45,572,0,Durham,2022-01-17
36,337,31,306,0,Durham,2022-05-31
38,567,41,526,0,Durham,2021-12-31
40,617,43,574,0,Durham,2021-12-27
50,712,41,671,0,Durham,2022-01-08
52,683,49,634,0,Durham,2022-01-02
53,907,55,852,0,Durham,2021-12-28
69,973,37,936,0,Durham,2021-12-29
72,1199,50,1149,0,Durham,2022-01-13
83,1066,71,995,0,Durham,2021-12-30
93,1323,96,1227,0,Durham,2022-01-06
97,1282,80,1202,0,Durham,2022-01-12
100,1546,125,1421,0,Durham,2022-01-04
,0,0,0,0,Edgecombe,2022-03-06
,0,0,0,0,Edgecombe,2022-03-12
,0,0,0,0,Edgecombe,2022-03-20
,0,0,0,0,Edgecombe,2022-03-23
,0,0,0,0,Edgecombe,2022-03-26
,0,0,0,0,Edgecombe,2022-04-01
,0,0,0,0,Edgecombe,2022-04-02
,0,0,0,0,Edgecombe,2022-04-03
,0,0,0,0,Edgecombe,2022-04-04
,0,0,0,0,Edgecombe,2022-04-07
,0,0,0,0,Edgecombe,2022-04-10
,0,0,0,0,Edgecombe,2022-04-16
,0,0,0,0,Edgecombe,2022-04-20
0,8,1,7,0,Edgecombe,2021-12-15
0,8,1,7,0,Edgecombe,2021-12-18
0,15,0,15,0,Edgecombe,2021-12-20
0,14,5,9,0,Edgecombe,2021-12-24
0,15,1,14,0,Edgecombe,2022-01-30
0,11,0,11,0,Edgecombe,2022-02-05
0,2,0,2,0,Edgecombe,2022-02-12
0,7,1,6,0,Edgecombe,2022-02-13
0,11,0,11,0,Edgecombe,2022-02-17
0,6,2,4,0,Edgecombe,2022-02-19
0,3,1,2,0,Edgecombe,2022-02-20
0,8,0,8,0,Edgecombe,2022-02-22
0,1,0,1,0,Edgecombe,2022-02-27
0,9,6,3,0,Edgecombe,2022-02-28
0,9,1,8,0,Edgecombe,2022-03-02
0,5,0,5,0,Edgecombe,2022-03-03
0,5,3,2,0,Edgecombe,2022-03-04
0,1,0,1,0,Edgecombe,2022-03-05
0,2,0,2,0,Edgecombe,2022-03-08
0,1,0,1,0,Edgecombe,2022-03-10
0,1,0,1,0,Edgecombe,2022-03-11
0,1,0,1,0,Edgecombe,2022-03-13
0,3,1,2,0,Edgecombe,2022-03-16
0,3,1,2,0,Edgecombe,2022-03-17
0,3,1,2,0,Edgecombe,2022-03-18
0,1,0,1,0,Edgecombe,2022-03-19
0,1,0,1,0,Edgecombe,2022-03-22
0,1,0,1,0,Edgecombe,2022-03-25
0,1,0,1,0,Edgecombe,2022-03-27
0,1,0,1,0,Edgecombe,2022-03-29
0,2,0,2,0,Edgecombe,2022-03-30
0,2,0,2,0,Edgecombe,2022-03-31
0,1,0,1,0,Edgecombe,2022-04-06
0,1,0,1,0,Edgecombe,2022-04-08
0,3,0,3,0,Edgecombe,2022-04-12
0,1,0,1,0,Edgecombe,2022-04-13
0,6,6,0,0,Edgecombe,2022-04-14
0,1,1,0,0,Edgecombe,2022-04-17
0,2,0,2,0,Edgecombe,2022-04-21
0,7,1,6,0,Edgecombe,2022-04-22
0,2,0,2,0,Edgecombe,2022-04-23
0,5,1,4,0,Edgecombe,2022-04-25
0,5,1,4,0,Edgecombe,2022-04-26
0,5,3,2,0,Edgecombe,2022-04-28
0,1,1,0,0,Edgecombe,2022-04-29
0,3,0,3,0,Edgecombe,2022-04-30
0,1,1,0,0,Edgecombe,2022-05-01
0,4,1,3,0,Edgecombe,2022-05-06
0,2,0,2,0,Edgecombe,2022-05-07
0,2,0,2,0,Edgecombe,2022-05-08
0,5,1,4,0,Edgecombe,2022-05-14
0,5,3,2,0,Edgecombe,2022-05-15
0,8,0,8,0,Edgecombe,2022-05-17
0,10,0,10,0,Edgecombe,2022-05-20
0,15,4,11,0,Edgecombe,2022-06-05
1,16,0,16,0,Edgecombe,2021-12-14
1,19,1,18,0,Edgecombe,2021-12-17
1,28,0,28,0,Edgecombe,2021-12-21
1,35,2,33,0,Edgecombe,2021-12-26
1,17,2,15,0,Edgecombe,2022-01-16
1,17,1,16,0,Edgecombe,2022-01-22
1,27,4,23,0,Edgecombe,2022-01-23
1,11,0,11,0,Edgecombe,2022-01-29
1,25,1,24,0,Edgecombe,2022-02-09
1,17,1,16,0,Edgecombe,2022-02-10
1,13,1,12,0,Edgecombe,2022-02-16
1,4,0,4,0,Edgecombe,2022-02-23
1,4,0,4,0,Edgecombe,2022-02-26
1,4,0,4,0,Edgecombe,2022-03-01
1,3,1,2,0,Edgecombe,2022-03-09
1,5,0,5,0,Edgecombe,2022-03-15
1,6,4,2,0,Edgecombe,2022-03-21
1,2,1,1,0,Edgecombe,2022-03-24
1,2,2,0,0,Edgecombe,2022-03-28
1,2,0,2,0,Edgecombe,2022-04-05
1,2,0,2,0,Edgecombe,2022-04-09
1,3,3,0,0,Edgecombe,2022-04-11
1,4,0,4,0,Edgecombe,2022-04-19
1,2,0,2,0,Edgecombe,2022-04-24
1,7,3,4,0,Edgecombe,2022-05-03
1,7,2,5,0,Edgecombe,2022-05-04
1,1,0,1,0,Edgecombe,2022-05-05
1,8,0,8,0,Edgecombe,2022-05-10
1,15,4,11,0,Edgecombe,2022-05-12
1,8,2,6,0,Edgecombe,2022-05-21
1,11,2,9,0,Edgecombe,2022-05-22
1,14,0,14,0,Edgecombe,2022-05-24
1,7,1,6,0,Edgecombe,2022-05-28
1,12,1,11,0,Edgecombe,2022-05-30
1,12,2,10,0,Edgecombe,2022-06-03
1,19,2,17,0,Edgecombe,2022-06-07
2,9,2,7,0,Edgecombe,2021-12-19
2,51,3,48,0,Edgecombe,2021-12-23
2,14,0,14,0,Edgecombe,2022-02-15
2,9,1,8,0,Edgecombe,2022-02-18
2,8,5,3,0,Edgecombe,2022-02-24
2,11,8,3,0,Edgecombe,2022-03-14
2,5,2,3,0,Edgecombe,2022-04-18
2,12,1,11,0,Edgecombe,2022-05-09
2,9,2,7,0,Edgecombe,2022-05-11
2,16,0,16,0,Edgecombe,2022-05-16
2,10,1,9,0,Edgecombe,2022-05-18
2,18,0,18,0,Edgecombe,2022-05-23
2,20,3,17,0,Edgecombe,2022-05-25
2,13,1,12,0,Edgecombe,2022-05-29
3,26,6,20,0,Edgecombe,2021-12-25
3,54,0,54,0,Edgecombe,2022-01-08
3,29,2,27,0,Edgecombe,2022-02-04
3,13,1,12,0,Edgecombe,2022-02-11
3,11,1,10,0,Edgecombe,2022-06-04
3,21,2,19,0,Edgecombe,2022-06-08
3,27,7,20,0,Edgecombe,2022-06-09
3,12,2,10,0,Edgecombe,2022-06-10
3,9,2,7,0,Edgecombe,2022-06-11
4,36,4,32,0,Edgecombe,2021-12-22
4,56,1,55,0,Edgecombe,2022-01-01
4,17,1,16,0,Edgecombe,2022-01-21
4,63,4,59,0,Edgecombe,2022-01-26
4,67,0,67,0,Edgecombe,2022-01-27
4,16,3,13,0,Edgecombe,2022-05-19
4,12,2,10,0,Edgecombe,2022-05-26
4,27,5,22,0,Edgecombe,2022-05-31
4,30,5,25,0,Edgecombe,2022-06-02
5,60,2,58,0,Edgecombe,2022-01-02
5,11,0,11,0,Edgecombe,2022-05-13
5,14,3,11,0,Edgecombe,2022-05-27
6,60,0,60,0,Edgecombe,2022-01-15
6,79,12,67,0,Edgecombe,2022-01-17
6,27,2,25,0,Edgecombe,2022-06-01
7,57,2,55,0,Edgecombe,2022-01-31
7,46,2,44,0,Edgecombe,2022-02-02
7,19,1,18,0,Edgecombe,2022-06-06
11,121,5,116,0,Edgecombe,2021-12-27
11,118,3,115,0,Edgecombe,2022-01-20
13,143,4,139,0,Edgecombe,2021-12-31
13,124,7,117,0,Edgecombe,2022-01-24
15,170,12,158,0,Edgecombe,2021-12-28
18,171,8,163,0,Edgecombe,2021-12-29
21,245,4,241,0,Edgecombe,2022-01-06
25,150,6,144,0,Edgecombe,2022-01-19
27,274,10,264,0,Edgecombe,2022-01-10
28,289,13,276,0,Edgecombe,2022-01-03
29,286,11,275,0,Edgecombe,2022-01-04
0,19,2,17,0,Forsyth,2022-03-05
0,12,3,9,0,Forsyth,2022-03-13
0,8,0,8,0,Forsyth,2022-03-20
0,8,5,3,0,Forsyth,2022-03-27
0,20,5,15,0,Forsyth,2022-03-28
0,7,1,6,0,Forsyth,2022-04-01
0,6,1,5,0,Forsyth,2022-04-03
1,10,1,9,0,Forsyth,2022-03-19
1,17,4,13,0,Forsyth,2022-03-22
1,9,2,7,0,Forsyth,2022-03-26
1,18,5,13,0,Forsyth,2022-04-10
1,33,8,25,0,Forsyth,2022-04-11
1,37,2,35,0,Forsyth,2022-04-13
1,23,6,17,0,Forsyth,2022-04-16
1,20,5,15,0,Forsyth,2022-04-17
2,146,21,125,0,Forsyth,2021-12-15
2,15,3,12,0,Forsyth,2022-03-16
2,15,4,11,0,Forsyth,2022-03-18
2,22,6,16,0,Forsyth,2022-03-24
2,13,3,10,0,Forsyth,2022-03-25
2,27,5,22,0,Forsyth,2022-03-31
2,38,9,29,0,Forsyth,2022-04-07
2,23,3,20,0,Forsyth,2022-04-08
2,36,7,29,0,Forsyth,2022-04-24
2,44,7,37,0,Forsyth,2022-05-01
3,114,9,105,0,Forsyth,2021-12-14
3,27,3,24,0,Forsyth,2022-03-29
3,33,7,26,0,Forsyth,2022-04-05
3,21,5,16,0,Forsyth,2022-04-09
3,36,6,30,0,Forsyth,2022-04-15
3,55,5,50,0,Forsyth,2022-04-22
3,41,9,32,0,Forsyth,2022-04-23
3,57,12,45,0,Forsyth,2022-04-30
4,24,5,19,0,Forsyth,2022-04-06
4,41,6,35,0,Forsyth,2022-04-12
4,55,14,41,0,Forsyth,2022-04-20
4,69,20,49,0,Forsyth,2022-04-21
4,78,25,53,0,Forsyth,2022-04-26
4,85,14,71,0,Forsyth,2022-05-22
5,62,5,57,0,Forsyth,2022-02-24
5,78,22,56,0,Forsyth,2022-04-19
5,70,12,58,0,Forsyth,2022-06-04
6,51,10,41,0,Forsyth,2022-04-14
6,65,20,45,0,Forsyth,2022-05-07
6,58,12,46,0,Forsyth,2022-05-30
7,59,14,45,0,Forsyth,2022-04-18
7,74,7,67,0,Forsyth,2022-06-05
7,76,11,65,0,Forsyth,2022-06-11
9,113,29,84,0,Forsyth,2022-04-27
9,87,20,67,0,Forsyth,2022-04-29
9,144,31,113,0,Forsyth,2022-05-12
9,91,9,82,0,Forsyth,2022-05-14
10,125,28,97,0,Forsyth,2022-05-04
10,170,38,132,0,Forsyth,2022-05-13
11,218,21,197,0,Forsyth,2021-12-26
11,113,27,86,0,Forsyth,2022-05-03
11,148,33,115,0,Forsyth,2022-05-11
11,99,17,82,0,Forsyth,2022-05-29
12,149,37,112,0,Forsyth,2022-05-09
12,85,15,70,0,Forsyth,2022-05-15
13,123,32,91,0,Forsyth,2022-06-09
14,211,44,167,0,Forsyth,2022-05-18
14,151,36,115,0,Forsyth,2022-05-20
15,131,30,101,0,Forsyth,2022-05-06
15,151,26,125,0,Forsyth,2022-05-10
15,189,27,162,0,Forsyth,2022-05-17
15,183,29,154,0,Forsyth,2022-05-27
16,129,30,99,0,Forsyth,2022-05-05
16,215,62,153,0,Forsyth,2022-05-23
17,199,34,165,0,Forsyth,2022-06-01
17,167,33,134,0,Forsyth,2022-06-02
18,184,48,136,0,Forsyth,2022-05-26
18,153,26,127,0,Forsyth,2022-06-03
19,151,30,121,0,Forsyth,2022-06-08
19,125,23,102,0,Forsyth,2022-06-10
20,193,40,153,0,Forsyth,2022-05-24
28,202,47,155,0,Forsyth,2022-06-06
30,401,68,333,0,Forsyth,2022-02-01
30,368,48,320,0,Forsyth,2022-02-02
43,586,68,518,0,Forsyth,2021-12-31
90,1216,152,1064,0,Forsyth,2022-01-04
,0,0,0,0,Franklin,2022-03-13
0,30,3,27,0,Franklin,2021-12-14
0,26,0,26,0,Franklin,2021-12-15
0,18,0,18,0,Franklin,2021-12-16
0,31,2,29,0,Franklin,2021-12-17
0,17,0,17,0,Franklin,2021-12-18
0,9,1,8,0,Franklin,2021-12-19
0,6,0,6,0,Franklin,2021-12-25
0,3,0,3,0,Franklin,2022-03-05
0,6,1,5,0,Franklin,2022-03-08
0,3,0,3,0,Franklin,2022-03-10
0,1,0,1,0,Franklin,2022-03-11
0,1,1,0,0,Franklin,2022-03-12
0,1,0,1,0,Franklin,2022-03-15
0,2,1,1,0,Franklin,2022-03-17
0,1,0,1,0,Franklin,2022-03-19
0,2,0,2,0,Franklin,2022-03-20
0,4,0,4,0,Franklin,2022-03-21
0,1,0,1,0,Franklin,2022-03-23
0,2,0,2,0,Franklin,2022-03-24
0,1,0,1,0,Franklin,2022-03-25
0,1,0,1,0,Franklin,2022-03-26
0,1,0,1,0,Franklin,2022-03-29
0,5,0,5,0,Franklin,2022-03-30
0,1,0,1,0,Franklin,2022-04-01
0,1,0,1,0,Franklin,2022-04-03
0,4,0,4,0,Franklin,2022-04-04
0,2,0,2,0,Franklin,2022-04-05
0,3,0,3,0,Franklin,2022-04-07
0,7,0,7,0,Franklin,2022-04-08
0,5,1,4,0,Franklin,2022-04-09
0,2,0,2,0,Franklin,2022-04-10
0,4,0,4,0,Franklin,2022-04-11
0,10,0,10,0,Franklin,2022-04-13
0,12,0,12,0,Franklin,2022-04-19
0,12,0,12,0,Franklin,2022-04-22
0,6,0,6,0,Franklin,2022-04-24
0,11,2,9,0,Franklin,2022-04-29
0,24,4,20,0,Franklin,2022-05-29
0,9,5,4,0,Franklin,2022-05-30
1,32,3,29,0,Franklin,2021-12-20
1,56,0,56,0,Franklin,2021-12-23
1,36,4,32,0,Franklin,2021-12-26
1,16,2,14,0,Franklin,2022-02-12
1,12,1,11,0,Franklin,2022-02-20
1,15,1,14,0,Franklin,2022-02-25
1,5,0,5,0,Franklin,2022-02-26
1,16,2,14,0,Franklin,2022-02-28
1,6,2,4,0,Franklin,2022-03-01
1,8,1,7,0,Franklin,2022-03-03
1,1,0,1,0,Franklin,2022-03-16
1,1,1,0,0,Franklin,2022-03-18
1,3,0,3,0,Franklin,2022-03-28
1,4,1,3,0,Franklin,2022-03-31
1,2,0,2,0,Franklin,2022-04-02
1,1,0,1,0,Franklin,2022-04-06
1,10,3,7,0,Franklin,2022-04-12
1,14,2,12,0,Franklin,2022-04-14
1,4,1,3,0,Franklin,2022-04-17
1,18,1,17,0,Franklin,2022-04-18
1,14,3,11,0,Franklin,2022-04-21
1,13,2,11,0,Franklin,2022-04-26
1,8,0,8,0,Franklin,2022-04-28
1,12,3,9,0,Franklin,2022-04-30
1,11,3,8,0,Franklin,2022-05-01
1,17,2,15,0,Franklin,2022-05-07
1,9,0,9,0,Franklin,2022-05-08
1,14,1,13,0,Franklin,2022-05-21
1,19,0,19,0,Franklin,2022-05-22
1,22,4,18,0,Franklin,2022-05-27
1,6,1,5,0,Franklin,2022-06-05
1,25,5,20,0,Franklin,2022-06-07
2,42,3,39,0,Franklin,2021-12-22
2,22,4,18,0,Franklin,2021-12-24
2,42,7,35,0,Franklin,2022-01-23
2,45,6,39,0,Franklin,2022-02-05
2,29,2,27,0,Franklin,2022-02-15
2,36,3,33,0,Franklin,2022-02-16
2,14,1,13,0,Franklin,2022-02-22
2,6,2,4,0,Franklin,2022-03-04
2,13,5,8,0,Franklin,2022-04-15
2,11,1,10,0,Franklin,2022-04-16
2,9,2,7,0,Franklin,2022-04-20
2,8,1,7,0,Franklin,2022-04-23
2,19,1,18,0,Franklin,2022-05-06
2,33,4,29,0,Franklin,2022-05-14
2,22,1,21,0,Franklin,2022-05-28
2,41,3,38,0,Franklin,2022-06-01
2,17,1,16,0,Franklin,2022-06-04
2,24,0,24,0,Franklin,2022-06-08
2,27,3,24,0,Franklin,2022-06-10
3,31,2,29,0,Franklin,2022-02-06
3,16,4,12,0,Franklin,2022-02-13
3,16,2,14,0,Franklin,2022-02-18
3,23,7,16,0,Franklin,2022-02-21
3,14,2,12,0,Franklin,2022-04-27
3,19,1,18,0,Franklin,2022-05-04
3,21,0,21,0,Franklin,2022-05-05
3,38,5,33,0,Franklin,2022-06-02
3,28,6,22,0,Franklin,2022-06-03
3,37,1,36,0,Franklin,2022-06-06
3,32,4,28,0,Franklin,2022-06-09
4,44,7,37,0,Franklin,2022-02-14
4,23,1,22,0,Franklin,2022-02-23
4,12,1,11,0,Franklin,2022-03-07
4,10,2,8,0,Franklin,2022-03-09
4,6,0,6,0,Franklin,2022-03-22
4,36,0,36,0,Franklin,2022-04-25
4,25,3,22,0,Franklin,2022-05-02
4,24,1,23,0,Franklin,2022-05-13
4,34,1,33,0,Franklin,2022-05-20
4,54,4,50,0,Franklin,2022-05-23
4,17,2,15,0,Franklin,2022-06-11
5,60,3,57,0,Franklin,2022-01-02
5,39,3,36,0,Franklin,2022-01-22
5,47,3,44,0,Franklin,2022-01-29
5,47,8,39,0,Franklin,2022-02-11
5,50,4,46,0,Franklin,2022-05-10
5,37,6,31,0,Franklin,2022-05-19
6,91,11,80,0,Franklin,2022-02-02
6,37,7,30,0,Franklin,2022-05-16
6,58,1,57,0,Franklin,2022-05-18
6,56,2,54,0,Franklin,2022-05-24
7,118,13,105,0,Franklin,2021-12-31
7,29,2,27,0,Franklin,2022-05-15
8,85,12,73,0,Franklin,2022-01-09
8,98,9,89,0,Franklin,2022-01-21
8,66,13,53,0,Franklin,2022-02-08
8,43,2,41,0,Franklin,2022-05-11
8,48,2,46,0,Franklin,2022-05-25
9,229,12,217,0,Franklin,2022-01-25
9,40,6,34,0,Franklin,2022-05-12
10,158,14,144,0,Franklin,2021-12-27
11,162,6,156,0,Franklin,2022-01-27
12,238,32,206,0,Franklin,2022-01-17
12,203,12,191,0,Franklin,2022-01-26
12,98,4,94,0,Franklin,2022-02-01
12,77,6,71,0,Franklin,2022-02-03
12,47,7,40,0,Franklin,2022-05-26
13,155,4,151,0,Franklin,2022-01-28
14,61,4,57,0,Franklin,2022-05-31
15,216,12,204,0,Franklin,2021-12-28
16,203,12,191,0,Franklin,2022-01-15
20,213,9,204,0,Franklin,2021-12-29
20,199,27,172,0,Franklin,2021-12-30
20,179,8,171,0,Franklin,2022-01-08
21,336,6,330,0,Franklin,2022-01-06
21,314,9,305,0,Franklin,2022-01-20
24,388,15,373,0,Franklin,2022-01-12
25,171,9,162,0,Franklin,2022-01-31
26,292,27,265,0,Franklin,2022-01-03
28,390,25,365,0,Franklin,2022-01-04
32,287,12,275,0,Franklin,2022-01-07
35,345,17,328,0,Franklin,2022-01-13
42,442,19,423,0,Franklin,2022-01-10
47,408,19,389,0,Franklin,2022-01-11
48,549,27,522,0,Franklin,2022-01-18
0,7,2,5,0,Gaston,2022-03-04
0,9,2,7,0,Gaston,2022-03-09
0,11,1,10,0,Gaston,2022-03-10
0,5,1,4,0,Gaston,2022-03-18
0,2,1,1,0,Gaston,2022-03-19
0,3,0,3,0,Gaston,2022-03-20
0,1,0,1,0,Gaston,2022-03-22
0,8,2,6,0,Gaston,2022-03-23
0,2,0,2,0,Gaston,2022-03-24
0,3,0,3,0,Gaston,2022-03-26
0,3,0,3,0,Gaston,2022-03-27
0,8,4,4,0,Gaston,2022-04-01
0,4,3,1,0,Gaston,2022-04-02
0,17,7,10,0,Gaston,2022-04-14
0,17,1,16,0,Gaston,2022-04-22
1,9,5,4,0,Gaston,2022-03-29
1,7,2,5,0,Gaston,2022-04-03
1,11,6,5,0,Gaston,2022-04-06
1,26,9,17,0,Gaston,2022-04-13
1,15,3,12,0,Gaston,2022-04-16
1,5,0,5,0,Gaston,2022-04-17
1,21,5,16,0,Gaston,2022-04-18
1,14,0,14,0,Gaston,2022-04-19
1,12,2,10,0,Gaston,2022-04-24
1,21,4,17,0,Gaston,2022-05-01
1,20,5,15,0,Gaston,2022-05-07
2,76,15,61,0,Gaston,2021-12-18
2,14,3,11,0,Gaston,2022-02-26
2,18,3,15,0,Gaston,2022-02-28
2,7,3,4,0,Gaston,2022-03-05
2,11,2,9,0,Gaston,2022-03-31
2,15,7,8,0,Gaston,2022-04-04
2,20,5,15,0,Gaston,2022-04-08
2,9,2,7,0,Gaston,2022-04-10
2,21,4,17,0,Gaston,2022-04-21
2,27,3,24,0,Gaston,2022-04-30
2,23,3,20,0,Gaston,2022-05-08
2,34,3,31,0,Gaston,2022-05-14
3,14,0,14,0,Gaston,2022-03-21
3,20,7,13,0,Gaston,2022-04-23
3,25,2,23,0,Gaston,2022-04-27
3,33,7,26,0,Gaston,2022-05-04
3,73,11,62,0,Gaston,2022-05-10
4,17,2,15,0,Gaston,2022-04-11
4,12,2,10,0,Gaston,2022-04-15
4,46,8,38,0,Gaston,2022-05-02
4,50,8,42,0,Gaston,2022-05-06
4,43,3,40,0,Gaston,2022-05-22
4,42,5,37,0,Gaston,2022-05-28
4,27,5,22,0,Gaston,2022-05-30
5,22,5,17,0,Gaston,2022-04-20
5,26,9,17,0,Gaston,2022-04-25
5,39,5,34,0,Gaston,2022-05-05
5,60,9,51,0,Gaston,2022-05-12
5,39,2,37,0,Gaston,2022-05-15
5,84,26,58,0,Gaston,2022-05-23
5,58,12,46,0,Gaston,2022-05-27
5,38,2,36,0,Gaston,2022-06-05
5,45,2,43,0,Gaston,2022-06-11
6,60,6,54,0,Gaston,2022-05-13
6,56,14,42,0,Gaston,2022-05-20
7,161,35,126,0,Gaston,2022-01-01
7,42,11,31,0,Gaston,2022-04-26
7,29,6,23,0,Gaston,2022-04-29
7,59,15,44,0,Gaston,2022-05-09
7,87,16,71,0,Gaston,2022-05-18
7,49,5,44,0,Gaston,2022-06-04
7,66,10,56,0,Gaston,2022-06-10
8,56,12,44,0,Gaston,2022-02-18
8,76,15,61,0,Gaston,2022-05-24
8,74,8,66,0,Gaston,2022-06-09
9,52,12,40,0,Gaston,2022-05-26
10,75,11,64,0,Gaston,2022-06-08
11,120,29,91,0,Gaston,2022-02-11
11,83,10,73,0,Gaston,2022-05-16
11,81,12,69,0,Gaston,2022-05-19
13,241,47,194,0,Gaston,2022-02-02
13,102,22,80,0,Gaston,2022-05-31
13,88,14,74,0,Gaston,2022-06-02
13,75,12,63,0,Gaston,2022-06-07
15,207,43,164,0,Gaston,2021-12-22
30,397,72,325,0,Gaston,2021-12-27
41,485,83,402,0,Gaston,2021-12-29
53,592,98,494,0,Gaston,2021-12-28
,0,0,0,0,Gates,2022-01-29
,0,0,0,0,Gates,2022-02-05
,0,0,0,0,Gates,2022-02-06
,0,0,0,0,Gates,2022-02-11
,0,0,0,0,Gates,2022-02-12
,0,0,0,0,Gates,2022-02-13
,0,0,0,0,Gates,2022-02-15
,0,0,0,0,Gates,2022-02-19
,0,0,0,0,Gates,2022-02-26
,0,0,0,0,Gates,2022-02-27
,0,0,0,0,Gates,2022-03-01
,0,0,0,0,Gates,2022-03-03
,0,0,0,0,Gates,2022-03-04
,0,0,0,0,Gates,2022-03-05
,0,0,0,0,Gates,2022-03-06
,0,0,0,0,Gates,2022-03-07
,0,0,0,0,Gates,2022-03-08
,0,0,0,0,Gates,2022-03-09
,0,0,0,0,Gates,2022-03-10
,0,0,0,0,Gates,2022-03-11
,0,0,0,0,Gates,2022-03-12
,0,0,0,0,Gates,2022-03-13
,0,0,0,0,Gates,2022-03-14
,0,0,0,0,Gates,2022-03-15
,0,0,0,0,Gates,2022-03-16
,0,0,0,0,Gates,2022-03-17
,0,0,0,0,Gates,2022-03-18
,0,0,0,0,Gates,2022-03-19
,0,0,0,0,Gates,2022-03-21
,0,0,0,0,Gates,2022-03-22
,0,0,0,0,Gates,2022-03-23
,0,0,0,0,Gates,2022-03-24
,0,0,0,0,Gates,2022-03-25
,0,0,0,0,Gates,2022-03-26
,0,0,0,0,Gates,2022-03-28
,0,0,0,0,Gates,2022-03-29
,0,0,0,0,Gates,2022-03-31
,0,0,0,0,Gates,2022-04-02
,0,0,0,0,Gates,2022-04-03
,0,0,0,0,Gates,2022-04-04
,0,0,0,0,Gates,2022-04-05
,0,0,0,0,Gates,2022-04-06
,0,0,0,0,Gates,2022-04-07
,0,0,0,0,Gates,2022-04-08
,0,0,0,0,Gates,2022-04-10
,0,0,0,0,Gates,2022-04-11
,0,0,0,0,Gates,2022-04-13
,0,0,0,0,Gates,2022-04-14
,0,0,0,0,Gates,2022-04-15
,0,0,0,0,Gates,2022-04-16
,0,0,0,0,Gates,2022-04-17
,0,0,0,0,Gates,2022-04-18
,0,0,0,0,Gates,2022-04-19
,0,0,0,0,Gates,2022-04-20
,0,0,0,0,Gates,2022-04-23
,0,0,0,0,Gates,2022-04-24
,0,0,0,0,Gates,2022-04-26
,0,0,0,0,Gates,2022-04-27
,0,0,0,0,Gates,2022-04-28
,0,0,0,0,Gates,2022-04-29
,0,0,0,0,Gates,2022-05-01
,0,0,0,0,Gates,2022-05-08
,0,0,0,0,Gates,2022-05-09
,0,0,0,0,Gates,2022-05-25
,0,0,0,0,Gates,2022-05-27
,0,0,0,0,Gates,2022-05-29
,0,0,0,0,Gates,2022-06-05
0,4,1,3,0,Gates,2021-12-14
0,3,0,3,0,Gates,2021-12-15
0,4,3,1,0,Gates,2021-12-16
0,2,1,1,0,Gates,2021-12-18
0,4,1,3,0,Gates,2021-12-19
0,6,0,6,0,Gates,2021-12-20
0,8,0,8,0,Gates,2021-12-23
0,2,1,1,0,Gates,2021-12-24
0,7,2,5,0,Gates,2021-12-25
0,17,3,14,0,Gates,2021-12-29
0,12,1,11,0,Gates,2021-12-31
0,1,0,1,0,Gates,2022-01-02
0,18,4,14,0,Gates,2022-01-05
0,23,7,16,0,Gates,2022-01-06
0,26,2,24,0,Gates,2022-01-13
0,10,6,4,0,Gates,2022-01-15
0,5,2,3,0,Gates,2022-01-16
0,17,6,11,0,Gates,2022-01-17
0,46,8,38,0,Gates,2022-01-18
0,9,2,7,0,Gates,2022-01-21
0,6,2,4,0,Gates,2022-01-23
0,21,4,17,0,Gates,2022-01-24
0,14,1,13,0,Gates,2022-01-26
0,7,0,7,0,Gates,2022-01-27
0,4,0,4,0,Gates,2022-01-28
0,2,0,2,0,Gates,2022-01-30
0,8,1,7,0,Gates,2022-02-01
0,5,2,3,0,Gates,2022-02-03
0,8,2,6,0,Gates,2022-02-04
0,1,0,1,0,Gates,2022-02-07
0,3,1,2,0,Gates,2022-02-08
0,1,1,0,0,Gates,2022-02-09
0,1,0,1,0,Gates,2022-02-10
0,3,3,0,0,Gates,2022-02-14
0,1,0,1,0,Gates,2022-02-16
0,2,0,2,0,Gates,2022-02-17
0,3,0,3,0,Gates,2022-02-18
0,2,0,2,0,Gates,2022-02-20
0,4,0,4,0,Gates,2022-02-21
0,1,0,1,0,Gates,2022-02-22
0,1,0,1,0,Gates,2022-02-23
0,1,0,1,0,Gates,2022-02-24
0,1,0,1,0,Gates,2022-02-25
0,2,0,2,0,Gates,2022-02-28
0,1,0,1,0,Gates,2022-03-02
0,1,1,0,0,Gates,2022-03-20
0,1,0,1,0,Gates,2022-03-27
0,1,0,1,0,Gates,2022-03-30
0,1,1,0,0,Gates,2022-04-01
0,1,0,1,0,Gates,2022-04-09
0,1,0,1,0,Gates,2022-04-12
0,1,0,1,0,Gates,2022-04-21
0,1,0,1,0,Gates,2022-04-22
0,1,0,1,0,Gates,2022-04-30
0,2,1,1,0,Gates,2022-05-03
0,1,0,1,0,Gates,2022-05-04
0,1,0,1,0,Gates,2022-05-06
0,2,2,0,0,Gates,2022-05-07
0,3,0,3,0,Gates,2022-05-10
0,3,1,2,0,Gates,2022-05-11
0,1,0,1,0,Gates,2022-05-12
0,1,1,0,0,Gates,2022-05-13
0,3,1,2,0,Gates,2022-05-14
0,1,1,0,0,Gates,2022-05-15
0,3,1,2,0,Gates,2022-05-16
0,3,0,3,0,Gates,2022-05-18
0,3,1,2,0,Gates,2022-05-19
0,3,1,2,0,Gates,2022-05-20
0,1,0,1,0,Gates,2022-05-21
0,1,0,1,0,Gates,2022-05-22
0,3,0,3,0,Gates,2022-05-23
0,1,1,0,0,Gates,2022-05-26
0,1,1,0,0,Gates,2022-05-28
0,2,1,1,0,Gates,2022-05-30
0,5,4,1,0,Gates,2022-06-01
0,4,1,3,0,Gates,2022-06-02
0,1,1,0,0,Gates,2022-06-03
0,1,1,0,0,Gates,2022-06-06
0,2,1,1,0,Gates,2022-06-07
0,3,0,3,0,Gates,2022-06-08
1,3,0,3,0,Gates,2021-12-21
1,9,6,3,0,Gates,2021-12-22
1,15,5,10,0,Gates,2021-12-28
1,14,3,11,0,Gates,2021-12-30
1,3,0,3,0,Gates,2022-01-08
1,23,6,17,0,Gates,2022-01-20
1,6,2,4,0,Gates,2022-01-22
1,37,10,27,0,Gates,2022-01-25
1,3,0,3,0,Gates,2022-05-02
1,2,1,1,0,Gates,2022-05-24
1,2,2,0,0,Gates,2022-06-04
1,2,2,0,0,Gates,2022-06-09
1,3,3,0,0,Gates,2022-06-10
1,1,0,1,0,Gates,2022-06-11
2,14,8,6,0,Gates,2021-12-27
2,8,1,7,0,Gates,2022-01-01
2,19,7,12,0,Gates,2022-01-04
2,22,3,19,0,Gates,2022-01-19
2,12,2,10,0,Gates,2022-01-31
2,6,0,6,0,Gates,2022-02-02
3,41,16,25,0,Gates,2022-01-12
4,20,4,16,0,Gates,2022-01-03
5,64,32,32,0,Gates,2022-01-10
5,37,14,23,0,Gates,2022-01-11
,0,0,0,0,Graham,2021-12-19
,0,0,0,0,Graham,2021-12-24
,0,0,0,0,Graham,2022-02-19
,0,0,0,0,Graham,2022-02-25
,0,0,0,0,Graham,2022-02-26
,0,0,0,0,Graham,2022-02-27
,0,0,0,0,Graham,2022-03-05
,0,0,0,0,Graham,2022-03-06
,0,0,0,0,Graham,2022-03-08
,0,0,0,0,Graham,2022-03-09
,0,0,0,0,Graham,2022-03-10
,0,0,0,0,Graham,2022-03-11
,0,0,0,0,Graham,2022-03-12
,0,0,0,0,Graham,2022-03-13
,0,0,0,0,Graham,2022-03-14
,0,0,0,0,Graham,2022-03-15
,0,0,0,0,Graham,2022-03-17
,0,0,0,0,Graham,2022-03-18
,0,0,0,0,Graham,2022-03-19
,0,0,0,0,Graham,2022-03-21
,0,0,0,0,Graham,2022-03-22
,0,0,0,0,Graham,2022-03-23
,0,0,0,0,Graham,2022-03-25
,0,0,0,0,Graham,2022-03-26
,0,0,0,0,Graham,2022-03-30
,0,0,0,0,Graham,2022-03-31
,0,0,0,0,Graham,2022-04-01
,0,0,0,0,Graham,2022-04-02
,0,0,0,0,Graham,2022-04-03
,0,0,0,0,Graham,2022-04-04
,0,0,0,0,Graham,2022-04-05
,0,0,0,0,Graham,2022-04-06
,0,0,0,0,Graham,2022-04-08
,0,0,0,0,Graham,2022-04-09
,0,0,0,0,Graham,2022-04-10
,0,0,0,0,Graham,2022-04-13
,0,0,0,0,Graham,2022-04-14
,0,0,0,0,Graham,2022-04-15
,0,0,0,0,Graham,2022-04-16
,0,0,0,0,Graham,2022-04-17
,0,0,0,0,Graham,2022-04-21
,0,0,0,0,Graham,2022-04-24
,0,0,0,0,Graham,2022-04-26
,0,0,0,0,Graham,2022-04-27
,0,0,0,0,Graham,2022-04-28
,0,0,0,0,Graham,2022-04-30
,0,0,0,0,Graham,2022-05-01
,0,0,0,0,Graham,2022-05-03
,0,0,0,0,Graham,2022-05-04
,0,0,0,0,Graham,2022-05-05
,0,0,0,0,Graham,2022-05-06
,0,0,0,0,Graham,2022-05-07
,0,0,0,0,Graham,2022-05-14
,0,0,0,0,Graham,2022-05-15
,0,0,0,0,Graham,2022-05-16
,0,0,0,0,Graham,2022-05-17
,0,0,0,0,Graham,2022-05-21
,0,0,0,0,Graham,2022-05-22
,0,0,0,0,Graham,2022-05-23
,0,0,0,0,Graham,2022-05-27
,0,0,0,0,Graham,2022-05-29
,0,0,0,0,Graham,2022-06-03
,0,0,0,0,Graham,2022-06-04
,0,0,0,0,Graham,2022-06-11
0,3,2,1,0,Graham,2021-12-14
0,2,2,0,0,Graham,2021-12-16
0,1,1,0,0,Graham,2021-12-18
0,6,6,0,0,Graham,2021-12-20
0,1,0,1,0,Graham,2021-12-21
0,2,2,0,0,Graham,2021-12-22
0,7,6,1,0,Graham,2021-12-23
0,8,7,1,0,Graham,2021-12-28
0,15,13,2,0,Graham,2021-12-29
0,3,3,0,0,Graham,2022-01-01
0,9,4,5,0,Graham,2022-01-02
0,7,3,4,0,Graham,2022-01-03
0,15,11,4,0,Graham,2022-01-06
0,22,10,12,0,Graham,2022-01-12
0,3,2,1,0,Graham,2022-01-16
0,21,12,9,0,Graham,2022-01-26
0,4,0,4,0,Graham,2022-01-29
0,18,13,5,0,Graham,2022-02-01
0,7,3,4,0,Graham,2022-02-05
0,2,2,0,0,Graham,2022-02-06
0,6,5,1,0,Graham,2022-02-08
0,13,8,5,0,Graham,2022-02-09
0,3,3,0,0,Graham,2022-02-10
0,2,0,2,0,Graham,2022-02-12
0,3,2,1,0,Graham,2022-02-13
0,5,3,2,0,Graham,2022-02-17
0,2,2,0,0,Graham,2022-02-18
0,1,0,1,0,Graham,2022-02-20
0,2,2,0,0,Graham,2022-02-21
0,3,3,0,0,Graham,2022-02-22
0,3,2,1,0,Graham,2022-02-28
0,1,1,0,0,Graham,2022-03-01
0,1,1,0,0,Graham,2022-03-02
0,2,1,1,0,Graham,2022-03-03
0,1,1,0,0,Graham,2022-03-04
0,3,1,2,0,Graham,2022-03-07
0,1,0,1,0,Graham,2022-03-16
0,1,1,0,0,Graham,2022-03-20
0,1,1,0,0,Graham,2022-03-27
0,1,0,1,0,Graham,2022-03-28
0,1,0,1,0,Graham,2022-03-29
0,1,0,1,0,Graham,2022-04-07
0,1,0,1,0,Graham,2022-04-11
0,1,0,1,0,Graham,2022-04-12
0,3,2,1,0,Graham,2022-04-19
0,1,1,0,0,Graham,2022-04-22
0,1,0,1,0,Graham,2022-04-23
0,3,1,2,0,Graham,2022-04-25
0,2,1,1,0,Graham,2022-04-29
0,1,1,0,0,Graham,2022-05-02
0,1,0,1,0,Graham,2022-05-08
0,1,1,0,0,Graham,2022-05-10
0,3,2,1,0,Graham,2022-05-11
0,2,2,0,0,Graham,2022-05-12
0,2,2,0,0,Graham,2022-05-13
0,2,2,0,0,Graham,2022-05-18
0,2,2,0,0,Graham,2022-05-19
0,2,1,1,0,Graham,2022-05-20
0,1,1,0,0,Graham,2022-05-26
0,1,0,1,0,Graham,2022-05-28
0,2,1,1,0,Graham,2022-05-30
0,1,1,0,0,Graham,2022-05-31
0,1,1,0,0,Graham,2022-06-01
0,2,2,0,0,Graham,2022-06-05
0,4,3,1,0,Graham,2022-06-06
0,1,0,1,0,Graham,2022-06-07
0,2,2,0,0,Graham,2022-06-08
0,4,4,0,0,Graham,2022-06-09
1,9,7,2,0,Graham,2021-12-15
1,9,4,5,0,Graham,2021-12-17
1,3,1,2,0,Graham,2021-12-25
1,3,3,0,0,Graham,2021-12-26
1,7,3,4,0,Graham,2021-12-27
1,14,7,7,0,Graham,2021-12-30
1,10,6,4,0,Graham,2021-12-31
1,6,6,0,0,Graham,2022-01-05
1,6,2,4,0,Graham,2022-01-08
1,20,6,14,0,Graham,2022-01-13
1,12,10,2,0,Graham,2022-01-23
1,24,16,8,0,Graham,2022-01-28
1,8,7,1,0,Graham,2022-02-04
1,3,2,1,0,Graham,2022-02-11
1,8,4,4,0,Graham,2022-02-14
1,6,6,0,0,Graham,2022-02-16
1,3,2,1,0,Graham,2022-02-23
1,2,2,0,0,Graham,2022-02-24
1,6,6,0,0,Graham,2022-04-18
1,4,4,0,0,Graham,2022-04-20
1,4,2,2,0,Graham,2022-05-09
1,2,2,0,0,Graham,2022-05-24
1,2,2,0,0,Graham,2022-06-02
1,3,2,1,0,Graham,2022-06-10
2,17,15,2,0,Graham,2022-01-07
2,11,7,4,0,Graham,2022-01-09
2,30,23,7,0,Graham,2022-01-11
2,26,12,14,0,Graham,2022-01-14
2,13,7,6,0,Graham,2022-01-17
2,13,4,9,0,Graham,2022-01-22
2,29,15,14,0,Graham,2022-01-25
2,10,7,3,0,Graham,2022-01-30
2,14,13,1,0,Graham,2022-02-07
2,7,4,3,0,Graham,2022-02-15
3,24,20,4,0,Graham,2022-01-04
3,41,24,17,0,Graham,2022-01-19
3,35,19,16,0,Graham,2022-01-20
3,18,10,8,0,Graham,2022-01-27
3,30,22,8,0,Graham,2022-01-31
3,10,8,2,0,Graham,2022-02-03
4,53,17,36,0,Graham,2022-01-24
5,39,27,12,0,Graham,2022-01-18
5,33,23,10,0,Graham,2022-01-21
5,7,6,1,0,Graham,2022-05-25
8,26,19,7,0,Graham,2022-02-02
,0,0,0,0,Granville,2022-03-19
,0,0,0,0,Granville,2022-03-20
,0,0,0,0,Granville,2022-03-27
,0,0,0,0,Granville,2022-03-30
,0,0,0,0,Granville,2022-04-03
0,21,2,19,0,Granville,2021-12-14
0,16,2,14,0,Granville,2021-12-18
0,16,3,13,0,Granville,2021-12-19
0,22,9,13,0,Granville,2021-12-24
0,23,3,20,0,Granville,2022-02-06
0,13,1,12,0,Granville,2022-02-18
0,9,0,9,0,Granville,2022-02-19
0,4,0,4,0,Granville,2022-02-20
0,10,2,8,0,Granville,2022-02-22
0,9,3,6,0,Granville,2022-02-23
0,10,1,9,0,Granville,2022-02-24
0,3,0,3,0,Granville,2022-02-25
0,3,0,3,0,Granville,2022-02-27
0,3,0,3,0,Granville,2022-03-04
0,2,1,1,0,Granville,2022-03-05
0,6,0,6,0,Granville,2022-03-07
0,5,2,3,0,Granville,2022-03-09
0,2,0,2,0,Granville,2022-03-10
0,2,2,0,0,Granville,2022-03-11
0,1,0,1,0,Granville,2022-03-12
0,2,1,1,0,Granville,2022-03-13
0,3,0,3,0,Granville,2022-03-14
0,3,0,3,0,Granville,2022-03-15
0,1,0,1,0,Granville,2022-03-16
0,1,0,1,0,Granville,2022-03-17
0,3,0,3,0,Granville,2022-03-18
0,2,1,1,0,Granville,2022-03-22
0,1,0,1,0,Granville,2022-03-26
0,1,0,1,0,Granville,2022-03-28
0,2,0,2,0,Granville,2022-03-29
0,1,0,1,0,Granville,2022-04-01
0,1,1,0,0,Granville,2022-04-02
0,4,3,1,0,Granville,2022-04-05
0,4,1,3,0,Granville,2022-04-06
0,5,2,3,0,Granville,2022-04-08
0,3,2,1,0,Granville,2022-04-10
0,10,2,8,0,Granville,2022-04-14
0,3,0,3,0,Granville,2022-04-15
0,10,0,10,0,Granville,2022-04-16
0,4,0,4,0,Granville,2022-04-17
0,9,2,7,0,Granville,2022-04-20
0,6,0,6,0,Granville,2022-04-22
0,5,1,4,0,Granville,2022-04-23
0,5,1,4,0,Granville,2022-04-24
0,13,6,7,0,Granville,2022-04-25
0,8,0,8,0,Granville,2022-04-30
0,5,2,3,0,Granville,2022-05-01
0,5,0,5,0,Granville,2022-05-06
0,9,0,9,0,Granville,2022-05-07
0,7,1,6,0,Granville,2022-05-08
0,16,1,15,0,Granville,2022-05-10
0,25,7,18,0,Granville,2022-05-13
0,15,2,13,0,Granville,2022-05-14
0,33,10,23,0,Granville,2022-05-25
0,10,3,7,0,Granville,2022-05-30
0,33,3,30,0,Granville,2022-06-01
0,4,0,4,0,Granville,2022-06-04
1,21,7,14,0,Granville,2021-12-16
1,28,4,24,0,Granville,2021-12-20
1,16,6,10,0,Granville,2021-12-25
1,35,1,34,0,Granville,2022-01-29
1,27,5,22,0,Granville,2022-02-11
1,12,3,9,0,Granville,2022-02-12
1,13,0,13,0,Granville,2022-02-13
1,5,0,5,0,Granville,2022-02-26
1,8,0,8,0,Granville,2022-03-02
1,3,1,2,0,Granville,2022-03-21
1,3,0,3,0,Granville,2022-03-25
1,2,0,2,0,Granville,2022-03-31
1,3,1,2,0,Granville,2022-04-04
1,7,2,5,0,Granville,2022-04-07
1,3,0,3,0,Granville,2022-04-09
1,6,2,4,0,Granville,2022-04-13
1,5,1,4,0,Granville,2022-04-18
1,7,2,5,0,Granville,2022-04-19
1,14,3,11,0,Granville,2022-04-26
1,12,5,7,0,Granville,2022-04-27
1,12,3,9,0,Granville,2022-04-28
1,21,4,17,0,Granville,2022-05-19
1,25,8,17,0,Granville,2022-05-20
1,11,6,5,0,Granville,2022-05-28
1,13,4,9,0,Granville,2022-05-29
2,23,10,13,0,Granville,2021-12-15
2,31,10,21,0,Granville,2021-12-22
2,42,7,35,0,Granville,2021-12-26
2,42,8,34,0,Granville,2022-01-01
2,42,3,39,0,Granville,2022-01-22
2,56,7,49,0,Granville,2022-01-23
2,47,4,43,0,Granville,2022-02-04
2,11,2,9,0,Granville,2022-02-28
2,14,3,11,0,Granville,2022-03-01
2,10,5,5,0,Granville,2022-03-08
2,8,2,6,0,Granville,2022-04-11
2,25,7,18,0,Granville,2022-05-12
2,37,17,20,0,Granville,2022-05-17
2,16,4,12,0,Granville,2022-05-21
2,20,5,15,0,Granville,2022-05-22
2,51,20,31,0,Granville,2022-05-23
2,21,3,18,0,Granville,2022-06-03
2,21,2,19,0,Granville,2022-06-07
2,24,5,19,0,Granville,2022-06-08
2,29,8,21,0,Granville,2022-06-10
3,61,5,56,0,Granville,2022-01-21
3,18,3,15,0,Granville,2022-02-15
3,19,7,12,0,Granville,2022-02-16
3,22,10,12,0,Granville,2022-02-21
3,10,4,6,0,Granville,2022-04-21
3,17,2,15,0,Granville,2022-05-04
3,24,8,16,0,Granville,2022-05-05
3,21,2,19,0,Granville,2022-05-09
3,21,3,18,0,Granville,2022-05-11
3,32,8,24,0,Granville,2022-05-18
3,29,5,24,0,Granville,2022-05-26
3,15,7,8,0,Granville,2022-05-27
3,28,8,20,0,Granville,2022-06-09
3,14,5,9,0,Granville,2022-06-11
4,36,3,33,0,Granville,2022-02-05
4,20,5,15,0,Granville,2022-02-17
4,26,7,19,0,Granville,2022-05-24
5,25,6,19,0,Granville,2021-12-23
5,103,53,50,0,Granville,2021-12-31
5,87,8,79,0,Granville,2022-01-15
5,88,6,82,0,Granville,2022-01-26
5,82,8,74,0,Granville,2022-01-27
5,66,2,64,0,Granville,2022-02-01
5,26,3,23,0,Granville,2022-02-10
5,36,13,23,0,Granville,2022-05-16
6,98,25,73,0,Granville,2021-12-27
6,50,15,35,0,Granville,2022-02-07
6,43,10,33,0,Granville,2022-06-06
7,79,22,57,0,Granville,2022-01-02
7,111,15,96,0,Granville,2022-01-08
7,141,19,122,0,Granville,2022-01-17
7,50,14,36,0,Granville,2022-02-08
8,88,3,85,0,Granville,2022-01-31
8,60,10,50,0,Granville,2022-02-02
8,62,10,52,0,Granville,2022-02-09
9,172,13,159,0,Granville,2022-01-14
10,168,45,123,0,Granville,2021-12-28
10,190,18,172,0,Granville,2022-01-19
10,77,4,73,0,Granville,2022-01-28
11,243,20,223,0,Granville,2022-01-10
11,160,12,148,0,Granville,2022-01-20
12,170,26,144,0,Granville,2022-01-04
14,215,27,188,0,Granville,2022-01-11
15,216,20,196,0,Granville,2022-01-12
15,184,9,175,0,Granville,2022-01-24
16,178,65,113,0,Granville,2021-12-29
16,157,65,92,0,Granville,2022-01-03
16,150,15,135,0,Granville,2022-01-06
17,196,92,104,0,Granville,2021-12-30
20,175,14,161,0,Granville,2022-01-05
24,176,11,165,0,Granville,2022-01-13
,0,0,0,0,Greene,2022-02-19
,0,0,0,0,Greene,2022-03-02
,0,0,0,0,Greene,2022-03-05
,0,0,0,0,Greene,2022-03-06
,0,0,0,0,Greene,2022-03-09
,0,0,0,0,Greene,2022-03-10
,0,0,0,0,Greene,2022-03-11
,0,0,0,0,Greene,2022-03-12
,0,0,0,0,Greene,2022-03-13
,0,0,0,0,Greene,2022-03-14
,0,0,0,0,Greene,2022-03-16
,0,0,0,0,Greene,2022-03-17
,0,0,0,0,Greene,2022-03-18
,0,0,0,0,Greene,2022-03-19
,0,0,0,0,Greene,2022-03-20
,0,0,0,0,Greene,2022-03-21
,0,0,0,0,Greene,2022-03-22
,0,0,0,0,Greene,2022-03-24
,0,0,0,0,Greene,2022-03-25
,0,0,0,0,Greene,2022-03-26
,0,0,0,0,Greene,2022-03-27
,0,0,0,0,Greene,2022-03-28
,0,0,0,0,Greene,2022-03-29
,0,0,0,0,Greene,2022-03-31
,0,0,0,0,Greene,2022-04-01
,0,0,0,0,Greene,2022-04-02
,0,0,0,0,Greene,2022-04-03
,0,0,0,0,Greene,2022-04-04
,0,0,0,0,Greene,2022-04-06
,0,0,0,0,Greene,2022-04-07
,0,0,0,0,Greene,2022-04-08
,0,0,0,0,Greene,2022-04-09
,0,0,0,0,Greene,2022-04-10
,0,0,0,0,Greene,2022-04-11
,0,0,0,0,Greene,2022-04-12
,0,0,0,0,Greene,2022-04-13
,0,0,0,0,Greene,2022-04-15
,0,0,0,0,Greene,2022-04-16
,0,0,0,0,Greene,2022-04-17
,0,0,0,0,Greene,2022-04-20
,0,0,0,0,Greene,2022-04-21
,0,0,0,0,Greene,2022-04-22
,0,0,0,0,Greene,2022-04-23
,0,0,0,0,Greene,2022-04-26
,0,0,0,0,Greene,2022-04-27
,0,0,0,0,Greene,2022-04-30
,0,0,0,0,Greene,2022-05-02
,0,0,0,0,Greene,2022-05-08
,0,0,0,0,Greene,2022-05-14
,0,0,0,0,Greene,2022-05-29
0,10,5,5,0,Greene,2021-12-14
0,4,1,3,0,Greene,2021-12-15
0,3,0,3,0,Greene,2021-12-18
0,16,2,14,0,Greene,2021-12-20
0,16,5,11,0,Greene,2021-12-21
0,25,4,21,0,Greene,2021-12-22
0,12,3,9,0,Greene,2021-12-23
0,1,1,0,0,Greene,2021-12-24
0,9,1,8,0,Greene,2021-12-26
0,8,0,8,0,Greene,2022-01-02
0,12,7,5,0,Greene,2022-01-16
0,25,9,16,0,Greene,2022-01-21
0,6,5,1,0,Greene,2022-01-22
0,44,6,38,0,Greene,2022-01-27
0,5,0,5,0,Greene,2022-01-30
0,5,0,5,0,Greene,2022-02-05
0,8,2,6,0,Greene,2022-02-06
0,11,1,10,0,Greene,2022-02-08
0,4,0,4,0,Greene,2022-02-10
0,4,2,2,0,Greene,2022-02-11
0,2,0,2,0,Greene,2022-02-16
0,1,0,1,0,Greene,2022-02-20
0,4,0,4,0,Greene,2022-02-22
0,4,0,4,0,Greene,2022-02-24
0,2,1,1,0,Greene,2022-02-26
0,1,0,1,0,Greene,2022-02-27
0,5,4,1,0,Greene,2022-02-28
0,2,0,2,0,Greene,2022-03-01
0,1,0,1,0,Greene,2022-03-04
0,2,0,2,0,Greene,2022-03-30
0,1,0,1,0,Greene,2022-04-05
0,4,0,4,0,Greene,2022-04-14
0,1,0,1,0,Greene,2022-04-18
0,4,0,4,0,Greene,2022-04-19
0,2,0,2,0,Greene,2022-04-24
0,1,1,0,0,Greene,2022-04-29
0,3,0,3,0,Greene,2022-05-01
0,2,1,1,0,Greene,2022-05-04
0,1,0,1,0,Greene,2022-05-06
0,2,0,2,0,Greene,2022-05-07
0,3,0,3,0,Greene,2022-05-10
0,3,1,2,0,Greene,2022-05-11
0,5,0,5,0,Greene,2022-05-12
0,3,2,1,0,Greene,2022-05-13
0,1,1,0,0,Greene,2022-05-15
0,1,0,1,0,Greene,2022-05-18
0,1,1,0,0,Greene,2022-05-21
0,3,1,2,0,Greene,2022-05-22
0,5,4,1,0,Greene,2022-05-23
0,5,0,5,0,Greene,2022-05-26
0,2,1,1,0,Greene,2022-05-28
0,1,1,0,0,Greene,2022-05-30
0,5,1,4,0,Greene,2022-06-03
0,3,0,3,0,Greene,2022-06-04
0,9,2,7,0,Greene,2022-06-09
0,6,2,4,0,Greene,2022-06-10
0,1,0,1,0,Greene,2022-06-11
1,3,1,2,0,Greene,2021-12-25
1,8,2,6,0,Greene,2022-01-01
1,23,3,20,0,Greene,2022-01-09
1,8,1,7,0,Greene,2022-01-29
1,6,0,6,0,Greene,2022-02-14
1,4,1,3,0,Greene,2022-02-18
1,10,4,6,0,Greene,2022-05-09
1,8,2,6,0,Greene,2022-05-17
1,2,2,0,0,Greene,2022-05-19
1,8,4,4,0,Greene,2022-05-20
1,5,0,5,0,Greene,2022-05-27
1,5,4,1,0,Greene,2022-06-01
2,17,3,14,0,Greene,2021-12-27
2,49,10,39,0,Greene,2021-12-28
2,73,14,59,0,Greene,2022-01-04
2,13,1,12,0,Greene,2022-01-08
2,15,3,12,0,Greene,2022-01-15
2,28,5,23,0,Greene,2022-01-28
2,14,3,11,0,Greene,2022-02-03
2,17,4,13,0,Greene,2022-02-04
2,11,6,5,0,Greene,2022-02-09
2,4,2,2,0,Greene,2022-05-16
2,7,2,5,0,Greene,2022-06-06
2,11,2,9,0,Greene,2022-06-08
3,25,5,20,0,Greene,2021-12-31
3,14,3,11,0,Greene,2022-02-02
3,10,2,8,0,Greene,2022-02-15
3,8,1,7,0,Greene,2022-02-21
4,36,14,22,0,Greene,2021-12-29
4,27,5,22,0,Greene,2022-02-01
4,38,2,36,0,Greene,2022-05-24
5,83,7,76,0,Greene,2022-01-03
5,67,19,48,0,Greene,2022-01-14
5,78,29,49,0,Greene,2022-01-17
6,41,12,29,0,Greene,2022-01-31
7,67,20,47,0,Greene,2022-01-12
8,87,6,81,0,Greene,2022-01-06
9,91,33,58,0,Greene,2022-01-20
9,67,19,48,0,Greene,2022-01-25
10,71,12,59,0,Greene,2021-12-30
12,130,28,102,0,Greene,2022-01-10
12,171,38,133,0,Greene,2022-01-18
13,106,25,81,0,Greene,2022-01-11
17,125,29,96,0,Greene,2022-01-24
0,15,3,12,0,Guilford,2022-03-18
0,21,8,13,0,Guilford,2022-03-28
1,147,24,123,0,Guilford,2021-12-18
1,27,4,23,0,Guilford,2022-03-16
1,13,1,12,0,Guilford,2022-03-26
1,17,3,14,0,Guilford,2022-04-03
1,27,10,17,0,Guilford,2022-04-06
1,63,10,53,0,Guilford,2022-04-23
2,39,9,30,0,Guilford,2022-03-21
2,25,11,14,0,Guilford,2022-04-01
2,26,3,23,0,Guilford,2022-04-05
2,45,9,36,0,Guilford,2022-04-08
3,70,19,51,0,Guilford,2022-02-19
3,17,6,11,0,Guilford,2022-03-12
3,28,7,21,0,Guilford,2022-03-24
3,37,8,29,0,Guilford,2022-04-04
3,40,11,29,0,Guilford,2022-04-10
3,90,27,63,0,Guilford,2022-05-01
4,56,22,34,0,Guilford,2022-02-20
4,28,9,19,0,Guilford,2022-03-17
4,33,8,25,0,Guilford,2022-03-31
4,82,13,69,0,Guilford,2022-04-15
4,91,15,76,0,Guilford,2022-05-07
5,39,4,35,0,Guilford,2022-04-17
5,76,9,67,0,Guilford,2022-04-24
6,88,14,74,0,Guilford,2022-05-08
7,100,14,86,0,Guilford,2021-12-25
7,119,26,93,0,Guilford,2022-05-29
8,89,28,61,0,Guilford,2022-04-11
8,111,19,92,0,Guilford,2022-05-21
10,56,13,43,0,Guilford,2022-04-07
10,130,18,112,0,Guilford,2022-05-15
10,158,35,123,0,Guilford,2022-05-22
11,158,37,121,0,Guilford,2022-05-03
12,123,33,90,0,Guilford,2022-04-21
12,103,5,98,0,Guilford,2022-04-22
13,171,45,126,0,Guilford,2022-05-04
13,114,15,99,0,Guilford,2022-06-05
14,168,38,130,0,Guilford,2022-05-27
16,286,39,247,0,Guilford,2021-12-20
16,120,37,83,0,Guilford,2022-04-14
16,149,25,124,0,Guilford,2022-05-06
16,150,30,120,0,Guilford,2022-06-03
16,177,22,155,0,Guilford,2022-06-06
17,179,42,137,0,Guilford,2022-04-20
17,166,40,126,0,Guilford,2022-04-27
17,209,45,164,0,Guilford,2022-05-13
17,262,56,206,0,Guilford,2022-05-23
18,163,37,126,0,Guilford,2022-05-05
20,205,46,159,0,Guilford,2022-06-02
21,202,42,160,0,Guilford,2022-05-02
22,236,36,200,0,Guilford,2022-05-11
22,185,23,162,0,Guilford,2022-06-08
24,191,17,174,0,Guilford,2022-06-09
25,169,46,123,0,Guilford,2022-04-19
25,266,52,214,0,Guilford,2022-05-16
25,221,37,184,0,Guilford,2022-05-20
27,265,42,223,0,Guilford,2022-05-18
30,211,36,175,0,Guilford,2022-05-26
33,248,40,208,0,Guilford,2022-05-19
124,1649,243,1406,0,Guilford,2022-01-04
,0,0,0,0,Halifax,2022-03-06
,0,0,0,0,Halifax,2022-03-10
,0,0,0,0,Halifax,2022-03-16
,0,0,0,0,Halifax,2022-03-18
,0,0,0,0,Halifax,2022-03-20
,0,0,0,0,Halifax,2022-03-22
,0,0,0,0,Halifax,2022-03-23
,0,0,0,0,Halifax,2022-03-24
,0,0,0,0,Halifax,2022-03-25
,0,0,0,0,Halifax,2022-03-27
,0,0,0,0,Halifax,2022-03-28
,0,0,0,0,Halifax,2022-03-29
,0,0,0,0,Halifax,2022-03-30
,0,0,0,0,Halifax,2022-04-01
,0,0,0,0,Halifax,2022-04-03
,0,0,0,0,Halifax,2022-04-07
,0,0,0,0,Halifax,2022-04-09
,0,0,0,0,Halifax,2022-04-11
,0,0,0,0,Halifax,2022-04-12
,0,0,0,0,Halifax,2022-04-16
,0,0,0,0,Halifax,2022-05-01
0,7,1,6,0,Halifax,2021-12-18
0,2,1,1,0,Halifax,2021-12-19
0,17,2,15,0,Halifax,2021-12-25
0,19,0,19,0,Halifax,2022-02-17
0,12,3,9,0,Halifax,2022-02-18
0,6,1,5,0,Halifax,2022-02-20
0,14,3,11,0,Halifax,2022-02-23
0,5,1,4,0,Halifax,2022-02-25
0,4,1,3,0,Halifax,2022-02-27
0,9,1,8,0,Halifax,2022-02-28
0,10,2,8,0,Halifax,2022-03-01
0,3,0,3,0,Halifax,2022-03-02
0,1,0,1,0,Halifax,2022-03-05
0,4,0,4,0,Halifax,2022-03-07
0,1,0,1,0,Halifax,2022-03-08
0,1,0,1,0,Halifax,2022-03-09
0,2,1,1,0,Halifax,2022-03-11
0,2,1,1,0,Halifax,2022-03-12
0,1,0,1,0,Halifax,2022-03-15
0,2,0,2,0,Halifax,2022-03-17
0,1,0,1,0,Halifax,2022-03-19
0,1,1,0,0,Halifax,2022-03-21
0,1,0,1,0,Halifax,2022-03-31
0,1,0,1,0,Halifax,2022-04-05
0,2,0,2,0,Halifax,2022-04-13
0,3,1,2,0,Halifax,2022-04-14
0,1,0,1,0,Halifax,2022-04-17
0,3,0,3,0,Halifax,2022-04-18
0,1,0,1,0,Halifax,2022-04-19
0,3,1,2,0,Halifax,2022-04-20
0,1,0,1,0,Halifax,2022-04-23
0,5,0,5,0,Halifax,2022-04-26
0,3,0,3,0,Halifax,2022-04-29
0,2,1,1,0,Halifax,2022-04-30
0,3,1,2,0,Halifax,2022-05-05
0,6,2,4,0,Halifax,2022-05-15
0,16,5,11,0,Halifax,2022-05-18
0,5,0,5,0,Halifax,2022-05-29
0,7,3,4,0,Halifax,2022-06-04
1,13,4,9,0,Halifax,2021-12-14
1,9,0,9,0,Halifax,2021-12-15
1,20,2,18,0,Halifax,2021-12-20
1,16,2,14,0,Halifax,2021-12-24
1,23,4,19,0,Halifax,2022-02-08
1,14,6,8,0,Halifax,2022-02-21
1,8,1,7,0,Halifax,2022-03-03
1,3,2,1,0,Halifax,2022-03-14
1,2,0,2,0,Halifax,2022-04-06
1,3,0,3,0,Halifax,2022-04-08
1,3,0,3,0,Halifax,2022-04-15
1,5,1,4,0,Halifax,2022-04-21
1,5,0,5,0,Halifax,2022-04-24
1,7,2,5,0,Halifax,2022-04-27
1,11,1,10,0,Halifax,2022-05-03
1,7,2,5,0,Halifax,2022-05-07
1,3,3,0,0,Halifax,2022-05-08
1,18,6,12,0,Halifax,2022-05-10
1,22,8,14,0,Halifax,2022-05-17
1,23,4,19,0,Halifax,2022-05-19
1,8,3,5,0,Halifax,2022-05-22
1,5,2,3,0,Halifax,2022-05-28
1,6,1,5,0,Halifax,2022-06-05
1,12,2,10,0,Halifax,2022-06-10
1,10,2,8,0,Halifax,2022-06-11
2,16,2,14,0,Halifax,2022-01-23
2,58,12,46,0,Halifax,2022-02-01
2,16,4,12,0,Halifax,2022-02-10
2,14,0,14,0,Halifax,2022-02-11
2,6,0,6,0,Halifax,2022-02-13
2,12,2,10,0,Halifax,2022-02-15
2,15,1,14,0,Halifax,2022-02-16
2,7,1,6,0,Halifax,2022-03-04
2,11,8,3,0,Halifax,2022-04-22
2,7,1,6,0,Halifax,2022-05-06
2,18,7,11,0,Halifax,2022-05-11
2,5,1,4,0,Halifax,2022-05-30
2,23,3,20,0,Halifax,2022-05-31
2,15,4,11,0,Halifax,2022-06-03
3,8,1,7,0,Halifax,2022-04-25
3,16,8,8,0,Halifax,2022-05-09
3,12,2,10,0,Halifax,2022-05-13
3,16,7,9,0,Halifax,2022-05-16
3,12,3,9,0,Halifax,2022-05-26
3,19,4,15,0,Halifax,2022-06-01
3,14,1,13,0,Halifax,2022-06-09
4,39,6,33,0,Halifax,2021-12-22
4,62,8,54,0,Halifax,2022-01-09
4,17,6,11,0,Halifax,2022-05-12
4,30,9,21,0,Halifax,2022-05-27
4,28,4,24,0,Halifax,2022-06-02
5,59,2,57,0,Halifax,2022-01-01
5,51,17,34,0,Halifax,2022-02-02
5,12,4,8,0,Halifax,2022-05-04
5,27,6,21,0,Halifax,2022-05-23
6,92,25,67,0,Halifax,2022-01-17
6,88,25,63,0,Halifax,2022-01-31
6,22,3,19,0,Halifax,2022-05-24
7,18,2,16,0,Halifax,2022-06-07
8,60,6,54,0,Halifax,2022-01-08
8,57,3,54,0,Halifax,2022-01-15
8,67,12,55,0,Halifax,2022-01-28
8,44,9,35,0,Halifax,2022-02-07
9,82,20,62,0,Halifax,2022-01-26
10,22,3,19,0,Halifax,2022-05-20
11,86,13,73,0,Halifax,2021-12-27
11,40,4,36,0,Halifax,2022-06-06
16,183,13,170,0,Halifax,2022-01-13
20,204,37,167,0,Halifax,2022-01-03
21,195,6,189,0,Halifax,2021-12-31
21,201,23,178,0,Halifax,2022-01-19
24,215,25,190,0,Halifax,2021-12-30
25,257,42,215,0,Halifax,2022-01-18
28,172,22,150,0,Halifax,2021-12-28
28,303,55,248,0,Halifax,2022-01-06
30,274,20,254,0,Halifax,2022-01-10
0,29,4,25,0,Harnett,2022-02-12
0,3,1,2,0,Harnett,2022-03-05
0,6,0,6,0,Harnett,2022-03-06
0,13,2,11,0,Harnett,2022-03-09
0,8,3,5,0,Harnett,2022-03-10
0,1,0,1,0,Harnett,2022-03-12
0,2,1,1,0,Harnett,2022-03-19
0,3,1,2,0,Harnett,2022-03-20
0,4,2,2,0,Harnett,2022-03-22
0,3,0,3,0,Harnett,2022-03-24
0,1,0,1,0,Harnett,2022-03-25
0,1,0,1,0,Harnett,2022-03-26
0,2,0,2,0,Harnett,2022-03-27
0,3,3,0,0,Harnett,2022-03-28
0,8,0,8,0,Harnett,2022-03-29
0,8,2,6,0,Harnett,2022-03-30
0,2,0,2,0,Harnett,2022-03-31
0,7,0,7,0,Harnett,2022-04-01
0,4,0,4,0,Harnett,2022-04-02
0,4,1,3,0,Harnett,2022-04-03
0,5,0,5,0,Harnett,2022-04-04
0,6,0,6,0,Harnett,2022-04-07
0,3,1,2,0,Harnett,2022-04-10
0,4,1,3,0,Harnett,2022-04-17
0,13,3,10,0,Harnett,2022-04-19
0,10,3,7,0,Harnett,2022-04-22
0,10,3,7,0,Harnett,2022-04-30
0,3,0,3,0,Harnett,2022-05-01
0,21,1,20,0,Harnett,2022-05-29
1,57,14,43,0,Harnett,2021-12-22
1,21,4,17,0,Harnett,2021-12-25
1,40,5,35,0,Harnett,2022-02-16
1,13,1,12,0,Harnett,2022-02-20
1,11,2,9,0,Harnett,2022-02-26
1,5,0,5,0,Harnett,2022-03-13
1,4,1,3,0,Harnett,2022-03-15
1,8,3,5,0,Harnett,2022-03-17
1,1,0,1,0,Harnett,2022-04-08
1,4,0,4,0,Harnett,2022-04-09
1,11,1,10,0,Harnett,2022-04-11
1,8,0,8,0,Harnett,2022-04-14
1,6,2,4,0,Harnett,2022-04-15
1,5,1,4,0,Harnett,2022-04-16
1,21,9,12,0,Harnett,2022-04-20
1,16,5,11,0,Harnett,2022-04-27
1,25,3,22,0,Harnett,2022-05-04
1,20,3,17,0,Harnett,2022-05-15
1,15,0,15,0,Harnett,2022-06-04
1,32,7,25,0,Harnett,2022-06-07
1,24,5,19,0,Harnett,2022-06-10
2,28,5,23,0,Harnett,2021-12-19
2,71,14,57,0,Harnett,2021-12-23
2,38,8,30,0,Harnett,2021-12-24
2,67,12,55,0,Harnett,2022-02-09
2,12,1,11,0,Harnett,2022-02-24
2,10,1,9,0,Harnett,2022-03-04
2,9,0,9,0,Harnett,2022-03-21
2,17,8,9,0,Harnett,2022-04-18
2,26,12,14,0,Harnett,2022-04-21
2,23,5,18,0,Harnett,2022-04-26
2,19,4,15,0,Harnett,2022-04-29
2,31,10,21,0,Harnett,2022-05-02
2,12,3,9,0,Harnett,2022-05-07
2,23,5,18,0,Harnett,2022-05-14
2,37,10,27,0,Harnett,2022-05-17
2,19,2,17,0,Harnett,2022-05-22
2,20,3,17,0,Harnett,2022-06-11
3,46,10,36,0,Harnett,2022-01-22
3,27,4,23,0,Harnett,2022-02-23
3,22,7,15,0,Harnett,2022-02-25
3,24,2,22,0,Harnett,2022-05-10
3,35,8,27,0,Harnett,2022-05-11
3,52,20,32,0,Harnett,2022-05-26
3,18,8,10,0,Harnett,2022-05-30
3,42,7,35,0,Harnett,2022-06-01
4,55,12,43,0,Harnett,2021-12-14
4,53,6,47,0,Harnett,2022-02-17
4,39,14,25,0,Harnett,2022-02-21
4,27,5,22,0,Harnett,2022-05-12
4,52,7,45,0,Harnett,2022-05-18
4,35,7,28,0,Harnett,2022-06-06
5,25,8,17,0,Harnett,2022-05-03
5,22,7,15,0,Harnett,2022-05-05
5,31,7,24,0,Harnett,2022-05-06
5,34,8,26,0,Harnett,2022-05-13
5,57,14,43,0,Harnett,2022-05-16
5,41,7,34,0,Harnett,2022-06-09
6,73,22,51,0,Harnett,2021-12-20
6,50,12,38,0,Harnett,2022-05-20
6,58,12,46,0,Harnett,2022-05-23
6,38,9,29,0,Harnett,2022-05-24
6,46,9,37,0,Harnett,2022-05-27
6,36,4,32,0,Harnett,2022-06-03
6,33,9,24,0,Harnett,2022-06-08
7,64,14,50,0,Harnett,2022-01-16
7,110,15,95,0,Harnett,2022-02-03
7,26,3,23,0,Harnett,2022-05-21
9,272,51,221,0,Harnett,2021-12-30
9,103,11,92,0,Harnett,2022-01-01
9,152,36,116,0,Harnett,2022-02-02
9,53,17,36,0,Harnett,2022-05-19
10,213,36,177,0,Harnett,2022-01-27
10,44,10,34,0,Harnett,2022-05-09
11,224,44,180,0,Harnett,2022-01-31
13,110,37,73,0,Harnett,2022-02-07
17,167,21,146,0,Harnett,2021-12-31
17,222,37,185,0,Harnett,2022-01-28
31,635,127,508,0,Harnett,2022-01-11
35,426,105,321,0,Harnett,2022-01-03
39,731,162,569,0,Harnett,2022-01-18
40,497,88,409,0,Harnett,2022-01-04
,0,0,0,0,Haywood,2022-03-19
,0,0,0,0,Haywood,2022-03-20
,0,0,0,0,Haywood,2022-03-26
,0,0,0,0,Haywood,2022-04-03
,0,0,0,0,Haywood,2022-04-17
0,7,1,6,0,Haywood,2021-12-25
0,18,10,8,0,Haywood,2021-12-26
0,24,8,16,0,Haywood,2022-01-01
0,11,6,5,0,Haywood,2022-01-16
0,19,5,14,0,Haywood,2022-02-23
0,6,2,4,0,Haywood,2022-02-27
0,1,0,1,0,Haywood,2022-03-02
0,1,0,1,0,Haywood,2022-03-12
0,2,0,2,0,Haywood,2022-03-13
0,5,2,3,0,Haywood,2022-03-15
0,14,1,13,0,Haywood,2022-03-16
0,1,0,1,0,Haywood,2022-03-18
0,3,1,2,0,Haywood,2022-03-21
0,2,0,2,0,Haywood,2022-03-22
0,1,0,1,0,Haywood,2022-03-25
0,2,1,1,0,Haywood,2022-03-28
0,6,3,3,0,Haywood,2022-03-30
0,2,0,2,0,Haywood,2022-03-31
0,2,1,1,0,Haywood,2022-04-02
0,1,0,1,0,Haywood,2022-04-05
0,3,1,2,0,Haywood,2022-04-07
0,2,1,1,0,Haywood,2022-04-08
0,1,0,1,0,Haywood,2022-04-09
0,6,1,5,0,Haywood,2022-04-11
0,5,2,3,0,Haywood,2022-04-13
0,3,1,2,0,Haywood,2022-04-14
0,4,4,0,0,Haywood,2022-04-16
0,4,3,1,0,Haywood,2022-04-18
0,6,4,2,0,Haywood,2022-04-20
0,6,3,3,0,Haywood,2022-04-21
0,2,1,1,0,Haywood,2022-04-23
0,3,0,3,0,Haywood,2022-04-24
0,15,10,5,0,Haywood,2022-04-25
0,6,4,2,0,Haywood,2022-04-29
0,4,3,1,0,Haywood,2022-05-01
0,12,5,7,0,Haywood,2022-05-02
0,13,5,8,0,Haywood,2022-05-06
0,7,1,6,0,Haywood,2022-05-07
0,6,3,3,0,Haywood,2022-05-08
0,9,5,4,0,Haywood,2022-05-09
0,17,13,4,0,Haywood,2022-05-10
0,13,5,8,0,Haywood,2022-05-13
0,6,4,2,0,Haywood,2022-05-15
0,13,7,6,0,Haywood,2022-05-20
0,13,4,9,0,Haywood,2022-05-27
0,14,4,10,0,Haywood,2022-05-29
0,8,4,4,0,Haywood,2022-06-04
0,24,5,19,0,Haywood,2022-06-06
1,22,8,14,0,Haywood,2021-12-14
1,26,4,22,0,Haywood,2021-12-15
1,56,14,42,0,Haywood,2021-12-28
1,17,6,11,0,Haywood,2022-02-12
1,19,2,17,0,Haywood,2022-02-13
1,18,6,12,0,Haywood,2022-02-18
1,11,3,8,0,Haywood,2022-03-03
1,3,0,3,0,Haywood,2022-03-05
1,4,2,2,0,Haywood,2022-03-10
1,4,0,4,0,Haywood,2022-03-11
1,3,1,2,0,Haywood,2022-03-17
1,1,0,1,0,Haywood,2022-04-01
1,4,2,2,0,Haywood,2022-04-06
1,2,0,2,0,Haywood,2022-04-10
1,2,1,1,0,Haywood,2022-04-15
1,2,0,2,0,Haywood,2022-04-19
1,6,3,3,0,Haywood,2022-04-26
1,11,2,9,0,Haywood,2022-04-27
1,5,4,1,0,Haywood,2022-04-30
1,21,12,9,0,Haywood,2022-05-12
1,15,1,14,0,Haywood,2022-05-18
1,19,6,13,0,Haywood,2022-05-19
1,12,8,4,0,Haywood,2022-05-22
1,6,5,1,0,Haywood,2022-05-28
1,14,9,5,0,Haywood,2022-06-05
1,20,11,9,0,Haywood,2022-06-07
1,14,7,7,0,Haywood,2022-06-10
1,11,4,7,0,Haywood,2022-06-11
2,24,12,12,0,Haywood,2021-12-23
2,47,17,30,0,Haywood,2022-01-08
2,38,16,22,0,Haywood,2022-02-10
2,7,6,1,0,Haywood,2022-03-27
2,7,1,6,0,Haywood,2022-04-22
2,17,7,10,0,Haywood,2022-05-03
2,16,8,8,0,Haywood,2022-05-05
2,38,18,20,0,Haywood,2022-05-16
2,18,14,4,0,Haywood,2022-05-24
2,13,10,3,0,Haywood,2022-05-26
2,11,5,6,0,Haywood,2022-05-30
2,18,9,9,0,Haywood,2022-06-08
2,26,6,20,0,Haywood,2022-06-09
3,58,22,36,0,Haywood,2021-12-30
3,22,9,13,0,Haywood,2022-05-11
3,24,12,12,0,Haywood,2022-05-23
3,24,11,13,0,Haywood,2022-06-01
3,20,10,10,0,Haywood,2022-06-03
4,93,25,68,0,Haywood,2022-01-04
4,60,14,46,0,Haywood,2022-01-22
4,65,11,54,0,Haywood,2022-01-23
4,75,30,45,0,Haywood,2022-02-04
4,16,8,8,0,Haywood,2022-05-04
5,161,62,99,0,Haywood,2022-01-18
5,118,29,89,0,Haywood,2022-01-25
5,57,28,29,0,Haywood,2022-02-09
5,30,17,13,0,Haywood,2022-02-17
6,23,12,11,0,Haywood,2022-02-28
8,142,34,108,0,Haywood,2022-01-06
9,93,32,61,0,Haywood,2022-01-03
9,131,35,96,0,Haywood,2022-01-26
13,170,44,126,0,Haywood,2022-01-20
15,148,34,114,0,Haywood,2022-01-21
18,152,62,90,0,Haywood,2022-01-12
18,200,68,132,0,Haywood,2022-01-19
19,154,63,91,0,Haywood,2022-01-13
0,25,12,13,0,Henderson,2021-12-18
0,42,23,19,0,Henderson,2021-12-19
0,10,4,6,0,Henderson,2022-02-20
0,8,2,6,0,Henderson,2022-02-26
0,4,2,2,0,Henderson,2022-02-27
0,6,1,5,0,Henderson,2022-03-05
0,1,0,1,0,Henderson,2022-03-12
0,4,3,1,0,Henderson,2022-03-14
0,7,1,6,0,Henderson,2022-03-15
0,2,1,1,0,Henderson,2022-03-16
0,1,0,1,0,Henderson,2022-03-18
0,5,4,1,0,Henderson,2022-03-20
0,2,2,0,0,Henderson,2022-03-21
0,6,4,2,0,Henderson,2022-03-22
0,1,1,0,0,Henderson,2022-03-23
0,4,1,3,0,Henderson,2022-03-25
0,1,1,0,0,Henderson,2022-03-27
0,2,0,2,0,Henderson,2022-03-30
0,8,2,6,0,Henderson,2022-03-31
0,3,1,2,0,Henderson,2022-04-01
0,3,1,2,0,Henderson,2022-04-03
0,5,1,4,0,Henderson,2022-04-05
0,4,3,1,0,Henderson,2022-04-06
0,2,0,2,0,Henderson,2022-04-07
0,5,3,2,0,Henderson,2022-04-08
0,2,0,2,0,Henderson,2022-04-09
0,2,1,1,0,Henderson,2022-04-10
0,13,2,11,0,Henderson,2022-04-15
0,4,4,0,0,Henderson,2022-04-16
0,3,0,3,0,Henderson,2022-04-17
0,13,6,7,0,Henderson,2022-04-18
0,13,4,9,0,Henderson,2022-04-19
0,9,3,6,0,Henderson,2022-04-23
0,12,7,5,0,Henderson,2022-04-27
0,13,7,6,0,Henderson,2022-05-06
0,15,7,8,0,Henderson,2022-05-07
0,33,5,28,0,Henderson,2022-05-24
1,28,11,17,0,Henderson,2022-02-17
1,19,4,15,0,Henderson,2022-02-25
1,17,12,5,0,Henderson,2022-02-28
1,9,5,4,0,Henderson,2022-03-02
1,8,2,6,0,Henderson,2022-03-03
1,13,4,9,0,Henderson,2022-03-04
1,13,6,7,0,Henderson,2022-03-07
1,3,1,2,0,Henderson,2022-03-13
1,2,1,1,0,Henderson,2022-03-26
1,6,2,4,0,Henderson,2022-03-28
1,5,0,5,0,Henderson,2022-04-14
1,12,4,8,0,Henderson,2022-04-20
1,13,7,6,0,Henderson,2022-04-21
1,11,3,8,0,Henderson,2022-04-22
1,5,4,1,0,Henderson,2022-04-24
1,14,6,8,0,Henderson,2022-04-29
1,6,1,5,0,Henderson,2022-05-01
1,17,9,8,0,Henderson,2022-05-08
1,14,2,12,0,Henderson,2022-05-21
1,25,11,14,0,Henderson,2022-05-26
1,23,10,13,0,Henderson,2022-06-04
1,25,8,17,0,Henderson,2022-06-05
1,23,9,14,0,Henderson,2022-06-07
2,63,32,31,0,Henderson,2021-12-14
2,21,9,12,0,Henderson,2022-02-23
2,16,8,8,0,Henderson,2022-02-24
2,4,1,3,0,Henderson,2022-03-29
2,13,2,11,0,Henderson,2022-04-11
2,18,6,12,0,Henderson,2022-05-03
2,22,11,11,0,Henderson,2022-05-04
2,22,10,12,0,Henderson,2022-05-12
2,45,22,23,0,Henderson,2022-05-19
2,39,12,27,0,Henderson,2022-05-20
2,23,9,14,0,Henderson,2022-05-22
2,30,16,14,0,Henderson,2022-05-27
2,16,7,9,0,Henderson,2022-05-28
2,17,9,8,0,Henderson,2022-05-29
2,26,10,16,0,Henderson,2022-06-08
2,23,15,8,0,Henderson,2022-06-11
3,64,15,49,0,Henderson,2021-12-20
3,70,22,48,0,Henderson,2021-12-22
3,54,17,37,0,Henderson,2022-01-29
3,15,4,11,0,Henderson,2022-04-13
3,17,8,9,0,Henderson,2022-04-25
3,12,6,6,0,Henderson,2022-04-30
3,32,14,18,0,Henderson,2022-05-09
3,58,33,25,0,Henderson,2022-05-16
3,19,11,8,0,Henderson,2022-05-30
3,29,7,22,0,Henderson,2022-05-31
3,23,12,11,0,Henderson,2022-06-03
3,24,6,18,0,Henderson,2022-06-10
4,92,26,66,0,Henderson,2021-12-23
4,34,8,26,0,Henderson,2021-12-24
4,60,24,36,0,Henderson,2022-01-01
4,44,18,26,0,Henderson,2022-02-16
4,26,10,16,0,Henderson,2022-05-10
4,29,8,21,0,Henderson,2022-05-17
4,30,13,17,0,Henderson,2022-06-01
4,37,15,22,0,Henderson,2022-06-06
5,91,37,54,0,Henderson,2022-01-02
5,44,17,27,0,Henderson,2022-02-15
5,38,11,27,0,Henderson,2022-05-23
5,29,5,24,0,Henderson,2022-06-02
6,16,5,11,0,Henderson,2022-05-05
6,28,8,20,0,Henderson,2022-05-11
6,49,19,30,0,Henderson,2022-05-18
7,21,8,13,0,Henderson,2022-06-09
10,118,26,92,0,Henderson,2021-12-31
17,141,14,127,0,Henderson,2021-12-27
17,199,71,128,0,Henderson,2022-01-06
21,295,96,199,0,Henderson,2022-01-12
22,247,51,196,0,Henderson,2022-01-05
23,181,65,116,0,Henderson,2022-01-21
26,256,103,153,0,Henderson,2022-01-24
27,212,32,180,0,Henderson,2022-01-04
28,313,92,221,0,Henderson,2022-01-11
34,372,111,261,0,Henderson,2022-01-10
,0,0,0,0,Hertford,2022-02-14
,0,0,0,0,Hertford,2022-02-28
,0,0,0,0,Hertford,2022-03-05
,0,0,0,0,Hertford,2022-03-06
,0,0,0,0,Hertford,2022-03-08
,0,0,0,0,Hertford,2022-03-09
,0,0,0,0,Hertford,2022-03-12
,0,0,0,0,Hertford,2022-03-13
,0,0,0,0,Hertford,2022-03-14
,0,0,0,0,Hertford,2022-03-15
,0,0,0,0,Hertford,2022-03-16
,0,0,0,0,Hertford,2022-03-17
,0,0,0,0,Hertford,2022-03-18
,0,0,0,0,Hertford,2022-03-19
,0,0,0,0,Hertford,2022-03-20
,0,0,0,0,Hertford,2022-03-22
,0,0,0,0,Hertford,2022-03-24
,0,0,0,0,Hertford,2022-03-26
,0,0,0,0,Hertford,2022-03-27
,0,0,0,0,Hertford,2022-03-30
,0,0,0,0,Hertford,2022-03-31
,0,0,0,0,Hertford,2022-04-01
,0,0,0,0,Hertford,2022-04-02
,0,0,0,0,Hertford,2022-04-03
,0,0,0,0,Hertford,2022-04-04
,0,0,0,0,Hertford,2022-04-06
,0,0,0,0,Hertford,2022-04-07
,0,0,0,0,Hertford,2022-04-09
,0,0,0,0,Hertford,2022-04-17
,0,0,0,0,Hertford,2022-04-19
,0,0,0,0,Hertford,2022-04-21
,0,0,0,0,Hertford,2022-04-22
,0,0,0,0,Hertford,2022-04-27
,0,0,0,0,Hertford,2022-05-01
,0,0,0,0,Hertford,2022-05-11
,0,0,0,0,Hertford,2022-05-14
,0,0,0,0,Hertford,2022-05-15
0,3,1,2,0,Hertford,2021-12-14
0,2,0,2,0,Hertford,2021-12-16
0,2,1,1,0,Hertford,2021-12-18
0,1,0,1,0,Hertford,2021-12-19
0,9,1,8,0,Hertford,2021-12-20
0,2,2,0,0,Hertford,2021-12-22
0,7,1,6,0,Hertford,2021-12-23
0,7,0,7,0,Hertford,2021-12-24
0,2,0,2,0,Hertford,2021-12-25
0,12,3,9,0,Hertford,2022-01-15
0,39,12,27,0,Hertford,2022-01-20
0,38,9,29,0,Hertford,2022-01-25
0,2,0,2,0,Hertford,2022-01-29
0,4,1,3,0,Hertford,2022-01-30
0,6,1,5,0,Hertford,2022-02-03
0,3,0,3,0,Hertford,2022-02-04
0,5,3,2,0,Hertford,2022-02-07
0,7,1,6,0,Hertford,2022-02-08
0,6,2,4,0,Hertford,2022-02-09
0,4,0,4,0,Hertford,2022-02-10
0,1,0,1,0,Hertford,2022-02-12
0,2,0,2,0,Hertford,2022-02-13
0,1,0,1,0,Hertford,2022-02-15
0,4,0,4,0,Hertford,2022-02-17
0,3,0,3,0,Hertford,2022-02-18
0,4,0,4,0,Hertford,2022-02-19
0,1,1,0,0,Hertford,2022-02-20
0,6,1,5,0,Hertford,2022-02-21
0,2,1,1,0,Hertford,2022-02-22
0,2,1,1,0,Hertford,2022-02-23
0,2,0,2,0,Hertford,2022-02-24
0,3,0,3,0,Hertford,2022-02-25
0,4,1,3,0,Hertford,2022-02-26
0,3,1,2,0,Hertford,2022-02-27
0,2,0,2,0,Hertford,2022-03-01
0,3,0,3,0,Hertford,2022-03-02
0,3,1,2,0,Hertford,2022-03-04
0,1,0,1,0,Hertford,2022-03-07
0,1,0,1,0,Hertford,2022-03-11
0,1,0,1,0,Hertford,2022-03-21
0,1,0,1,0,Hertford,2022-03-23
0,3,0,3,0,Hertford,2022-03-25
0,1,0,1,0,Hertford,2022-03-28
0,1,0,1,0,Hertford,2022-03-29
0,1,0,1,0,Hertford,2022-04-08
0,1,0,1,0,Hertford,2022-04-10
0,1,0,1,0,Hertford,2022-04-11
0,1,1,0,0,Hertford,2022-04-12
0,1,0,1,0,Hertford,2022-04-13
0,2,0,2,0,Hertford,2022-04-14
0,1,0,1,0,Hertford,2022-04-16
0,2,0,2,0,Hertford,2022-04-20
0,1,0,1,0,Hertford,2022-04-23
0,1,0,1,0,Hertford,2022-04-24
0,1,0,1,0,Hertford,2022-04-25
0,2,1,1,0,Hertford,2022-04-26
0,1,0,1,0,Hertford,2022-04-29
0,1,0,1,0,Hertford,2022-04-30
0,1,1,0,0,Hertford,2022-05-04
0,2,1,1,0,Hertford,2022-05-06
0,6,0,6,0,Hertford,2022-05-16
0,3,0,3,0,Hertford,2022-05-17
0,5,1,4,0,Hertford,2022-05-18
0,2,0,2,0,Hertford,2022-05-20
0,3,0,3,0,Hertford,2022-05-21
0,3,2,1,0,Hertford,2022-05-24
0,1,0,1,0,Hertford,2022-05-27
0,1,0,1,0,Hertford,2022-05-30
0,2,0,2,0,Hertford,2022-06-03
0,1,0,1,0,Hertford,2022-06-09
0,4,1,3,0,Hertford,2022-06-10
0,4,0,4,0,Hertford,2022-06-11
1,6,3,3,0,Hertford,2021-12-21
1,9,0,9,0,Hertford,2022-01-01
1,14,0,14,0,Hertford,2022-01-09
1,11,1,10,0,Hertford,2022-01-16
1,10,0,10,0,Hertford,2022-01-21
1,6,1,5,0,Hertford,2022-01-23
1,12,3,9,0,Hertford,2022-02-01
1,5,3,2,0,Hertford,2022-02-02
1,2,0,2,0,Hertford,2022-02-05
1,5,0,5,0,Hertford,2022-02-06
1,2,0,2,0,Hertford,2022-03-10
1,2,0,2,0,Hertford,2022-04-15
1,1,0,1,0,Hertford,2022-04-18
1,2,0,2,0,Hertford,2022-04-28
1,1,0,1,0,Hertford,2022-05-03
1,7,1,6,0,Hertford,2022-05-05
1,1,0,1,0,Hertford,2022-05-07
1,2,0,2,0,Hertford,2022-05-08
1,5,3,2,0,Hertford,2022-05-09
1,3,0,3,0,Hertford,2022-05-10
1,8,2,6,0,Hertford,2022-05-12
1,4,1,3,0,Hertford,2022-05-13
1,2,0,2,0,Hertford,2022-05-22
1,6,0,6,0,Hertford,2022-05-23
1,8,2,6,0,Hertford,2022-05-25
1,3,1,2,0,Hertford,2022-05-26
1,4,0,4,0,Hertford,2022-05-28
1,3,2,1,0,Hertford,2022-05-29
1,8,1,7,0,Hertford,2022-06-02
1,4,1,3,0,Hertford,2022-06-04
1,7,3,4,0,Hertford,2022-06-07
1,4,1,3,0,Hertford,2022-06-08
2,9,4,5,0,Hertford,2022-05-19
2,22,6,16,0,Hertford,2022-05-31
2,9,1,8,0,Hertford,2022-06-06
3,18,5,13,0,Hertford,2021-12-27
3,23,4,19,0,Hertford,2022-01-17
3,23,6,17,0,Hertford,2022-01-26
3,18,3,15,0,Hertford,2022-01-27
3,9,3,6,0,Hertford,2022-06-01
5,48,6,42,0,Hertford,2021-12-28
5,70,10,60,0,Hertford,2022-01-07
5,52,12,40,0,Hertford,2022-01-24
6,33,6,27,0,Hertford,2022-01-08
6,82,13,69,0,Hertford,2022-01-18
7,62,27,35,0,Hertford,2021-12-29
7,98,15,83,0,Hertford,2022-01-06
7,78,15,63,0,Hertford,2022-01-11
8,107,24,83,0,Hertford,2022-01-10
8,76,19,57,0,Hertford,2022-01-12
9,88,18,70,0,Hertford,2022-01-03
9,66,10,56,0,Hertford,2022-01-14
10,54,8,46,0,Hertford,2021-12-30
11,64,8,56,0,Hertford,2021-12-31
11,107,40,67,0,Hertford,2022-01-04
,0,0,0,0,Hoke,2022-03-18
,0,0,0,0,Hoke,2022-03-20
,0,0,0,0,Hoke,2022-03-27
,0,0,0,0,Hoke,2022-04-10
0,18,3,15,0,Hoke,2021-12-14
0,20,4,16,0,Hoke,2021-12-15
0,22,2,20,0,Hoke,2022-01-22
0,19,2,17,0,Hoke,2022-01-30
0,22,7,15,0,Hoke,2022-02-10
0,8,2,6,0,Hoke,2022-02-13
0,30,5,25,0,Hoke,2022-02-14
0,26,6,20,0,Hoke,2022-02-15
0,3,0,3,0,Hoke,2022-02-19
0,14,3,11,0,Hoke,2022-02-22
0,10,3,7,0,Hoke,2022-02-24
0,5,3,2,0,Hoke,2022-02-27
0,10,2,8,0,Hoke,2022-03-03
0,3,0,3,0,Hoke,2022-03-04
0,2,0,2,0,Hoke,2022-03-05
0,1,1,0,0,Hoke,2022-03-06
0,5,0,5,0,Hoke,2022-03-07
0,3,1,2,0,Hoke,2022-03-09
0,4,0,4,0,Hoke,2022-03-10
0,4,0,4,0,Hoke,2022-03-11
0,1,1,0,0,Hoke,2022-03-12
0,1,0,1,0,Hoke,2022-03-13
0,1,0,1,0,Hoke,2022-03-14
0,2,1,1,0,Hoke,2022-03-15
0,2,1,1,0,Hoke,2022-03-16
0,1,0,1,0,Hoke,2022-03-17
0,1,0,1,0,Hoke,2022-03-19
0,2,0,2,0,Hoke,2022-03-21
0,3,0,3,0,Hoke,2022-03-22
0,2,0,2,0,Hoke,2022-03-24
0,2,0,2,0,Hoke,2022-03-25
0,3,1,2,0,Hoke,2022-03-26
0,1,0,1,0,Hoke,2022-03-28
0,3,0,3,0,Hoke,2022-03-29
0,2,2,0,0,Hoke,2022-03-30
0,1,0,1,0,Hoke,2022-03-31
0,3,2,1,0,Hoke,2022-04-01
0,3,0,3,0,Hoke,2022-04-02
0,2,0,2,0,Hoke,2022-04-03
0,4,0,4,0,Hoke,2022-04-06
0,1,0,1,0,Hoke,2022-04-07
0,2,0,2,0,Hoke,2022-04-08
0,2,1,1,0,Hoke,2022-04-09
0,4,0,4,0,Hoke,2022-04-11
0,3,1,2,0,Hoke,2022-04-12
0,6,3,3,0,Hoke,2022-04-13
0,8,4,4,0,Hoke,2022-04-14
0,3,2,1,0,Hoke,2022-04-15
0,2,0,2,0,Hoke,2022-04-17
0,9,1,8,0,Hoke,2022-04-18
0,2,1,1,0,Hoke,2022-04-19
0,4,1,3,0,Hoke,2022-04-21
0,2,0,2,0,Hoke,2022-04-22
0,4,1,3,0,Hoke,2022-04-24
0,10,2,8,0,Hoke,2022-04-26
0,12,3,9,0,Hoke,2022-04-27
0,7,1,6,0,Hoke,2022-04-29
0,6,0,6,0,Hoke,2022-04-30
0,5,3,2,0,Hoke,2022-05-01
0,4,1,3,0,Hoke,2022-05-14
0,26,7,19,0,Hoke,2022-05-23
0,33,7,26,0,Hoke,2022-05-25
0,10,2,8,0,Hoke,2022-05-27
0,9,2,7,0,Hoke,2022-05-29
0,12,4,8,0,Hoke,2022-05-30
0,23,6,17,0,Hoke,2022-06-02
0,7,0,7,0,Hoke,2022-06-04
1,9,5,4,0,Hoke,2021-12-18
1,19,4,15,0,Hoke,2021-12-20
1,19,2,17,0,Hoke,2021-12-25
1,15,3,12,0,Hoke,2022-02-05
1,20,4,16,0,Hoke,2022-02-06
1,12,1,11,0,Hoke,2022-02-12
1,19,1,18,0,Hoke,2022-02-16
1,7,0,7,0,Hoke,2022-02-25
1,3,0,3,0,Hoke,2022-04-16
1,3,0,3,0,Hoke,2022-04-20
1,4,2,2,0,Hoke,2022-04-23
1,24,10,14,0,Hoke,2022-05-02
1,12,3,9,0,Hoke,2022-05-06
1,7,3,4,0,Hoke,2022-05-08
1,24,7,17,0,Hoke,2022-05-12
1,17,8,9,0,Hoke,2022-05-15
1,35,8,27,0,Hoke,2022-05-16
1,13,2,11,0,Hoke,2022-05-20
1,13,3,10,0,Hoke,2022-05-21
1,26,6,20,0,Hoke,2022-05-24
1,26,8,18,0,Hoke,2022-06-01
1,10,2,8,0,Hoke,2022-06-05
2,46,12,34,0,Hoke,2021-12-23
2,92,11,81,0,Hoke,2022-01-21
2,64,5,59,0,Hoke,2022-01-23
2,27,2,25,0,Hoke,2022-01-29
2,20,7,13,0,Hoke,2022-02-11
2,11,1,10,0,Hoke,2022-02-21
2,10,2,8,0,Hoke,2022-02-23
2,9,1,8,0,Hoke,2022-04-28
2,20,4,16,0,Hoke,2022-05-04
2,18,3,15,0,Hoke,2022-05-10
2,16,7,9,0,Hoke,2022-05-11
2,6,0,6,0,Hoke,2022-05-22
2,14,1,13,0,Hoke,2022-05-28
2,8,2,6,0,Hoke,2022-06-03
2,17,4,13,0,Hoke,2022-06-10
2,12,2,10,0,Hoke,2022-06-11
3,40,8,32,0,Hoke,2021-12-22
3,27,4,23,0,Hoke,2021-12-24
3,19,1,18,0,Hoke,2022-01-16
3,78,19,59,0,Hoke,2022-01-31
3,45,12,33,0,Hoke,2022-02-07
3,39,10,29,0,Hoke,2022-02-08
3,36,9,27,0,Hoke,2022-02-09
3,25,11,14,0,Hoke,2022-05-09
3,12,3,9,0,Hoke,2022-05-13
3,22,2,20,0,Hoke,2022-05-19
3,24,11,13,0,Hoke,2022-06-07
4,9,2,7,0,Hoke,2022-05-07
4,31,6,25,0,Hoke,2022-05-18
5,93,9,84,0,Hoke,2021-12-27
5,79,1,78,0,Hoke,2022-01-02
5,22,5,17,0,Hoke,2022-05-26
7,102,12,90,0,Hoke,2021-12-31
7,40,14,26,0,Hoke,2022-05-31
8,135,6,129,0,Hoke,2021-12-28
8,17,9,8,0,Hoke,2022-06-09
9,212,13,199,0,Hoke,2022-01-07
9,154,3,151,0,Hoke,2022-01-08
10,164,22,142,0,Hoke,2022-01-25
12,146,8,138,0,Hoke,2021-12-29
13,159,31,128,0,Hoke,2021-12-30
14,246,19,227,0,Hoke,2022-01-14
17,252,26,226,0,Hoke,2022-01-04
17,263,24,239,0,Hoke,2022-01-06
17,294,40,254,0,Hoke,2022-01-12
17,280,31,249,0,Hoke,2022-01-17
18,172,13,159,0,Hoke,2022-01-03
18,247,46,201,0,Hoke,2022-01-20
25,380,46,334,0,Hoke,2022-01-10
25,382,36,346,0,Hoke,2022-01-18
39,351,34,317,0,Hoke,2022-01-11
,0,0,0,0,Hyde,2021-12-14
,0,0,0,0,Hyde,2021-12-19
,0,0,0,0,Hyde,2021-12-21
,0,0,0,0,Hyde,2021-12-25
,0,0,0,0,Hyde,2022-02-06
,0,0,0,0,Hyde,2022-02-13
,0,0,0,0,Hyde,2022-02-16
,0,0,0,0,Hyde,2022-02-19
,0,0,0,0,Hyde,2022-02-20
,0,0,0,0,Hyde,2022-02-24
,0,0,0,0,Hyde,2022-02-27
,0,0,0,0,Hyde,2022-02-28
,0,0,0,0,Hyde,2022-03-02
,0,0,0,0,Hyde,2022-03-05
,0,0,0,0,Hyde,2022-03-06
,0,0,0,0,Hyde,2022-03-08
,0,0,0,0,Hyde,2022-03-09
,0,0,0,0,Hyde,2022-03-11
,0,0,0,0,Hyde,2022-03-12
,0,0,0,0,Hyde,2022-03-14
,0,0,0,0,Hyde,2022-03-15
,0,0,0,0,Hyde,2022-03-16
,0,0,0,0,Hyde,2022-03-17
,0,0,0,0,Hyde,2022-03-18
,0,0,0,0,Hyde,2022-03-19
,0,0,0,0,Hyde,2022-03-20
,0,0,0,0,Hyde,2022-03-21
,0,0,0,0,Hyde,2022-03-23
,0,0,0,0,Hyde,2022-03-24
,0,0,0,0,Hyde,2022-03-25
,0,0,0,0,Hyde,2022-03-26
,0,0,0,0,Hyde,2022-03-27
,0,0,0,0,Hyde,2022-03-28
,0,0,0,0,Hyde,2022-03-29
,0,0,0,0,Hyde,2022-03-30
,0,0,0,0,Hyde,2022-03-31
,0,0,0,0,Hyde,2022-04-01
,0,0,0,0,Hyde,2022-04-02
,0,0,0,0,Hyde,2022-04-03
,0,0,0,0,Hyde,2022-04-04
,0,0,0,0,Hyde,2022-04-05
,0,0,0,0,Hyde,2022-04-06
,0,0,0,0,Hyde,2022-04-07
,0,0,0,0,Hyde,2022-04-08
,0,0,0,0,Hyde,2022-04-09
,0,0,0,0,Hyde,2022-04-10
,0,0,0,0,Hyde,2022-04-14
,0,0,0,0,Hyde,2022-04-15
,0,0,0,0,Hyde,2022-04-16
,0,0,0,0,Hyde,2022-04-17
,0,0,0,0,Hyde,2022-04-19
,0,0,0,0,Hyde,2022-04-21
,0,0,0,0,Hyde,2022-04-23
,0,0,0,0,Hyde,2022-04-24
,0,0,0,0,Hyde,2022-04-25
,0,0,0,0,Hyde,2022-04-27
,0,0,0,0,Hyde,2022-04-28
,0,0,0,0,Hyde,2022-04-30
,0,0,0,0,Hyde,2022-05-01
,0,0,0,0,Hyde,2022-05-05
,0,0,0,0,Hyde,2022-05-07
,0,0,0,0,Hyde,2022-05-08
,0,0,0,0,Hyde,2022-05-14
,0,0,0,0,Hyde,2022-05-21
,0,0,0,0,Hyde,2022-05-27
,0,0,0,0,Hyde,2022-05-28
,0,0,0,0,Hyde,2022-05-29
,0,0,0,0,Hyde,2022-06-03
,0,0,0,0,Hyde,2022-06-04
,0,0,0,0,Hyde,2022-06-05
,0,0,0,0,Hyde,2022-06-08
,0,0,0,0,Hyde,2022-06-11
0,1,1,0,0,Hyde,2021-12-15
0,2,0,2,0,Hyde,2021-12-17
0,2,0,2,0,Hyde,2021-12-18
0,3,0,3,0,Hyde,2021-12-20
0,2,1,1,0,Hyde,2021-12-22
0,1,0,1,0,Hyde,2021-12-23
0,1,0,1,0,Hyde,2021-12-24
0,6,0,6,0,Hyde,2021-12-27
0,4,0,4,0,Hyde,2021-12-28
0,4,0,4,0,Hyde,2021-12-29
0,1,0,1,0,Hyde,2021-12-31
0,1,0,1,0,Hyde,2022-01-01
0,4,0,4,0,Hyde,2022-01-02
0,13,0,13,0,Hyde,2022-01-04
0,13,1,12,0,Hyde,2022-01-07
0,13,1,12,0,Hyde,2022-01-10
0,4,0,4,0,Hyde,2022-01-15
0,24,1,23,0,Hyde,2022-01-18
0,6,1,5,0,Hyde,2022-01-21
0,1,0,1,0,Hyde,2022-01-22
0,6,1,5,0,Hyde,2022-01-28
0,2,0,2,0,Hyde,2022-01-29
0,5,0,5,0,Hyde,2022-02-04
0,1,1,0,0,Hyde,2022-02-05
0,2,0,2,0,Hyde,2022-02-08
0,1,0,1,0,Hyde,2022-02-09
0,3,0,3,0,Hyde,2022-02-10
0,5,0,5,0,Hyde,2022-02-11
0,3,0,3,0,Hyde,2022-02-12
0,2,0,2,0,Hyde,2022-02-14
0,2,0,2,0,Hyde,2022-02-15
0,3,0,3,0,Hyde,2022-02-17
0,1,0,1,0,Hyde,2022-02-18
0,4,1,3,0,Hyde,2022-02-21
0,3,0,3,0,Hyde,2022-02-22
0,1,1,0,0,Hyde,2022-02-23
0,1,0,1,0,Hyde,2022-02-25
0,1,0,1,0,Hyde,2022-03-01
0,1,0,1,0,Hyde,2022-03-03
0,1,0,1,0,Hyde,2022-03-04
0,1,0,1,0,Hyde,2022-03-07
0,1,0,1,0,Hyde,2022-03-10
0,1,0,1,0,Hyde,2022-03-13
0,1,0,1,0,Hyde,2022-03-22
0,1,0,1,0,Hyde,2022-04-11
0,1,0,1,0,Hyde,2022-04-12
0,1,0,1,0,Hyde,2022-04-13
0,1,1,0,0,Hyde,2022-04-18
0,1,0,1,0,Hyde,2022-04-20
0,2,0,2,0,Hyde,2022-04-22
0,1,0,1,0,Hyde,2022-04-26
0,4,0,4,0,Hyde,2022-04-29
0,8,0,8,0,Hyde,2022-05-02
0,6,0,6,0,Hyde,2022-05-03
0,3,1,2,0,Hyde,2022-05-04
0,2,0,2,0,Hyde,2022-05-06
0,2,0,2,0,Hyde,2022-05-12
0,3,0,3,0,Hyde,2022-05-13
0,2,0,2,0,Hyde,2022-05-15
0,5,0,5,0,Hyde,2022-05-18
0,1,0,1,0,Hyde,2022-05-22
0,1,0,1,0,Hyde,2022-05-24
0,3,0,3,0,Hyde,2022-05-30
0,7,0,7,0,Hyde,2022-05-31
0,3,0,3,0,Hyde,2022-06-02
0,4,0,4,0,Hyde,2022-06-06
0,2,0,2,0,Hyde,2022-06-09
0,2,0,2,0,Hyde,2022-06-10
1,21,0,21,0,Hyde,2022-01-03
1,2,0,2,0,Hyde,2022-01-08
1,7,0,7,0,Hyde,2022-01-16
1,13,2,11,0,Hyde,2022-01-20
1,3,0,3,0,Hyde,2022-01-23
1,19,3,16,0,Hyde,2022-01-24
1,11,0,11,0,Hyde,2022-01-25
1,7,0,7,0,Hyde,2022-01-26
1,11,3,8,0,Hyde,2022-01-27
1,3,0,3,0,Hyde,2022-01-30
1,4,0,4,0,Hyde,2022-02-02
1,5,1,4,0,Hyde,2022-02-03
1,7,0,7,0,Hyde,2022-02-07
1,3,2,1,0,Hyde,2022-05-09
1,6,0,6,0,Hyde,2022-05-10
1,3,0,3,0,Hyde,2022-05-11
1,15,0,15,0,Hyde,2022-05-16
1,4,0,4,0,Hyde,2022-05-19
1,5,0,5,0,Hyde,2022-05-20
1,5,0,5,0,Hyde,2022-05-23
1,8,0,8,0,Hyde,2022-05-26
1,4,0,4,0,Hyde,2022-06-01
1,3,0,3,0,Hyde,2022-06-07
2,23,1,22,0,Hyde,2022-01-12
2,50,14,36,0,Hyde,2022-01-14
2,7,1,6,0,Hyde,2022-01-17
2,18,2,16,0,Hyde,2022-01-19
2,10,1,9,0,Hyde,2022-02-01
3,11,0,11,0,Hyde,2022-01-11
3,12,0,12,0,Hyde,2022-01-13
3,18,0,18,0,Hyde,2022-01-31
0,44,23,21,0,Iredell,2022-01-16
0,6,4,2,0,Iredell,2022-03-04
0,11,5,6,0,Iredell,2022-03-09
0,3,0,3,0,Iredell,2022-03-10
0,3,0,3,0,Iredell,2022-03-13
0,6,2,4,0,Iredell,2022-03-16
0,5,1,4,0,Iredell,2022-03-18
0,10,7,3,0,Iredell,2022-03-19
0,13,8,5,0,Iredell,2022-03-21
0,8,3,5,0,Iredell,2022-03-22
0,6,2,4,0,Iredell,2022-03-23
0,2,1,1,0,Iredell,2022-03-25
0,2,0,2,0,Iredell,2022-04-03
0,7,4,3,0,Iredell,2022-04-06
0,10,4,6,0,Iredell,2022-04-09
0,18,8,10,0,Iredell,2022-04-12
0,11,1,10,0,Iredell,2022-04-15
0,13,7,6,0,Iredell,2022-04-17
0,24,5,19,0,Iredell,2022-04-20
0,36,8,28,0,Iredell,2022-04-29
0,38,19,19,0,Iredell,2022-05-28
1,16,7,9,0,Iredell,2022-02-25
1,6,4,2,0,Iredell,2022-03-11
1,7,2,5,0,Iredell,2022-03-15
1,6,3,3,0,Iredell,2022-03-17
1,5,1,4,0,Iredell,2022-03-20
1,6,3,3,0,Iredell,2022-03-26
1,6,5,1,0,Iredell,2022-03-27
1,8,5,3,0,Iredell,2022-03-28
1,6,3,3,0,Iredell,2022-03-29
1,6,4,2,0,Iredell,2022-03-30
1,8,5,3,0,Iredell,2022-03-31
1,5,3,2,0,Iredell,2022-04-01
1,10,4,6,0,Iredell,2022-04-04
1,10,5,5,0,Iredell,2022-04-08
1,13,6,7,0,Iredell,2022-04-10
1,25,2,23,0,Iredell,2022-04-22
1,9,2,7,0,Iredell,2022-04-23
1,32,18,14,0,Iredell,2022-04-25
1,34,12,22,0,Iredell,2022-04-27
1,10,4,6,0,Iredell,2022-04-30
1,13,6,7,0,Iredell,2022-05-01
1,26,13,13,0,Iredell,2022-05-05
1,20,11,9,0,Iredell,2022-05-08
2,44,14,30,0,Iredell,2021-12-25
2,14,8,6,0,Iredell,2022-02-27
2,21,8,13,0,Iredell,2022-03-01
2,23,7,16,0,Iredell,2022-04-11
2,23,8,15,0,Iredell,2022-04-26
2,22,8,14,0,Iredell,2022-05-07
2,33,9,24,0,Iredell,2022-05-14
2,55,17,38,0,Iredell,2022-06-07
3,104,37,67,0,Iredell,2021-12-15
3,8,4,4,0,Iredell,2022-04-07
3,10,4,6,0,Iredell,2022-04-16
3,30,10,20,0,Iredell,2022-04-21
3,22,6,16,0,Iredell,2022-04-24
3,36,10,26,0,Iredell,2022-05-06
3,41,12,29,0,Iredell,2022-05-12
3,32,18,14,0,Iredell,2022-06-04
3,61,15,46,0,Iredell,2022-06-06
3,48,15,33,0,Iredell,2022-06-09
4,70,24,46,0,Iredell,2022-02-06
4,28,16,12,0,Iredell,2022-04-18
4,26,14,12,0,Iredell,2022-04-19
4,26,17,9,0,Iredell,2022-04-28
4,37,10,27,0,Iredell,2022-05-13
4,46,19,27,0,Iredell,2022-05-22
4,35,15,20,0,Iredell,2022-05-30
4,61,24,37,0,Iredell,2022-06-02
5,20,13,7,0,Iredell,2022-03-14
5,28,12,16,0,Iredell,2022-04-13
5,23,11,12,0,Iredell,2022-04-14
5,42,20,22,0,Iredell,2022-05-04
5,72,31,41,0,Iredell,2022-05-16
5,61,33,28,0,Iredell,2022-05-26
5,56,12,44,0,Iredell,2022-05-27
5,44,16,28,0,Iredell,2022-05-29
5,48,10,38,0,Iredell,2022-06-05
6,41,16,25,0,Iredell,2022-05-02
6,64,26,38,0,Iredell,2022-05-24
6,53,14,39,0,Iredell,2022-06-08
6,42,9,33,0,Iredell,2022-06-10
6,30,12,18,0,Iredell,2022-06-11
8,51,22,29,0,Iredell,2022-05-09
8,49,23,26,0,Iredell,2022-05-10
8,54,22,32,0,Iredell,2022-05-11
8,70,30,40,0,Iredell,2022-05-18
8,50,12,38,0,Iredell,2022-06-03
9,164,65,99,0,Iredell,2021-12-23
9,77,31,46,0,Iredell,2022-05-17
9,75,32,43,0,Iredell,2022-06-01
10,217,92,125,0,Iredell,2021-12-31
10,55,22,33,0,Iredell,2022-05-20
12,78,30,48,0,Iredell,2022-05-31
14,162,45,117,0,Iredell,2022-02-07
15,82,31,51,0,Iredell,2022-05-19
32,526,182,344,0,Iredell,2022-01-05
45,507,154,353,0,Iredell,2022-01-24
52,675,213,462,0,Iredell,2022-01-11
,0,0,0,0,Jackson,2022-03-05
,0,0,0,0,Jackson,2022-03-06
,0,0,0,0,Jackson,2022-03-11
,0,0,0,0,Jackson,2022-03-13
,0,0,0,0,Jackson,2022-03-16
,0,0,0,0,Jackson,2022-03-19
,0,0,0,0,Jackson,2022-03-26
,0,0,0,0,Jackson,2022-03-31
,0,0,0,0,Jackson,2022-04-01
,0,0,0,0,Jackson,2022-04-02
,0,0,0,0,Jackson,2022-04-17
,0,0,0,0,Jackson,2022-04-23
,0,0,0,0,Jackson,2022-05-11
0,17,2,15,0,Jackson,2021-12-14
0,9,1,8,0,Jackson,2021-12-18
0,16,3,13,0,Jackson,2021-12-20
0,8,1,7,0,Jackson,2021-12-24
0,4,1,3,0,Jackson,2021-12-25
0,6,0,6,0,Jackson,2022-01-16
0,6,1,5,0,Jackson,2022-01-29
0,54,12,42,0,Jackson,2022-02-01
0,10,2,8,0,Jackson,2022-02-06
0,10,3,7,0,Jackson,2022-02-24
0,12,5,7,0,Jackson,2022-02-28
0,12,3,9,0,Jackson,2022-03-01
0,3,0,3,0,Jackson,2022-03-09
0,3,0,3,0,Jackson,2022-03-10
0,1,0,1,0,Jackson,2022-03-12
0,2,2,0,0,Jackson,2022-03-14
0,3,1,2,0,Jackson,2022-03-15
0,2,0,2,0,Jackson,2022-03-17
0,2,1,1,0,Jackson,2022-03-18
0,1,0,1,0,Jackson,2022-03-21
0,2,2,0,0,Jackson,2022-03-22
0,2,1,1,0,Jackson,2022-03-23
0,1,1,0,0,Jackson,2022-03-28
0,2,1,1,0,Jackson,2022-03-29
0,2,0,2,0,Jackson,2022-04-03
0,1,0,1,0,Jackson,2022-04-04
0,2,0,2,0,Jackson,2022-04-05
0,1,0,1,0,Jackson,2022-04-06
0,5,3,2,0,Jackson,2022-04-07
0,2,1,1,0,Jackson,2022-04-08
0,4,1,3,0,Jackson,2022-04-09
0,1,0,1,0,Jackson,2022-04-10
0,1,1,0,0,Jackson,2022-04-11
0,3,0,3,0,Jackson,2022-04-13
0,3,1,2,0,Jackson,2022-04-16
0,2,0,2,0,Jackson,2022-04-19
0,4,1,3,0,Jackson,2022-04-21
0,4,2,2,0,Jackson,2022-04-22
0,3,1,2,0,Jackson,2022-04-24
0,8,1,7,0,Jackson,2022-04-25
0,2,1,1,0,Jackson,2022-04-30
0,2,0,2,0,Jackson,2022-05-01
0,5,2,3,0,Jackson,2022-05-07
0,4,0,4,0,Jackson,2022-05-08
0,11,4,7,0,Jackson,2022-05-10
0,6,0,6,0,Jackson,2022-05-12
0,13,3,10,0,Jackson,2022-05-13
0,4,1,3,0,Jackson,2022-05-15
0,17,3,14,0,Jackson,2022-05-19
0,4,0,4,0,Jackson,2022-05-22
0,9,0,9,0,Jackson,2022-05-24
0,6,3,3,0,Jackson,2022-05-25
0,6,1,5,0,Jackson,2022-05-29
0,11,6,5,0,Jackson,2022-05-31
0,13,2,11,0,Jackson,2022-06-02
0,9,1,8,0,Jackson,2022-06-03
0,6,2,4,0,Jackson,2022-06-05
0,2,1,1,0,Jackson,2022-06-11
1,11,5,6,0,Jackson,2021-12-15
1,50,11,39,0,Jackson,2021-12-27
1,55,5,50,0,Jackson,2021-12-28
1,26,11,15,0,Jackson,2021-12-31
1,21,3,18,0,Jackson,2022-01-15
1,12,2,10,0,Jackson,2022-02-05
1,25,6,19,0,Jackson,2022-02-08
1,7,1,6,0,Jackson,2022-02-12
1,3,0,3,0,Jackson,2022-02-13
1,28,11,17,0,Jackson,2022-02-16
1,18,7,11,0,Jackson,2022-02-17
1,7,4,3,0,Jackson,2022-02-19
1,11,5,6,0,Jackson,2022-02-21
1,5,1,4,0,Jackson,2022-03-04
1,1,1,0,0,Jackson,2022-03-20
1,2,1,1,0,Jackson,2022-03-24
1,3,1,2,0,Jackson,2022-03-25
1,1,1,0,0,Jackson,2022-03-30
1,1,0,1,0,Jackson,2022-04-12
1,2,0,2,0,Jackson,2022-04-14
1,6,2,4,0,Jackson,2022-04-18
1,6,1,5,0,Jackson,2022-04-20
1,4,3,1,0,Jackson,2022-04-28
1,5,1,4,0,Jackson,2022-04-29
1,7,4,3,0,Jackson,2022-05-06
1,12,5,7,0,Jackson,2022-05-09
1,5,0,5,0,Jackson,2022-05-14
1,17,6,11,0,Jackson,2022-05-16
1,7,0,7,0,Jackson,2022-05-17
1,13,2,11,0,Jackson,2022-05-18
1,8,3,5,0,Jackson,2022-05-20
1,5,1,4,0,Jackson,2022-05-21
1,12,1,11,0,Jackson,2022-05-23
1,6,3,3,0,Jackson,2022-05-28
1,4,0,4,0,Jackson,2022-05-30
1,4,0,4,0,Jackson,2022-06-04
1,15,8,7,0,Jackson,2022-06-07
1,5,2,3,0,Jackson,2022-06-09
1,8,3,5,0,Jackson,2022-06-10
2,67,16,51,0,Jackson,2022-01-31
2,43,17,26,0,Jackson,2022-02-02
2,29,9,20,0,Jackson,2022-02-15
2,8,4,4,0,Jackson,2022-02-20
2,7,1,6,0,Jackson,2022-04-26
2,3,1,2,0,Jackson,2022-04-27
2,8,2,6,0,Jackson,2022-05-04
2,14,8,6,0,Jackson,2022-06-08
3,25,7,18,0,Jackson,2021-12-22
3,18,2,16,0,Jackson,2021-12-23
3,66,6,60,0,Jackson,2021-12-30
3,39,4,35,0,Jackson,2022-01-22
3,26,4,22,0,Jackson,2022-01-23
3,44,14,30,0,Jackson,2022-02-03
3,42,11,31,0,Jackson,2022-02-07
3,29,3,26,0,Jackson,2022-02-10
3,14,7,7,0,Jackson,2022-02-18
3,17,6,11,0,Jackson,2022-02-23
3,10,0,10,0,Jackson,2022-05-26
3,16,3,13,0,Jackson,2022-06-01
3,14,3,11,0,Jackson,2022-06-06
4,64,11,53,0,Jackson,2021-12-29
4,53,7,46,0,Jackson,2022-01-02
4,37,4,33,0,Jackson,2022-01-17
4,43,15,28,0,Jackson,2022-01-28
4,31,7,24,0,Jackson,2022-01-30
4,17,4,13,0,Jackson,2022-05-27
5,39,3,36,0,Jackson,2022-01-08
5,52,5,47,0,Jackson,2022-01-09
5,134,38,96,0,Jackson,2022-01-10
6,103,8,95,0,Jackson,2022-01-03
6,28,3,25,0,Jackson,2022-02-09
9,103,26,77,0,Jackson,2022-01-18
10,108,17,91,0,Jackson,2022-01-12
10,114,38,76,0,Jackson,2022-01-25
11,122,30,92,0,Jackson,2022-01-20
14,106,15,91,0,Jackson,2022-01-11
14,136,52,84,0,Jackson,2022-01-19
16,123,47,76,0,Jackson,2022-01-24
0,5,1,4,0,Johnston,2022-03-05
0,6,0,6,0,Johnston,2022-03-12
0,14,1,13,0,Johnston,2022-03-14
0,6,2,4,0,Johnston,2022-03-16
0,10,2,8,0,Johnston,2022-03-19
0,3,1,2,0,Johnston,2022-03-20
0,6,2,4,0,Johnston,2022-03-26
0,6,1,5,0,Johnston,2022-03-30
0,5,1,4,0,Johnston,2022-04-01
0,1,0,1,0,Johnston,2022-04-03
0,12,3,9,0,Johnston,2022-04-13
0,19,0,19,0,Johnston,2022-04-22
1,93,21,72,0,Johnston,2021-12-18
1,13,4,9,0,Johnston,2022-02-20
1,18,4,14,0,Johnston,2022-03-02
1,10,6,4,0,Johnston,2022-03-11
1,9,1,8,0,Johnston,2022-03-18
1,14,3,11,0,Johnston,2022-03-21
1,7,1,6,0,Johnston,2022-03-25
1,19,4,15,0,Johnston,2022-03-28
1,7,2,5,0,Johnston,2022-03-29
1,11,2,9,0,Johnston,2022-03-31
1,10,3,7,0,Johnston,2022-04-05
1,15,6,9,0,Johnston,2022-04-06
1,8,1,7,0,Johnston,2022-04-07
1,5,3,2,0,Johnston,2022-04-08
1,10,2,8,0,Johnston,2022-04-10
1,14,4,10,0,Johnston,2022-04-11
1,8,2,6,0,Johnston,2022-04-16
1,26,8,18,0,Johnston,2022-04-18
1,16,3,13,0,Johnston,2022-04-24
1,16,6,10,0,Johnston,2022-05-01
1,29,10,19,0,Johnston,2022-05-07
1,39,12,27,0,Johnston,2022-05-30
2,27,11,16,0,Johnston,2022-02-28
2,11,2,9,0,Johnston,2022-03-06
2,12,4,8,0,Johnston,2022-03-09
2,10,2,8,0,Johnston,2022-03-17
2,11,1,10,0,Johnston,2022-04-04
2,10,3,7,0,Johnston,2022-04-09
2,17,3,14,0,Johnston,2022-04-14
2,9,2,7,0,Johnston,2022-04-17
2,32,1,31,0,Johnston,2022-06-04
2,43,3,40,0,Johnston,2022-06-05
3,121,31,90,0,Johnston,2021-12-14
3,31,7,24,0,Johnston,2022-02-25
3,9,3,6,0,Johnston,2022-03-22
3,14,8,6,0,Johnston,2022-04-15
3,21,7,14,0,Johnston,2022-04-19
3,24,6,18,0,Johnston,2022-04-20
3,24,6,18,0,Johnston,2022-04-21
3,18,6,12,0,Johnston,2022-04-23
3,55,16,39,0,Johnston,2022-05-13
4,40,15,25,0,Johnston,2022-02-24
4,41,6,35,0,Johnston,2022-04-26
4,29,7,22,0,Johnston,2022-04-29
4,49,13,36,0,Johnston,2022-05-05
4,41,10,31,0,Johnston,2022-05-06
4,49,5,44,0,Johnston,2022-05-22
4,42,8,34,0,Johnston,2022-06-11
5,83,16,67,0,Johnston,2021-12-24
5,51,7,44,0,Johnston,2022-02-17
5,59,9,50,0,Johnston,2022-02-18
5,35,4,31,0,Johnston,2022-04-27
5,36,7,29,0,Johnston,2022-04-30
5,50,10,40,0,Johnston,2022-05-15
5,68,13,55,0,Johnston,2022-06-07
5,58,5,53,0,Johnston,2022-06-08
6,73,25,48,0,Johnston,2022-02-06
6,60,11,49,0,Johnston,2022-05-04
6,73,17,56,0,Johnston,2022-05-28
7,179,24,155,0,Johnston,2021-12-23
7,61,13,48,0,Johnston,2022-05-03
7,73,10,63,0,Johnston,2022-05-11
7,82,16,66,0,Johnston,2022-05-19
8,70,21,49,0,Johnston,2022-05-12
8,98,14,84,0,Johnston,2022-05-25
8,96,23,73,0,Johnston,2022-05-26
8,67,13,54,0,Johnston,2022-06-03
8,60,13,47,0,Johnston,2022-06-10
9,172,18,154,0,Johnston,2022-01-01
9,97,21,76,0,Johnston,2022-05-27
9,108,26,82,0,Johnston,2022-06-02
10,78,32,46,0,Johnston,2022-02-21
10,63,18,45,0,Johnston,2022-06-09
12,62,15,47,0,Johnston,2022-05-02
12,101,26,75,0,Johnston,2022-05-18
12,94,17,77,0,Johnston,2022-06-06
13,88,27,61,0,Johnston,2022-05-20
13,129,21,108,0,Johnston,2022-05-31
14,108,29,79,0,Johnston,2022-05-23
14,99,19,80,0,Johnston,2022-06-01
18,132,28,104,0,Johnston,2022-05-16
22,298,35,263,0,Johnston,2021-12-31
23,401,49,352,0,Johnston,2021-12-27
31,532,86,446,0,Johnston,2021-12-28
63,777,100,677,0,Johnston,2022-01-06
66,758,116,642,0,Johnston,2022-01-20
73,1011,171,840,0,Johnston,2022-01-12
96,1044,123,921,0,Johnston,2022-01-10
,0,0,0,0,Jones,2021-12-14
,0,0,0,0,Jones,2021-12-20
,0,0,0,0,Jones,2022-02-12
,0,0,0,0,Jones,2022-02-13
,0,0,0,0,Jones,2022-02-25
,0,0,0,0,Jones,2022-02-26
,0,0,0,0,Jones,2022-03-02
,0,0,0,0,Jones,2022-03-03
,0,0,0,0,Jones,2022-03-05
,0,0,0,0,Jones,2022-03-06
,0,0,0,0,Jones,2022-03-07
,0,0,0,0,Jones,2022-03-09
,0,0,0,0,Jones,2022-03-10
,0,0,0,0,Jones,2022-03-12
,0,0,0,0,Jones,2022-03-13
,0,0,0,0,Jones,2022-03-14
,0,0,0,0,Jones,2022-03-15
,0,0,0,0,Jones,2022-03-16
,0,0,0,0,Jones,2022-03-18
,0,0,0,0,Jones,2022-03-19
,0,0,0,0,Jones,2022-03-20
,0,0,0,0,Jones,2022-03-21
,0,0,0,0,Jones,2022-03-22
,0,0,0,0,Jones,2022-03-23
,0,0,0,0,Jones,2022-03-24
,0,0,0,0,Jones,2022-03-25
,0,0,0,0,Jones,2022-03-26
,0,0,0,0,Jones,2022-03-27
,0,0,0,0,Jones,2022-03-28
,0,0,0,0,Jones,2022-03-29
,0,0,0,0,Jones,2022-03-30
,0,0,0,0,Jones,2022-03-31
,0,0,0,0,Jones,2022-04-01
,0,0,0,0,Jones,2022-04-02
,0,0,0,0,Jones,2022-04-04
,0,0,0,0,Jones,2022-04-05
,0,0,0,0,Jones,2022-04-06
,0,0,0,0,Jones,2022-04-07
,0,0,0,0,Jones,2022-04-08
,0,0,0,0,Jones,2022-04-09
,0,0,0,0,Jones,2022-04-10
,0,0,0,0,Jones,2022-04-11
,0,0,0,0,Jones,2022-04-13
,0,0,0,0,Jones,2022-04-15
,0,0,0,0,Jones,2022-04-16
,0,0,0,0,Jones,2022-04-17
,0,0,0,0,Jones,2022-04-18
,0,0,0,0,Jones,2022-04-19
,0,0,0,0,Jones,2022-04-21
,0,0,0,0,Jones,2022-04-22
,0,0,0,0,Jones,2022-04-23
,0,0,0,0,Jones,2022-04-26
,0,0,0,0,Jones,2022-04-27
,0,0,0,0,Jones,2022-04-30
,0,0,0,0,Jones,2022-05-01
,0,0,0,0,Jones,2022-05-03
,0,0,0,0,Jones,2022-05-08
,0,0,0,0,Jones,2022-05-15
,0,0,0,0,Jones,2022-05-24
,0,0,0,0,Jones,2022-05-29
,0,0,0,0,Jones,2022-06-04
,0,0,0,0,Jones,2022-06-05
0,2,1,1,0,Jones,2021-12-15
0,2,1,1,0,Jones,2021-12-16
0,1,0,1,0,Jones,2021-12-18
0,1,0,1,0,Jones,2021-12-19
0,2,1,1,0,Jones,2021-12-22
0,3,1,2,0,Jones,2021-12-23
0,2,2,0,0,Jones,2021-12-24
0,1,0,1,0,Jones,2021-12-25
0,5,0,5,0,Jones,2021-12-26
0,9,1,8,0,Jones,2021-12-27
0,10,1,9,0,Jones,2021-12-28
0,15,4,11,0,Jones,2021-12-29
0,5,2,3,0,Jones,2022-01-01
0,2,1,1,0,Jones,2022-01-02
0,11,3,8,0,Jones,2022-01-04
0,23,10,13,0,Jones,2022-01-06
0,14,3,11,0,Jones,2022-01-08
0,7,1,6,0,Jones,2022-01-16
0,3,1,2,0,Jones,2022-01-21
0,1,0,1,0,Jones,2022-01-22
0,5,1,4,0,Jones,2022-01-23
0,21,5,16,0,Jones,2022-01-27
0,1,0,1,0,Jones,2022-01-30
0,2,1,1,0,Jones,2022-02-02
0,6,2,4,0,Jones,2022-02-04
0,5,2,3,0,Jones,2022-02-05
0,1,0,1,0,Jones,2022-02-06
0,10,3,7,0,Jones,2022-02-07
0,1,1,0,0,Jones,2022-02-08
0,3,1,2,0,Jones,2022-02-09
0,5,2,3,0,Jones,2022-02-10
0,4,0,4,0,Jones,2022-02-11
0,7,1,6,0,Jones,2022-02-14
0,2,1,1,0,Jones,2022-02-15
0,3,2,1,0,Jones,2022-02-18
0,2,2,0,0,Jones,2022-02-19
0,1,0,1,0,Jones,2022-02-20
0,3,0,3,0,Jones,2022-02-22
0,1,0,1,0,Jones,2022-02-23
0,1,0,1,0,Jones,2022-02-27
0,1,0,1,0,Jones,2022-02-28
0,1,1,0,0,Jones,2022-03-01
0,1,0,1,0,Jones,2022-03-11
0,1,0,1,0,Jones,2022-03-17
0,1,0,1,0,Jones,2022-04-14
0,2,0,2,0,Jones,2022-04-20
0,2,0,2,0,Jones,2022-04-24
0,2,0,2,0,Jones,2022-04-25
0,1,1,0,0,Jones,2022-04-28
0,1,0,1,0,Jones,2022-04-29
0,1,1,0,0,Jones,2022-05-05
0,1,1,0,0,Jones,2022-05-09
0,3,1,2,0,Jones,2022-05-10
0,3,2,1,0,Jones,2022-05-12
0,3,0,3,0,Jones,2022-05-13
0,2,0,2,0,Jones,2022-05-14
0,4,1,3,0,Jones,2022-05-16
0,3,0,3,0,Jones,2022-05-17
0,6,1,5,0,Jones,2022-05-18
0,1,0,1,0,Jones,2022-05-19
0,4,2,2,0,Jones,2022-05-20
0,2,1,1,0,Jones,2022-05-21
0,3,1,2,0,Jones,2022-05-22
0,1,1,0,0,Jones,2022-05-23
0,5,0,5,0,Jones,2022-05-25
0,5,3,2,0,Jones,2022-05-26
0,1,0,1,0,Jones,2022-05-28
0,5,0,5,0,Jones,2022-06-01
0,1,1,0,0,Jones,2022-06-02
0,1,1,0,0,Jones,2022-06-03
0,6,3,3,0,Jones,2022-06-06
0,3,1,2,0,Jones,2022-06-10
1,6,2,4,0,Jones,2021-12-31
1,6,5,1,0,Jones,2022-01-09
1,24,7,17,0,Jones,2022-01-12
1,7,2,5,0,Jones,2022-01-15
1,11,2,9,0,Jones,2022-01-28
1,3,1,2,0,Jones,2022-01-29
1,21,11,10,0,Jones,2022-01-31
1,9,2,7,0,Jones,2022-02-03
1,2,1,1,0,Jones,2022-02-16
1,3,1,2,0,Jones,2022-02-17
1,7,4,3,0,Jones,2022-02-21
1,1,0,1,0,Jones,2022-02-24
1,1,0,1,0,Jones,2022-03-04
1,1,0,1,0,Jones,2022-04-03
1,2,0,2,0,Jones,2022-05-04
1,3,2,1,0,Jones,2022-05-06
1,2,1,1,0,Jones,2022-05-07
1,2,1,1,0,Jones,2022-05-11
1,2,1,1,0,Jones,2022-05-27
1,2,2,0,0,Jones,2022-05-30
1,2,0,2,0,Jones,2022-05-31
1,5,4,1,0,Jones,2022-06-08
1,12,5,7,0,Jones,2022-06-09
1,3,0,3,0,Jones,2022-06-11
2,15,3,12,0,Jones,2021-12-30
2,25,9,16,0,Jones,2022-01-03
2,26,10,16,0,Jones,2022-01-14
2,7,2,5,0,Jones,2022-06-07
3,23,12,11,0,Jones,2022-01-05
3,37,16,21,0,Jones,2022-01-11
3,30,11,19,0,Jones,2022-01-13
3,21,9,12,0,Jones,2022-02-01
4,30,16,14,0,Jones,2022-01-17
4,47,12,35,0,Jones,2022-01-18
4,25,12,13,0,Jones,2022-01-20
5,44,19,25,0,Jones,2022-01-10
5,39,16,23,0,Jones,2022-01-19
5,42,18,24,0,Jones,2022-01-24
8,49,31,18,0,Jones,2022-01-25
,0,0,0,0,Lee,2022-02-27
,0,0,0,0,Lee,2022-03-19
,0,0,0,0,Lee,2022-03-20
,0,0,0,0,Lee,2022-03-22
,0,0,0,0,Lee,2022-03-26
,0,0,0,0,Lee,2022-03-27
,0,0,0,0,Lee,2022-04-09
,0,0,0,0,Lee,2022-04-16
0,26,2,24,0,Lee,2021-12-22
0,29,4,25,0,Lee,2022-01-30
0,21,2,19,0,Lee,2022-02-10
0,18,5,13,0,Lee,2022-02-15
0,9,2,7,0,Lee,2022-02-18
0,8,0,8,0,Lee,2022-02-24
0,4,0,4,0,Lee,2022-02-25
0,4,1,3,0,Lee,2022-02-28
0,5,2,3,0,Lee,2022-03-01
0,10,1,9,0,Lee,2022-03-02
0,4,1,3,0,Lee,2022-03-03
0,6,1,5,0,Lee,2022-03-04
0,1,0,1,0,Lee,2022-03-05
0,5,4,1,0,Lee,2022-03-07
0,3,0,3,0,Lee,2022-03-09
0,1,1,0,0,Lee,2022-03-11
0,1,1,0,0,Lee,2022-03-13
0,1,0,1,0,Lee,2022-03-17
0,4,1,3,0,Lee,2022-03-21
0,2,0,2,0,Lee,2022-03-24
0,4,0,4,0,Lee,2022-03-25
0,2,1,1,0,Lee,2022-03-28
0,1,0,1,0,Lee,2022-03-29
0,4,1,3,0,Lee,2022-03-31
0,2,0,2,0,Lee,2022-04-03
0,1,0,1,0,Lee,2022-04-05
0,1,0,1,0,Lee,2022-04-06
0,3,1,2,0,Lee,2022-04-07
0,2,0,2,0,Lee,2022-04-08
0,1,0,1,0,Lee,2022-04-11
0,5,1,4,0,Lee,2022-04-13
0,5,0,5,0,Lee,2022-04-14
0,4,2,2,0,Lee,2022-04-15
0,2,0,2,0,Lee,2022-04-17
0,4,2,2,0,Lee,2022-04-18
0,12,0,12,0,Lee,2022-04-20
0,10,2,8,0,Lee,2022-04-22
0,8,0,8,0,Lee,2022-04-23
0,2,1,1,0,Lee,2022-04-24
0,7,0,7,0,Lee,2022-04-28
0,7,1,6,0,Lee,2022-04-30
0,9,3,6,0,Lee,2022-05-02
0,8,2,6,0,Lee,2022-05-06
0,7,0,7,0,Lee,2022-05-07
0,9,0,9,0,Lee,2022-05-10
0,12,3,9,0,Lee,2022-05-14
0,10,5,5,0,Lee,2022-05-21
0,13,1,12,0,Lee,2022-05-27
0,11,3,8,0,Lee,2022-05-28
0,4,3,1,0,Lee,2022-05-29
0,8,2,6,0,Lee,2022-06-04
1,15,2,13,0,Lee,2021-12-18
1,24,1,23,0,Lee,2021-12-20
1,25,6,19,0,Lee,2022-01-16
1,38,4,34,0,Lee,2022-02-03
1,26,3,23,0,Lee,2022-02-06
1,7,1,6,0,Lee,2022-02-12
1,13,1,12,0,Lee,2022-02-21
1,1,1,0,0,Lee,2022-03-15
1,5,3,2,0,Lee,2022-03-16
1,4,0,4,0,Lee,2022-03-18
1,5,0,5,0,Lee,2022-03-30
1,1,0,1,0,Lee,2022-04-10
1,4,0,4,0,Lee,2022-04-19
1,6,1,5,0,Lee,2022-04-21
1,5,0,5,0,Lee,2022-04-26
1,12,1,11,0,Lee,2022-04-27
1,6,0,6,0,Lee,2022-04-29
1,3,1,2,0,Lee,2022-05-01
1,14,3,11,0,Lee,2022-05-03
1,14,3,11,0,Lee,2022-05-04
1,17,1,16,0,Lee,2022-05-09
1,14,1,13,0,Lee,2022-05-11
1,15,0,15,0,Lee,2022-05-12
1,17,4,13,0,Lee,2022-05-13
1,23,4,19,0,Lee,2022-05-18
1,19,3,16,0,Lee,2022-05-26
1,14,6,8,0,Lee,2022-05-30
1,12,2,10,0,Lee,2022-06-08
1,10,0,10,0,Lee,2022-06-10
1,7,0,7,0,Lee,2022-06-11
2,23,5,18,0,Lee,2021-12-17
2,25,7,18,0,Lee,2022-01-29
2,22,2,20,0,Lee,2022-02-11
2,8,2,6,0,Lee,2022-02-20
2,7,0,7,0,Lee,2022-02-23
2,13,6,7,0,Lee,2022-05-15
2,26,5,21,0,Lee,2022-05-16
2,23,6,17,0,Lee,2022-05-17
2,23,5,18,0,Lee,2022-05-20
2,12,2,10,0,Lee,2022-05-22
2,9,2,7,0,Lee,2022-06-03
2,18,7,11,0,Lee,2022-06-05
2,22,10,12,0,Lee,2022-06-06
3,32,6,26,0,Lee,2021-12-23
3,18,5,13,0,Lee,2022-05-19
3,25,8,17,0,Lee,2022-05-24
4,50,17,33,0,Lee,2022-01-23
4,81,6,75,0,Lee,2022-01-31
4,41,3,38,0,Lee,2022-02-04
4,36,10,26,0,Lee,2022-02-07
4,28,4,24,0,Lee,2022-06-01
4,24,8,16,0,Lee,2022-06-07
4,22,4,18,0,Lee,2022-06-09
5,75,9,66,0,Lee,2021-12-31
5,43,4,39,0,Lee,2022-01-01
5,126,36,90,0,Lee,2022-01-25
6,78,11,67,0,Lee,2022-01-27
6,71,8,63,0,Lee,2022-02-02
7,149,19,130,0,Lee,2021-12-30
7,80,13,67,0,Lee,2022-01-21
8,86,16,70,0,Lee,2021-12-27
8,74,8,66,0,Lee,2022-01-02
10,131,22,109,0,Lee,2021-12-28
10,178,20,158,0,Lee,2022-01-03
10,137,23,114,0,Lee,2022-01-26
11,120,24,96,0,Lee,2021-12-29
13,180,42,138,0,Lee,2022-01-24
14,157,20,137,0,Lee,2022-01-15
18,211,72,139,0,Lee,2022-01-20
21,281,24,257,0,Lee,2022-01-11
21,239,51,188,0,Lee,2022-01-18
21,302,39,263,0,Lee,2022-01-19
,0,0,0,0,Lenoir,2022-03-12
,0,0,0,0,Lenoir,2022-03-15
,0,0,0,0,Lenoir,2022-03-16
,0,0,0,0,Lenoir,2022-03-19
,0,0,0,0,Lenoir,2022-03-20
,0,0,0,0,Lenoir,2022-03-25
,0,0,0,0,Lenoir,2022-04-01
,0,0,0,0,Lenoir,2022-04-02
,0,0,0,0,Lenoir,2022-04-07
,0,0,0,0,Lenoir,2022-04-16
,0,0,0,0,Lenoir,2022-05-01
,0,0,0,0,Lenoir,2022-05-06
0,16,1,15,0,Lenoir,2021-12-14
0,13,1,12,0,Lenoir,2021-12-15
0,15,5,10,0,Lenoir,2021-12-17
0,9,0,9,0,Lenoir,2021-12-18
0,24,3,21,0,Lenoir,2021-12-20
0,11,1,10,0,Lenoir,2021-12-24
0,12,2,10,0,Lenoir,2021-12-25
0,44,17,27,0,Lenoir,2022-01-16
0,11,0,11,0,Lenoir,2022-02-18
0,4,0,4,0,Lenoir,2022-02-20
0,1,0,1,0,Lenoir,2022-02-26
0,4,1,3,0,Lenoir,2022-02-27
0,3,0,3,0,Lenoir,2022-03-03
0,3,2,1,0,Lenoir,2022-03-09
0,4,0,4,0,Lenoir,2022-03-11
0,1,0,1,0,Lenoir,2022-03-13
0,2,0,2,0,Lenoir,2022-03-14
0,2,1,1,0,Lenoir,2022-03-22
0,1,0,1,0,Lenoir,2022-03-24
0,2,2,0,0,Lenoir,2022-03-29
0,1,0,1,0,Lenoir,2022-03-30
0,1,0,1,0,Lenoir,2022-04-03
0,1,1,0,0,Lenoir,2022-04-04
0,1,0,1,0,Lenoir,2022-04-06
0,1,0,1,0,Lenoir,2022-04-08
0,1,0,1,0,Lenoir,2022-04-09
0,1,0,1,0,Lenoir,2022-04-10
0,2,1,1,0,Lenoir,2022-04-13
0,1,1,0,0,Lenoir,2022-04-15
0,1,1,0,0,Lenoir,2022-04-17
0,2,1,1,0,Lenoir,2022-04-19
0,2,1,1,0,Lenoir,2022-04-21
0,3,1,2,0,Lenoir,2022-04-22
0,1,1,0,0,Lenoir,2022-04-23
0,4,1,3,0,Lenoir,2022-04-25
0,3,2,1,0,Lenoir,2022-04-29
0,3,3,0,0,Lenoir,2022-04-30
0,6,1,5,0,Lenoir,2022-05-02
0,2,0,2,0,Lenoir,2022-05-07
0,2,1,1,0,Lenoir,2022-05-08
0,4,1,3,0,Lenoir,2022-05-14
0,2,0,2,0,Lenoir,2022-05-21
0,16,5,11,0,Lenoir,2022-05-23
0,11,5,6,0,Lenoir,2022-05-26
0,14,5,9,0,Lenoir,2022-05-27
0,6,3,3,0,Lenoir,2022-05-28
0,7,1,6,0,Lenoir,2022-06-05
0,4,1,3,0,Lenoir,2022-06-11
1,35,4,31,0,Lenoir,2021-12-21
1,26,4,22,0,Lenoir,2021-12-23
1,20,2,18,0,Lenoir,2021-12-26
1,31,10,21,0,Lenoir,2022-02-04
1,6,4,2,0,Lenoir,2022-02-12
1,13,1,12,0,Lenoir,2022-02-21
1,7,1,6,0,Lenoir,2022-02-22
1,11,0,11,0,Lenoir,2022-02-24
1,2,0,2,0,Lenoir,2022-03-17
1,1,0,1,0,Lenoir,2022-03-18
1,1,0,1,0,Lenoir,2022-03-21
1,2,1,1,0,Lenoir,2022-03-28
1,2,0,2,0,Lenoir,2022-03-31
1,2,0,2,0,Lenoir,2022-04-11
1,3,3,0,0,Lenoir,2022-04-24
1,2,1,1,0,Lenoir,2022-04-26
1,1,0,1,0,Lenoir,2022-04-27
1,7,0,7,0,Lenoir,2022-05-05
1,7,2,5,0,Lenoir,2022-05-10
1,4,2,2,0,Lenoir,2022-05-11
1,9,3,6,0,Lenoir,2022-05-13
1,10,4,6,0,Lenoir,2022-05-15
1,19,5,14,0,Lenoir,2022-05-16
1,11,1,10,0,Lenoir,2022-05-17
1,12,4,8,0,Lenoir,2022-05-20
1,5,4,1,0,Lenoir,2022-05-22
1,10,3,7,0,Lenoir,2022-05-24
1,3,1,2,0,Lenoir,2022-05-29
1,3,2,1,0,Lenoir,2022-05-30
1,16,7,9,0,Lenoir,2022-06-01
1,9,6,3,0,Lenoir,2022-06-03
1,18,6,12,0,Lenoir,2022-06-07
2,12,5,7,0,Lenoir,2022-01-22
2,23,5,18,0,Lenoir,2022-02-11
2,14,2,12,0,Lenoir,2022-02-16
2,2,0,2,0,Lenoir,2022-03-27
2,3,0,3,0,Lenoir,2022-04-12
2,6,4,2,0,Lenoir,2022-04-18
2,3,2,1,0,Lenoir,2022-04-20
2,8,3,5,0,Lenoir,2022-05-04
2,5,2,3,0,Lenoir,2022-05-09
2,13,4,9,0,Lenoir,2022-05-12
2,21,6,15,0,Lenoir,2022-06-02
2,17,3,14,0,Lenoir,2022-06-06
2,18,8,10,0,Lenoir,2022-06-08
3,45,17,28,0,Lenoir,2022-01-08
3,7,1,6,0,Lenoir,2022-05-18
3,4,0,4,0,Lenoir,2022-06-04
3,18,5,13,0,Lenoir,2022-06-09
4,73,22,51,0,Lenoir,2022-01-15
4,38,8,30,0,Lenoir,2022-01-21
4,44,15,29,0,Lenoir,2022-01-23
4,18,3,15,0,Lenoir,2022-06-10
5,52,14,38,0,Lenoir,2022-01-02
5,13,4,9,0,Lenoir,2022-05-19
7,53,10,43,0,Lenoir,2022-02-02
7,50,14,36,0,Lenoir,2022-02-03
8,28,9,19,0,Lenoir,2022-02-10
9,84,15,69,0,Lenoir,2021-12-31
14,74,11,63,0,Lenoir,2021-12-27
14,131,18,113,0,Lenoir,2021-12-30
14,141,24,117,0,Lenoir,2022-01-06
15,111,15,96,0,Lenoir,2021-12-29
15,163,34,129,0,Lenoir,2022-01-07
15,263,47,216,0,Lenoir,2022-01-12
17,157,59,98,0,Lenoir,2022-01-17
18,254,58,196,0,Lenoir,2022-01-20
22,256,38,218,0,Lenoir,2022-01-11
29,229,52,177,0,Lenoir,2022-01-14
45,317,80,237,0,Lenoir,2022-01-10
,0,0,0,0,Lincoln,2022-03-10
,0,0,0,0,Lincoln,2022-03-22
,0,0,0,0,Lincoln,2022-03-25
,0,0,0,0,Lincoln,2022-03-26
,0,0,0,0,Lincoln,2022-04-01
,0,0,0,0,Lincoln,2022-04-04
0,7,2,5,0,Lincoln,2021-12-25
0,4,2,2,0,Lincoln,2022-02-27
0,3,2,1,0,Lincoln,2022-03-03
0,5,2,3,0,Lincoln,2022-03-04
0,4,1,3,0,Lincoln,2022-03-05
0,1,1,0,0,Lincoln,2022-03-06
0,4,0,4,0,Lincoln,2022-03-12
0,1,0,1,0,Lincoln,2022-03-13
0,7,2,5,0,Lincoln,2022-03-14
0,9,0,9,0,Lincoln,2022-03-15
0,3,0,3,0,Lincoln,2022-03-17
0,2,1,1,0,Lincoln,2022-03-19
0,1,1,0,0,Lincoln,2022-03-20
0,1,0,1,0,Lincoln,2022-03-21
0,4,1,3,0,Lincoln,2022-03-23
0,2,0,2,0,Lincoln,2022-03-24
0,1,0,1,0,Lincoln,2022-03-27
0,1,0,1,0,Lincoln,2022-03-28
0,2,0,2,0,Lincoln,2022-03-30
0,2,0,2,0,Lincoln,2022-03-31
0,1,0,1,0,Lincoln,2022-04-03
0,2,0,2,0,Lincoln,2022-04-06
0,2,1,1,0,Lincoln,2022-04-07
0,3,2,1,0,Lincoln,2022-04-10
0,4,1,3,0,Lincoln,2022-04-11
0,3,0,3,0,Lincoln,2022-04-13
0,9,1,8,0,Lincoln,2022-04-14
0,3,1,2,0,Lincoln,2022-04-16
0,1,0,1,0,Lincoln,2022-04-17
0,7,0,7,0,Lincoln,2022-04-18
0,6,2,4,0,Lincoln,2022-04-20
0,3,1,2,0,Lincoln,2022-04-21
0,5,0,5,0,Lincoln,2022-04-23
0,6,2,4,0,Lincoln,2022-04-24
0,20,2,18,0,Lincoln,2022-04-26
0,13,4,9,0,Lincoln,2022-04-29
0,9,3,6,0,Lincoln,2022-05-07
0,7,1,6,0,Lincoln,2022-05-28
0,5,2,3,0,Lincoln,2022-05-29
0,27,10,17,0,Lincoln,2022-06-01
1,29,9,20,0,Lincoln,2021-12-15
1,23,1,22,0,Lincoln,2021-12-18
1,16,5,11,0,Lincoln,2022-01-16
1,5,2,3,0,Lincoln,2022-02-23
1,16,1,15,0,Lincoln,2022-02-25
1,3,0,3,0,Lincoln,2022-03-09
1,4,1,3,0,Lincoln,2022-03-11
1,4,0,4,0,Lincoln,2022-04-15
1,5,0,5,0,Lincoln,2022-04-19
1,4,0,4,0,Lincoln,2022-04-22
1,9,1,8,0,Lincoln,2022-04-25
1,6,0,6,0,Lincoln,2022-04-28
1,6,1,5,0,Lincoln,2022-04-30
1,14,2,12,0,Lincoln,2022-05-05
1,7,1,6,0,Lincoln,2022-05-08
1,5,2,3,0,Lincoln,2022-05-15
1,9,3,6,0,Lincoln,2022-05-21
1,16,4,12,0,Lincoln,2022-05-30
1,15,5,10,0,Lincoln,2022-06-03
1,17,4,13,0,Lincoln,2022-06-10
2,59,18,41,0,Lincoln,2021-12-20
2,63,17,46,0,Lincoln,2021-12-21
2,28,10,18,0,Lincoln,2022-02-17
2,14,9,5,0,Lincoln,2022-02-24
2,4,0,4,0,Lincoln,2022-03-08
2,4,1,3,0,Lincoln,2022-04-09
2,9,1,8,0,Lincoln,2022-04-27
2,14,2,12,0,Lincoln,2022-05-09
2,21,5,16,0,Lincoln,2022-05-10
2,26,7,19,0,Lincoln,2022-05-12
2,27,5,22,0,Lincoln,2022-05-18
2,33,7,26,0,Lincoln,2022-05-19
2,10,0,10,0,Lincoln,2022-05-22
2,23,4,19,0,Lincoln,2022-05-25
2,27,8,19,0,Lincoln,2022-05-26
2,17,4,13,0,Lincoln,2022-05-27
2,26,8,18,0,Lincoln,2022-06-02
2,20,1,19,0,Lincoln,2022-06-05
2,15,0,15,0,Lincoln,2022-06-11
3,64,9,55,0,Lincoln,2021-12-22
3,42,7,35,0,Lincoln,2022-02-05
3,19,5,14,0,Lincoln,2022-02-13
3,14,3,11,0,Lincoln,2022-02-19
3,23,4,19,0,Lincoln,2022-02-21
3,11,1,10,0,Lincoln,2022-02-28
3,4,0,4,0,Lincoln,2022-04-08
3,5,1,4,0,Lincoln,2022-04-12
3,12,1,11,0,Lincoln,2022-05-01
3,18,5,13,0,Lincoln,2022-05-03
3,40,11,29,0,Lincoln,2022-05-23
3,33,9,24,0,Lincoln,2022-05-24
3,18,2,16,0,Lincoln,2022-06-04
3,21,2,19,0,Lincoln,2022-06-09
4,47,11,36,0,Lincoln,2021-12-14
4,33,10,23,0,Lincoln,2021-12-24
4,66,17,49,0,Lincoln,2022-01-09
4,19,7,12,0,Lincoln,2022-05-04
4,17,4,13,0,Lincoln,2022-05-06
4,20,4,16,0,Lincoln,2022-05-20
4,22,3,19,0,Lincoln,2022-06-08
5,32,9,23,0,Lincoln,2022-01-01
5,93,22,71,0,Lincoln,2022-01-22
5,26,8,18,0,Lincoln,2022-05-11
5,21,3,18,0,Lincoln,2022-05-13
5,27,3,24,0,Lincoln,2022-06-07
6,76,29,47,0,Lincoln,2021-12-31
7,60,20,40,0,Lincoln,2022-02-08
7,37,7,30,0,Lincoln,2022-06-06
8,32,14,18,0,Lincoln,2022-05-16
8,40,5,35,0,Lincoln,2022-05-31
9,108,41,67,0,Lincoln,2022-01-28
10,96,26,70,0,Lincoln,2022-02-02
10,85,27,58,0,Lincoln,2022-02-03
11,168,55,113,0,Lincoln,2022-01-07
11,140,30,110,0,Lincoln,2022-01-15
11,89,28,61,0,Lincoln,2022-01-17
12,174,48,126,0,Lincoln,2021-12-29
13,67,19,48,0,Lincoln,2022-02-09
16,164,56,108,0,Lincoln,2022-01-03
17,203,46,157,0,Lincoln,2021-12-28
19,180,63,117,0,Lincoln,2022-01-26
21,204,58,146,0,Lincoln,2021-12-30
22,205,76,129,0,Lincoln,2022-01-24
25,228,78,150,0,Lincoln,2022-01-25
31,231,44,187,0,Lincoln,2022-01-06
37,312,90,222,0,Lincoln,2022-01-14
,0,0,0,0,Macon,2022-03-05
,0,0,0,0,Macon,2022-03-06
,0,0,0,0,Macon,2022-03-12
,0,0,0,0,Macon,2022-03-13
,0,0,0,0,Macon,2022-03-20
,0,0,0,0,Macon,2022-03-22
,0,0,0,0,Macon,2022-03-23
,0,0,0,0,Macon,2022-03-24
,0,0,0,0,Macon,2022-03-25
,0,0,0,0,Macon,2022-03-26
,0,0,0,0,Macon,2022-03-27
,0,0,0,0,Macon,2022-03-28
,0,0,0,0,Macon,2022-03-31
,0,0,0,0,Macon,2022-04-09
,0,0,0,0,Macon,2022-04-11
,0,0,0,0,Macon,2022-04-17
,0,0,0,0,Macon,2022-05-14
,0,0,0,0,Macon,2022-05-22
0,4,1,3,0,Macon,2021-12-15
0,8,2,6,0,Macon,2021-12-17
0,1,0,1,0,Macon,2021-12-19
0,11,5,6,0,Macon,2021-12-21
0,10,3,7,0,Macon,2021-12-23
0,10,6,4,0,Macon,2021-12-24
0,9,2,7,0,Macon,2021-12-26
0,24,6,18,0,Macon,2021-12-27
0,28,4,24,0,Macon,2022-02-02
0,10,1,9,0,Macon,2022-02-05
0,5,1,4,0,Macon,2022-02-06
0,6,0,6,0,Macon,2022-02-12
0,3,0,3,0,Macon,2022-02-13
0,11,0,11,0,Macon,2022-02-15
0,12,2,10,0,Macon,2022-02-16
0,6,1,5,0,Macon,2022-02-18
0,3,0,3,0,Macon,2022-02-19
0,2,1,1,0,Macon,2022-02-20
0,2,1,1,0,Macon,2022-02-23
0,3,2,1,0,Macon,2022-02-25
0,2,0,2,0,Macon,2022-02-28
0,2,0,2,0,Macon,2022-03-01
0,3,1,2,0,Macon,2022-03-03
0,2,0,2,0,Macon,2022-03-04
0,3,1,2,0,Macon,2022-03-08
0,1,0,1,0,Macon,2022-03-09
0,2,1,1,0,Macon,2022-03-10
0,2,0,2,0,Macon,2022-03-11
0,2,0,2,0,Macon,2022-03-14
0,2,0,2,0,Macon,2022-03-15
0,1,0,1,0,Macon,2022-03-16
0,2,0,2,0,Macon,2022-03-17
0,2,0,2,0,Macon,2022-03-18
0,3,1,2,0,Macon,2022-03-29
0,1,1,0,0,Macon,2022-04-01
0,1,0,1,0,Macon,2022-04-02
0,4,0,4,0,Macon,2022-04-03
0,1,1,0,0,Macon,2022-04-04
0,2,1,1,0,Macon,2022-04-07
0,3,0,3,0,Macon,2022-04-08
0,1,0,1,0,Macon,2022-04-10
0,1,0,1,0,Macon,2022-04-12
0,2,2,0,0,Macon,2022-04-16
0,2,1,1,0,Macon,2022-04-19
0,3,3,0,0,Macon,2022-04-20
0,1,0,1,0,Macon,2022-04-21
0,1,0,1,0,Macon,2022-04-22
0,1,0,1,0,Macon,2022-04-23
0,1,0,1,0,Macon,2022-04-24
0,2,0,2,0,Macon,2022-04-26
0,2,1,1,0,Macon,2022-04-27
0,4,2,2,0,Macon,2022-04-28
0,1,0,1,0,Macon,2022-04-29
0,3,0,3,0,Macon,2022-04-30
0,2,0,2,0,Macon,2022-05-01
0,2,0,2,0,Macon,2022-05-02
0,1,0,1,0,Macon,2022-05-04
0,2,0,2,0,Macon,2022-05-07
0,4,0,4,0,Macon,2022-05-08
0,2,1,1,0,Macon,2022-05-11
0,6,0,6,0,Macon,2022-05-12
0,2,0,2,0,Macon,2022-05-13
0,2,0,2,0,Macon,2022-05-15
0,4,1,3,0,Macon,2022-05-16
0,11,0,11,0,Macon,2022-05-18
0,10,1,9,0,Macon,2022-05-19
0,6,0,6,0,Macon,2022-05-20
0,7,2,5,0,Macon,2022-05-21
0,6,0,6,0,Macon,2022-05-24
0,8,0,8,0,Macon,2022-05-25
0,7,5,2,0,Macon,2022-05-27
0,1,0,1,0,Macon,2022-05-28
0,3,0,3,0,Macon,2022-05-29
0,2,0,2,0,Macon,2022-05-30
0,4,1,3,0,Macon,2022-06-04
0,2,0,2,0,Macon,2022-06-05
0,3,1,2,0,Macon,2022-06-07
0,9,1,8,0,Macon,2022-06-08
0,6,0,6,0,Macon,2022-06-09
0,7,0,7,0,Macon,2022-06-10
0,1,0,1,0,Macon,2022-06-11
1,6,2,4,0,Macon,2021-12-20
1,13,3,10,0,Macon,2021-12-22
1,44,7,37,0,Macon,2021-12-28
1,28,6,22,0,Macon,2022-01-17
1,34,10,24,0,Macon,2022-01-28
1,7,0,7,0,Macon,2022-01-29
1,11,2,9,0,Macon,2022-02-14
1,8,4,4,0,Macon,2022-02-21
1,2,1,1,0,Macon,2022-04-06
1,1,0,1,0,Macon,2022-04-14
1,5,4,1,0,Macon,2022-04-18
1,4,3,1,0,Macon,2022-05-03
1,1,0,1,0,Macon,2022-05-06
1,5,1,4,0,Macon,2022-05-09
1,9,1,8,0,Macon,2022-05-23
1,7,1,6,0,Macon,2022-05-26
1,11,5,6,0,Macon,2022-06-01
1,6,0,6,0,Macon,2022-06-02
1,12,2,10,0,Macon,2022-06-06
2,13,3,10,0,Macon,2021-12-31
2,17,2,15,0,Macon,2022-01-08
2,23,3,20,0,Macon,2022-01-15
2,28,4,24,0,Macon,2022-01-22
2,19,3,16,0,Macon,2022-01-23
2,28,4,24,0,Macon,2022-02-04
2,34,7,27,0,Macon,2022-02-07
2,15,1,14,0,Macon,2022-02-09
2,16,5,11,0,Macon,2022-02-11
2,9,2,7,0,Macon,2022-05-31
3,48,12,36,0,Macon,2021-12-29
3,23,3,20,0,Macon,2022-01-02
3,51,4,47,0,Macon,2022-01-25
3,16,2,14,0,Macon,2022-01-30
3,5,2,3,0,Macon,2022-06-03
4,32,6,26,0,Macon,2022-02-01
4,25,7,18,0,Macon,2022-02-03
5,92,25,67,0,Macon,2022-01-12
5,54,7,47,0,Macon,2022-01-26
6,91,29,62,0,Macon,2022-01-13
7,74,12,62,0,Macon,2022-01-21
9,90,15,75,0,Macon,2022-01-11
10,94,10,84,0,Macon,2022-01-24
11,71,4,67,0,Macon,2022-01-04
12,112,35,77,0,Macon,2022-01-10
,0,0,0,0,Madison,2021-12-19
,0,0,0,0,Madison,2021-12-25
,0,0,0,0,Madison,2022-03-05
,0,0,0,0,Madison,2022-03-12
,0,0,0,0,Madison,2022-03-19
,0,0,0,0,Madison,2022-03-20
,0,0,0,0,Madison,2022-03-23
,0,0,0,0,Madison,2022-03-25
,0,0,0,0,Madison,2022-03-26
,0,0,0,0,Madison,2022-03-27
,0,0,0,0,Madison,2022-03-30
,0,0,0,0,Madison,2022-04-01
,0,0,0,0,Madison,2022-04-02
,0,0,0,0,Madison,2022-04-03
,0,0,0,0,Madison,2022-04-04
,0,0,0,0,Madison,2022-04-09
,0,0,0,0,Madison,2022-04-15
,0,0,0,0,Madison,2022-05-01
,0,0,0,0,Madison,2022-05-15
0,6,3,3,0,Madison,2021-12-14
0,6,1,5,0,Madison,2021-12-17
0,4,2,2,0,Madison,2021-12-18
0,12,1,11,0,Madison,2021-12-20
0,7,2,5,0,Madison,2021-12-22
0,2,0,2,0,Madison,2021-12-24
0,8,2,6,0,Madison,2021-12-26
0,20,4,16,0,Madison,2021-12-27
0,35,2,33,0,Madison,2021-12-28
0,14,2,12,0,Madison,2022-01-01
0,4,1,3,0,Madison,2022-01-16
0,43,4,39,0,Madison,2022-01-28
0,5,2,3,0,Madison,2022-01-29
0,9,2,7,0,Madison,2022-02-12
0,11,2,9,0,Madison,2022-02-18
0,2,1,1,0,Madison,2022-02-19
0,4,4,0,0,Madison,2022-02-20
0,5,0,5,0,Madison,2022-02-23
0,8,4,4,0,Madison,2022-02-25
0,3,0,3,0,Madison,2022-02-27
0,3,1,2,0,Madison,2022-03-03
0,4,1,3,0,Madison,2022-03-04
0,1,1,0,0,Madison,2022-03-06
0,3,0,3,0,Madison,2022-03-07
0,4,2,2,0,Madison,2022-03-08
0,2,0,2,0,Madison,2022-03-10
0,1,0,1,0,Madison,2022-03-11
0,1,1,0,0,Madison,2022-03-13
0,2,0,2,0,Madison,2022-03-15
0,2,1,1,0,Madison,2022-03-16
0,1,0,1,0,Madison,2022-03-17
0,1,0,1,0,Madison,2022-03-18
0,1,0,1,0,Madison,2022-03-21
0,1,0,1,0,Madison,2022-03-22
0,1,0,1,0,Madison,2022-03-24
0,3,0,3,0,Madison,2022-03-28
0,2,0,2,0,Madison,2022-03-29
0,3,0,3,0,Madison,2022-03-31
0,3,1,2,0,Madison,2022-04-06
0,2,2,0,0,Madison,2022-04-07
0,1,0,1,0,Madison,2022-04-08
0,3,2,1,0,Madison,2022-04-12
0,3,0,3,0,Madison,2022-04-13
0,1,1,0,0,Madison,2022-04-16
0,1,0,1,0,Madison,2022-04-17
0,2,1,1,0,Madison,2022-04-19
0,6,1,5,0,Madison,2022-04-20
0,3,0,3,0,Madison,2022-04-21
0,4,1,3,0,Madison,2022-04-22
0,2,2,0,0,Madison,2022-04-23
0,2,1,1,0,Madison,2022-04-24
0,3,2,1,0,Madison,2022-04-25
0,2,1,1,0,Madison,2022-04-29
0,1,0,1,0,Madison,2022-04-30
0,3,2,1,0,Madison,2022-05-02
0,4,3,1,0,Madison,2022-05-04
0,4,3,1,0,Madison,2022-05-05
0,6,4,2,0,Madison,2022-05-06
0,1,1,0,0,Madison,2022-05-07
0,8,2,6,0,Madison,2022-05-09
0,7,6,1,0,Madison,2022-05-10
0,9,6,3,0,Madison,2022-05-12
0,11,6,5,0,Madison,2022-05-13
0,6,4,2,0,Madison,2022-05-21
0,6,2,4,0,Madison,2022-05-24
0,1,0,1,0,Madison,2022-05-29
0,13,6,7,0,Madison,2022-05-31
0,6,2,4,0,Madison,2022-06-02
0,12,2,10,0,Madison,2022-06-03
0,2,2,0,0,Madison,2022-06-05
0,6,1,5,0,Madison,2022-06-09
0,5,3,2,0,Madison,2022-06-10
0,1,1,0,0,Madison,2022-06-11
1,16,3,13,0,Madison,2021-12-15
1,16,0,16,0,Madison,2021-12-21
1,24,2,22,0,Madison,2021-12-29
1,12,1,11,0,Madison,2022-01-02
1,43,5,38,0,Madison,2022-01-21
1,10,5,5,0,Madison,2022-01-23
1,12,1,11,0,Madison,2022-01-30
1,7,1,6,0,Madison,2022-02-05
1,29,5,24,0,Madison,2022-02-09
1,7,3,4,0,Madison,2022-02-13
1,31,6,25,0,Madison,2022-02-14
1,9,1,8,0,Madison,2022-02-15
1,19,3,16,0,Madison,2022-02-17
1,6,4,2,0,Madison,2022-02-28
1,6,0,6,0,Madison,2022-03-01
1,4,0,4,0,Madison,2022-03-14
1,2,0,2,0,Madison,2022-04-10
1,4,2,2,0,Madison,2022-04-11
1,5,2,3,0,Madison,2022-04-14
1,6,2,4,0,Madison,2022-04-18
1,8,0,8,0,Madison,2022-04-26
1,7,4,3,0,Madison,2022-04-28
1,13,4,9,0,Madison,2022-05-17
1,6,3,3,0,Madison,2022-05-20
1,6,3,3,0,Madison,2022-05-22
1,5,4,1,0,Madison,2022-05-26
1,3,0,3,0,Madison,2022-05-27
1,5,3,2,0,Madison,2022-05-30
1,5,2,3,0,Madison,2022-06-04
1,6,3,3,0,Madison,2022-06-06
1,6,0,6,0,Madison,2022-06-08
2,22,0,22,0,Madison,2021-12-30
2,38,7,31,0,Madison,2022-01-26
2,37,8,29,0,Madison,2022-02-03
2,25,5,20,0,Madison,2022-02-16
2,19,6,13,0,Madison,2022-02-21
2,6,2,4,0,Madison,2022-02-24
2,6,4,2,0,Madison,2022-05-11
2,5,3,2,0,Madison,2022-05-14
2,8,5,3,0,Madison,2022-05-18
2,11,8,3,0,Madison,2022-05-19
2,13,9,4,0,Madison,2022-05-23
2,6,2,4,0,Madison,2022-05-25
2,2,1,1,0,Madison,2022-05-28
2,9,3,6,0,Madison,2022-06-01
2,8,3,5,0,Madison,2022-06-07
3,47,3,44,0,Madison,2022-01-06
3,18,7,11,0,Madison,2022-02-04
3,27,7,20,0,Madison,2022-02-10
3,5,0,5,0,Madison,2022-04-27
4,35,3,32,0,Madison,2022-01-03
4,50,5,45,0,Madison,2022-01-04
4,84,6,78,0,Madison,2022-01-19
4,33,2,31,0,Madison,2022-01-22
4,52,13,39,0,Madison,2022-02-07
5,30,2,28,0,Madison,2022-01-07
5,94,12,82,0,Madison,2022-01-10
5,62,9,53,0,Madison,2022-01-11
5,83,10,73,0,Madison,2022-01-12
5,34,2,32,0,Madison,2022-01-15
6,20,1,19,0,Madison,2022-01-17
6,63,8,55,0,Madison,2022-01-25
6,36,11,25,0,Madison,2022-02-02
7,57,3,54,0,Madison,2022-01-13
8,47,7,40,0,Madison,2022-01-31
8,26,17,9,0,Madison,2022-05-16
10,52,10,42,0,Madison,2022-01-20
10,74,19,55,0,Madison,2022-01-24
,0,0,0,0,Martin,2021-12-24
,0,0,0,0,Martin,2021-12-25
,0,0,0,0,Martin,2022-02-17
,0,0,0,0,Martin,2022-03-06
,0,0,0,0,Martin,2022-03-08
,0,0,0,0,Martin,2022-03-12
,0,0,0,0,Martin,2022-03-13
,0,0,0,0,Martin,2022-03-14
,0,0,0,0,Martin,2022-03-15
,0,0,0,0,Martin,2022-03-17
,0,0,0,0,Martin,2022-03-18
,0,0,0,0,Martin,2022-03-19
,0,0,0,0,Martin,2022-03-20
,0,0,0,0,Martin,2022-03-21
,0,0,0,0,Martin,2022-03-22
,0,0,0,0,Martin,2022-03-24
,0,0,0,0,Martin,2022-03-25
,0,0,0,0,Martin,2022-03-26
,0,0,0,0,Martin,2022-03-27
,0,0,0,0,Martin,2022-03-28
,0,0,0,0,Martin,2022-03-29
,0,0,0,0,Martin,2022-03-30
,0,0,0,0,Martin,2022-03-31
,0,0,0,0,Martin,2022-04-02
,0,0,0,0,Martin,2022-04-03
,0,0,0,0,Martin,2022-04-04
,0,0,0,0,Martin,2022-04-05
,0,0,0,0,Martin,2022-04-08
,0,0,0,0,Martin,2022-04-09
,0,0,0,0,Martin,2022-04-10
,0,0,0,0,Martin,2022-04-11
,0,0,0,0,Martin,2022-04-14
,0,0,0,0,Martin,2022-04-15
,0,0,0,0,Martin,2022-04-16
,0,0,0,0,Martin,2022-04-17
,0,0,0,0,Martin,2022-04-18
,0,0,0,0,Martin,2022-04-19
,0,0,0,0,Martin,2022-04-23
,0,0,0,0,Martin,2022-04-24
,0,0,0,0,Martin,2022-04-30
,0,0,0,0,Martin,2022-05-01
,0,0,0,0,Martin,2022-05-07
,0,0,0,0,Martin,2022-05-11
0,3,1,2,0,Martin,2021-12-14
0,2,1,1,0,Martin,2021-12-15
0,3,0,3,0,Martin,2021-12-17
0,1,1,0,0,Martin,2021-12-18
0,3,0,3,0,Martin,2021-12-19
0,11,3,8,0,Martin,2021-12-20
0,10,0,10,0,Martin,2021-12-22
0,2,1,1,0,Martin,2021-12-26
0,10,3,7,0,Martin,2022-01-01
0,2,1,1,0,Martin,2022-01-22
0,2,0,2,0,Martin,2022-01-29
0,3,1,2,0,Martin,2022-01-30
0,12,0,12,0,Martin,2022-02-04
0,1,0,1,0,Martin,2022-02-06
0,1,0,1,0,Martin,2022-02-20
0,10,1,9,0,Martin,2022-02-21
0,3,0,3,0,Martin,2022-02-22
0,2,0,2,0,Martin,2022-02-23
0,2,0,2,0,Martin,2022-02-24
0,1,0,1,0,Martin,2022-03-04
0,1,0,1,0,Martin,2022-03-05
0,1,0,1,0,Martin,2022-03-09
0,1,0,1,0,Martin,2022-03-10
0,1,0,1,0,Martin,2022-03-11
0,1,0,1,0,Martin,2022-03-16
0,1,0,1,0,Martin,2022-04-01
0,2,1,1,0,Martin,2022-04-06
0,1,0,1,0,Martin,2022-04-07
0,1,1,0,0,Martin,2022-04-12
0,1,0,1,0,Martin,2022-04-13
0,3,2,1,0,Martin,2022-04-20
0,2,0,2,0,Martin,2022-04-22
0,2,0,2,0,Martin,2022-04-28
0,3,2,1,0,Martin,2022-05-05
0,2,1,1,0,Martin,2022-05-10
0,4,1,3,0,Martin,2022-05-12
0,5,0,5,0,Martin,2022-05-13
0,1,0,1,0,Martin,2022-05-15
0,9,2,7,0,Martin,2022-05-18
0,6,2,4,0,Martin,2022-05-27
0,4,0,4,0,Martin,2022-05-29
0,4,1,3,0,Martin,2022-06-04
0,1,0,1,0,Martin,2022-06-05
0,9,2,7,0,Martin,2022-06-09
0,2,0,2,0,Martin,2022-06-10
1,3,0,3,0,Martin,2021-12-23
1,20,6,14,0,Martin,2022-01-09
1,37,9,28,0,Martin,2022-01-15
1,14,10,4,0,Martin,2022-01-16
1,4,0,4,0,Martin,2022-01-21
1,11,2,9,0,Martin,2022-02-05
1,19,1,18,0,Martin,2022-02-07
1,10,1,9,0,Martin,2022-02-10
1,14,1,13,0,Martin,2022-02-11
1,4,0,4,0,Martin,2022-02-15
1,4,1,3,0,Martin,2022-02-16
1,4,0,4,0,Martin,2022-02-18
1,4,0,4,0,Martin,2022-03-01
1,1,0,1,0,Martin,2022-03-03
1,2,1,1,0,Martin,2022-04-21
1,2,0,2,0,Martin,2022-04-27
1,3,1,2,0,Martin,2022-04-29
1,5,2,3,0,Martin,2022-05-04
1,2,1,1,0,Martin,2022-05-06
1,3,1,2,0,Martin,2022-05-09
1,9,2,7,0,Martin,2022-05-16
1,10,3,7,0,Martin,2022-05-19
1,4,0,4,0,Martin,2022-05-22
1,7,2,5,0,Martin,2022-05-26
1,4,2,2,0,Martin,2022-05-28
1,2,1,1,0,Martin,2022-05-30
1,9,3,6,0,Martin,2022-06-01
1,6,2,4,0,Martin,2022-06-03
1,2,0,2,0,Martin,2022-06-11
2,16,5,11,0,Martin,2021-12-27
2,16,0,16,0,Martin,2021-12-31
2,41,2,39,0,Martin,2022-01-31
2,21,1,20,0,Martin,2022-02-02
2,15,1,14,0,Martin,2022-02-08
2,9,2,7,0,Martin,2022-02-14
2,6,2,4,0,Martin,2022-05-02
2,9,2,7,0,Martin,2022-05-23
2,12,3,9,0,Martin,2022-05-24
2,14,5,9,0,Martin,2022-06-07
2,11,2,9,0,Martin,2022-06-08
3,53,5,48,0,Martin,2021-12-29
3,44,9,35,0,Martin,2022-01-08
3,34,2,32,0,Martin,2022-01-28
3,45,4,41,0,Martin,2022-02-01
3,14,6,8,0,Martin,2022-06-06
4,57,8,49,0,Martin,2021-12-30
4,46,13,33,0,Martin,2022-01-25
4,11,4,7,0,Martin,2022-05-20
6,74,5,69,0,Martin,2022-01-03
6,112,12,100,0,Martin,2022-01-10
7,86,4,82,0,Martin,2022-01-12
7,76,10,66,0,Martin,2022-01-20
8,105,9,96,0,Martin,2022-01-04
8,127,8,119,0,Martin,2022-01-11
8,94,23,71,0,Martin,2022-01-14
9,95,23,72,0,Martin,2022-01-17
11,110,6,104,0,Martin,2022-01-19
14,94,7,87,0,Martin,2022-01-06
,0,0,0,0,McDowell,2022-03-12
,0,0,0,0,McDowell,2022-03-19
,0,0,0,0,McDowell,2022-03-23
,0,0,0,0,McDowell,2022-03-24
,0,0,0,0,McDowell,2022-03-26
,0,0,0,0,McDowell,2022-03-27
,0,0,0,0,McDowell,2022-03-31
,0,0,0,0,McDowell,2022-04-03
,0,0,0,0,McDowell,2022-04-15
,0,0,0,0,McDowell,2022-04-17
,0,0,0,0,McDowell,2022-04-24
0,19,4,15,0,McDowell,2021-12-14
0,9,3,6,0,McDowell,2021-12-18
0,10,6,4,0,McDowell,2021-12-19
0,16,5,11,0,McDowell,2021-12-23
0,3,0,3,0,McDowell,2021-12-25
0,13,2,11,0,McDowell,2022-02-24
0,6,1,5,0,McDowell,2022-02-25
0,3,2,1,0,McDowell,2022-02-26
0,7,1,6,0,McDowell,2022-02-27
0,12,1,11,0,McDowell,2022-03-01
0,4,0,4,0,McDowell,2022-03-04
0,6,1,5,0,McDowell,2022-03-07
0,4,3,1,0,McDowell,2022-03-10
0,2,0,2,0,McDowell,2022-03-11
0,1,1,0,0,McDowell,2022-03-13
0,2,0,2,0,McDowell,2022-03-14
0,5,1,4,0,McDowell,2022-03-16
0,1,1,0,0,McDowell,2022-03-17
0,1,0,1,0,McDowell,2022-03-18
0,1,1,0,0,McDowell,2022-03-20
0,2,1,1,0,McDowell,2022-03-21
0,2,0,2,0,McDowell,2022-03-25
0,2,0,2,0,McDowell,2022-03-28
0,3,0,3,0,McDowell,2022-03-29
0,1,0,1,0,McDowell,2022-03-30
0,2,0,2,0,McDowell,2022-04-02
0,3,2,1,0,McDowell,2022-04-04
0,4,0,4,0,McDowell,2022-04-07
0,2,1,1,0,McDowell,2022-04-08
0,2,0,2,0,McDowell,2022-04-09
0,3,0,3,0,McDowell,2022-04-11
0,2,0,2,0,McDowell,2022-04-12
0,2,0,2,0,McDowell,2022-04-13
0,1,0,1,0,McDowell,2022-04-16
0,5,2,3,0,McDowell,2022-04-19
0,5,2,3,0,McDowell,2022-04-22
0,3,1,2,0,McDowell,2022-04-23
0,6,0,6,0,McDowell,2022-04-26
0,1,0,1,0,McDowell,2022-04-30
0,9,2,7,0,McDowell,2022-05-02
0,7,0,7,0,McDowell,2022-05-03
0,9,2,7,0,McDowell,2022-05-04
0,3,0,3,0,McDowell,2022-05-07
0,5,1,4,0,McDowell,2022-05-08
0,3,0,3,0,McDowell,2022-05-10
0,3,2,1,0,McDowell,2022-05-12
0,9,0,9,0,McDowell,2022-05-13
0,7,0,7,0,McDowell,2022-05-14
0,8,1,7,0,McDowell,2022-05-22
0,8,0,8,0,McDowell,2022-05-28
0,14,1,13,0,McDowell,2022-05-31
0,5,0,5,0,McDowell,2022-06-09
0,5,0,5,0,McDowell,2022-06-11
1,13,5,8,0,McDowell,2021-12-15
1,29,6,23,0,McDowell,2021-12-22
1,17,3,14,0,McDowell,2021-12-24
1,13,1,12,0,McDowell,2021-12-26
1,73,16,57,0,McDowell,2021-12-27
1,42,21,21,0,McDowell,2022-02-05
1,21,9,12,0,McDowell,2022-02-12
1,6,2,4,0,McDowell,2022-02-19
1,13,1,12,0,McDowell,2022-02-20
1,10,1,9,0,McDowell,2022-02-28
1,5,2,3,0,McDowell,2022-03-05
1,3,1,2,0,McDowell,2022-03-09
1,3,0,3,0,McDowell,2022-03-15
1,5,0,5,0,McDowell,2022-04-01
1,2,2,0,0,McDowell,2022-04-06
1,1,0,1,0,McDowell,2022-04-10
1,4,2,2,0,McDowell,2022-04-14
1,4,1,3,0,McDowell,2022-04-18
1,8,1,7,0,McDowell,2022-04-20
1,5,0,5,0,McDowell,2022-04-25
1,5,1,4,0,McDowell,2022-04-27
1,3,1,2,0,McDowell,2022-04-28
1,1,0,1,0,McDowell,2022-05-01
1,8,2,6,0,McDowell,2022-05-05
1,9,0,9,0,McDowell,2022-05-06
1,6,0,6,0,McDowell,2022-05-15
1,12,1,11,0,McDowell,2022-05-25
1,8,1,7,0,McDowell,2022-06-07
2,32,7,25,0,McDowell,2021-12-21
2,42,17,25,0,McDowell,2022-01-30
2,36,16,20,0,McDowell,2022-02-09
2,19,6,13,0,McDowell,2022-02-13
2,33,16,17,0,McDowell,2022-02-17
2,17,4,13,0,McDowell,2022-02-22
2,6,3,3,0,McDowell,2022-04-21
2,7,4,3,0,McDowell,2022-04-29
2,17,4,13,0,McDowell,2022-05-09
2,13,0,13,0,McDowell,2022-05-11
2,12,0,12,0,McDowell,2022-05-16
2,16,4,12,0,McDowell,2022-05-17
2,8,1,7,0,McDowell,2022-05-19
2,10,0,10,0,McDowell,2022-05-21
2,26,3,23,0,McDowell,2022-05-23
2,18,1,17,0,McDowell,2022-05-24
2,12,0,12,0,McDowell,2022-05-26
2,14,1,13,0,McDowell,2022-05-27
2,18,1,17,0,McDowell,2022-06-04
2,14,2,12,0,McDowell,2022-06-08
2,4,0,4,0,McDowell,2022-06-10
3,45,8,37,0,McDowell,2021-12-31
3,41,8,33,0,McDowell,2022-01-17
3,15,3,12,0,McDowell,2022-02-23
3,20,4,16,0,McDowell,2022-05-18
3,12,0,12,0,McDowell,2022-05-20
3,10,0,10,0,McDowell,2022-05-29
3,22,1,21,0,McDowell,2022-06-01
3,21,1,20,0,McDowell,2022-06-02
3,7,1,6,0,McDowell,2022-06-03
3,17,2,15,0,McDowell,2022-06-06
4,19,0,19,0,McDowell,2022-06-05
5,38,6,32,0,McDowell,2022-01-02
5,56,16,40,0,McDowell,2022-01-22
6,70,17,53,0,McDowell,2021-12-29
6,51,14,37,0,McDowell,2022-01-08
6,56,26,30,0,McDowell,2022-01-29
7,58,9,49,0,McDowell,2021-12-28
7,41,15,26,0,McDowell,2022-02-15
7,28,4,24,0,McDowell,2022-02-18
8,69,13,56,0,McDowell,2021-12-30
8,111,54,57,0,McDowell,2022-01-21
9,118,33,85,0,McDowell,2022-01-26
10,110,30,80,0,McDowell,2022-01-04
10,98,32,66,0,McDowell,2022-01-06
11,110,25,85,0,McDowell,2022-01-05
11,102,30,72,0,McDowell,2022-01-07
11,120,39,81,0,McDowell,2022-01-14
12,125,45,80,0,McDowell,2022-01-28
14,162,33,129,0,McDowell,2022-01-10
14,137,36,101,0,McDowell,2022-01-12
14,109,31,78,0,McDowell,2022-01-27
15,103,42,61,0,McDowell,2022-01-31
26,171,64,107,0,McDowell,2022-01-19
1,28,8,20,0,Mecklenburg,2022-03-12
1,20,5,15,0,Mecklenburg,2022-03-13
1,52,9,43,0,Mecklenburg,2022-03-14
1,37,7,30,0,Mecklenburg,2022-03-18
1,38,8,30,0,Mecklenburg,2022-03-26
1,46,4,42,0,Mecklenburg,2022-04-09
2,66,18,48,0,Mecklenburg,2022-03-23
2,69,14,55,0,Mecklenburg,2022-03-30
3,53,13,40,0,Mecklenburg,2022-03-09
3,69,17,52,0,Mecklenburg,2022-03-31
3,59,10,49,0,Mecklenburg,2022-04-10
4,52,9,43,0,Mecklenburg,2022-03-15
4,39,5,34,0,Mecklenburg,2022-03-27
5,95,24,71,0,Mecklenburg,2022-03-02
5,111,16,95,0,Mecklenburg,2022-04-16
5,122,30,92,0,Mecklenburg,2022-04-23
6,51,9,42,0,Mecklenburg,2022-03-22
6,108,19,89,0,Mecklenburg,2022-04-06
7,62,10,52,0,Mecklenburg,2022-04-01
8,104,17,87,0,Mecklenburg,2022-04-05
8,69,3,66,0,Mecklenburg,2022-04-17
9,57,14,43,0,Mecklenburg,2022-02-26
9,92,24,68,0,Mecklenburg,2022-04-04
9,158,35,123,0,Mecklenburg,2022-04-30
10,141,27,114,0,Mecklenburg,2022-04-24
10,303,48,255,0,Mecklenburg,2022-05-15
11,191,38,153,0,Mecklenburg,2022-04-13
12,132,19,113,0,Mecklenburg,2022-04-15
13,128,17,111,0,Mecklenburg,2022-04-07
13,151,22,129,0,Mecklenburg,2022-04-11
14,183,23,160,0,Mecklenburg,2022-04-14
15,245,36,209,0,Mecklenburg,2022-04-21
15,254,42,212,0,Mecklenburg,2022-04-29
15,194,23,171,0,Mecklenburg,2022-05-01
16,263,51,212,0,Mecklenburg,2022-04-28
16,232,27,205,0,Mecklenburg,2022-05-07
17,175,30,145,0,Mecklenburg,2022-04-22
18,225,34,191,0,Mecklenburg,2022-04-20
19,303,48,255,0,Mecklenburg,2022-04-27
20,291,47,244,0,Mecklenburg,2022-05-21
20,278,41,237,0,Mecklenburg,2022-05-28
22,228,27,201,0,Mecklenburg,2022-06-11
23,279,26,253,0,Mecklenburg,2022-05-29
24,319,45,274,0,Mecklenburg,2022-05-22
24,221,38,183,0,Mecklenburg,2022-05-30
24,261,29,232,0,Mecklenburg,2022-06-05
25,290,41,249,0,Mecklenburg,2022-04-25
26,315,61,254,0,Mecklenburg,2022-05-06
28,369,67,302,0,Mecklenburg,2022-05-05
29,397,63,334,0,Mecklenburg,2022-05-03
29,309,27,282,0,Mecklenburg,2022-05-14
32,270,54,216,0,Mecklenburg,2022-04-26
34,463,76,387,0,Mecklenburg,2022-05-26
34,447,44,403,0,Mecklenburg,2022-06-09
36,460,70,390,0,Mecklenburg,2022-05-13
36,507,70,437,0,Mecklenburg,2022-05-19
40,394,67,327,0,Mecklenburg,2022-05-02
40,417,69,348,0,Mecklenburg,2022-05-20
42,415,65,350,0,Mecklenburg,2022-06-03
43,493,57,436,0,Mecklenburg,2022-05-24
44,469,91,378,0,Mecklenburg,2022-05-16
46,468,70,398,0,Mecklenburg,2022-05-09
46,510,76,434,0,Mecklenburg,2022-05-25
49,485,57,428,0,Mecklenburg,2022-05-10
49,451,64,387,0,Mecklenburg,2022-06-06
49,413,51,362,0,Mecklenburg,2022-06-07
56,525,78,447,0,Mecklenburg,2022-05-18
59,554,79,475,0,Mecklenburg,2022-05-17
62,569,66,503,0,Mecklenburg,2022-06-01
87,1535,244,1291,0,Mecklenburg,2022-01-15
,0,0,0,0,Mitchell,2022-02-17
,0,0,0,0,Mitchell,2022-02-27
,0,0,0,0,Mitchell,2022-03-05
,0,0,0,0,Mitchell,2022-03-06
,0,0,0,0,Mitchell,2022-03-10
,0,0,0,0,Mitchell,2022-03-12
,0,0,0,0,Mitchell,2022-03-14
,0,0,0,0,Mitchell,2022-03-16
,0,0,0,0,Mitchell,2022-03-18
,0,0,0,0,Mitchell,2022-03-22
,0,0,0,0,Mitchell,2022-03-23
,0,0,0,0,Mitchell,2022-03-26
,0,0,0,0,Mitchell,2022-03-27
,0,0,0,0,Mitchell,2022-03-28
,0,0,0,0,Mitchell,2022-04-01
,0,0,0,0,Mitchell,2022-04-02
,0,0,0,0,Mitchell,2022-04-03
,0,0,0,0,Mitchell,2022-04-04
,0,0,0,0,Mitchell,2022-04-05
,0,0,0,0,Mitchell,2022-04-06
,0,0,0,0,Mitchell,2022-04-07
,0,0,0,0,Mitchell,2022-04-09
,0,0,0,0,Mitchell,2022-04-10
,0,0,0,0,Mitchell,2022-04-11
,0,0,0,0,Mitchell,2022-04-14
,0,0,0,0,Mitchell,2022-04-16
,0,0,0,0,Mitchell,2022-04-17
,0,0,0,0,Mitchell,2022-04-18
,0,0,0,0,Mitchell,2022-04-19
,0,0,0,0,Mitchell,2022-04-23
,0,0,0,0,Mitchell,2022-04-24
,0,0,0,0,Mitchell,2022-04-25
,0,0,0,0,Mitchell,2022-04-28
,0,0,0,0,Mitchell,2022-04-29
,0,0,0,0,Mitchell,2022-04-30
,0,0,0,0,Mitchell,2022-05-01
,0,0,0,0,Mitchell,2022-05-02
,0,0,0,0,Mitchell,2022-05-05
,0,0,0,0,Mitchell,2022-05-07
,0,0,0,0,Mitchell,2022-05-08
,0,0,0,0,Mitchell,2022-05-15
,0,0,0,0,Mitchell,2022-05-28
0,8,4,4,0,Mitchell,2021-12-14
0,7,3,4,0,Mitchell,2021-12-15
0,8,7,1,0,Mitchell,2021-12-16
0,7,2,5,0,Mitchell,2021-12-18
0,2,1,1,0,Mitchell,2021-12-19
0,13,4,9,0,Mitchell,2021-12-20
0,8,5,3,0,Mitchell,2021-12-22
0,13,8,5,0,Mitchell,2021-12-23
0,4,1,3,0,Mitchell,2021-12-24
0,1,0,1,0,Mitchell,2021-12-25
0,9,2,7,0,Mitchell,2021-12-31
0,8,1,7,0,Mitchell,2022-01-09
0,5,1,4,0,Mitchell,2022-01-23
0,15,2,13,0,Mitchell,2022-01-26
0,23,10,13,0,Mitchell,2022-01-31
0,14,4,10,0,Mitchell,2022-02-02
0,22,2,20,0,Mitchell,2022-02-04
0,4,2,2,0,Mitchell,2022-02-05
0,3,1,2,0,Mitchell,2022-02-06
0,8,3,5,0,Mitchell,2022-02-11
0,10,5,5,0,Mitchell,2022-02-14
0,1,0,1,0,Mitchell,2022-02-20
0,4,1,3,0,Mitchell,2022-02-22
0,3,1,2,0,Mitchell,2022-02-24
0,5,1,4,0,Mitchell,2022-02-25
0,3,2,1,0,Mitchell,2022-03-02
0,1,1,0,0,Mitchell,2022-03-04
0,1,0,1,0,Mitchell,2022-03-07
0,1,0,1,0,Mitchell,2022-03-09
0,1,1,0,0,Mitchell,2022-03-11
0,1,1,0,0,Mitchell,2022-03-13
0,1,1,0,0,Mitchell,2022-03-15
0,1,0,1,0,Mitchell,2022-03-17
0,1,0,1,0,Mitchell,2022-03-19
0,1,1,0,0,Mitchell,2022-03-20
0,2,1,1,0,Mitchell,2022-03-24
0,1,0,1,0,Mitchell,2022-03-29
0,2,1,1,0,Mitchell,2022-03-31
0,1,1,0,0,Mitchell,2022-04-08
0,1,1,0,0,Mitchell,2022-04-12
0,1,1,0,0,Mitchell,2022-04-13
0,1,0,1,0,Mitchell,2022-04-15
0,2,0,2,0,Mitchell,2022-04-21
0,1,0,1,0,Mitchell,2022-04-26
0,1,1,0,0,Mitchell,2022-04-27
0,3,2,1,0,Mitchell,2022-05-04
0,1,1,0,0,Mitchell,2022-05-06
0,1,0,1,0,Mitchell,2022-05-10
0,1,0,1,0,Mitchell,2022-05-13
0,3,3,0,0,Mitchell,2022-05-18
0,3,2,1,0,Mitchell,2022-05-19
0,5,1,4,0,Mitchell,2022-05-20
0,2,0,2,0,Mitchell,2022-05-21
0,3,0,3,0,Mitchell,2022-05-22
0,1,0,1,0,Mitchell,2022-05-24
0,4,2,2,0,Mitchell,2022-05-25
0,5,1,4,0,Mitchell,2022-05-27
0,5,0,5,0,Mitchell,2022-05-29
0,9,5,4,0,Mitchell,2022-06-09
0,2,2,0,0,Mitchell,2022-06-11
1,34,23,11,0,Mitchell,2021-12-27
1,23,5,18,0,Mitchell,2021-12-28
1,9,3,6,0,Mitchell,2022-01-01
1,5,2,3,0,Mitchell,2022-01-02
1,29,1,28,0,Mitchell,2022-01-12
1,20,6,14,0,Mitchell,2022-01-15
1,6,5,1,0,Mitchell,2022-01-17
1,25,3,22,0,Mitchell,2022-01-21
1,7,4,3,0,Mitchell,2022-01-30
1,11,5,6,0,Mitchell,2022-02-10
1,6,4,2,0,Mitchell,2022-02-12
1,8,6,2,0,Mitchell,2022-02-15
1,3,2,1,0,Mitchell,2022-02-23
1,3,1,2,0,Mitchell,2022-02-28
1,3,1,2,0,Mitchell,2022-03-01
1,1,0,1,0,Mitchell,2022-03-08
1,1,0,1,0,Mitchell,2022-03-25
1,5,1,4,0,Mitchell,2022-03-30
1,1,0,1,0,Mitchell,2022-04-20
1,2,0,2,0,Mitchell,2022-04-22
1,3,2,1,0,Mitchell,2022-05-03
1,2,1,1,0,Mitchell,2022-05-09
1,1,1,0,0,Mitchell,2022-05-11
1,4,3,1,0,Mitchell,2022-05-12
1,4,4,0,0,Mitchell,2022-05-17
1,5,3,2,0,Mitchell,2022-05-26
1,5,0,5,0,Mitchell,2022-05-30
1,10,4,6,0,Mitchell,2022-05-31
1,4,2,2,0,Mitchell,2022-06-01
1,5,0,5,0,Mitchell,2022-06-04
1,2,1,1,0,Mitchell,2022-06-05
1,16,11,5,0,Mitchell,2022-06-06
1,5,3,2,0,Mitchell,2022-06-10
2,21,6,15,0,Mitchell,2022-01-18
2,6,5,1,0,Mitchell,2022-01-29
2,11,5,6,0,Mitchell,2022-02-09
2,11,7,4,0,Mitchell,2022-02-16
2,6,5,1,0,Mitchell,2022-05-14
2,5,3,2,0,Mitchell,2022-05-16
2,13,7,6,0,Mitchell,2022-05-23
2,10,8,2,0,Mitchell,2022-06-02
2,6,4,2,0,Mitchell,2022-06-08
3,38,11,27,0,Mitchell,2022-01-06
3,53,8,45,0,Mitchell,2022-01-10
3,40,6,34,0,Mitchell,2022-01-14
3,19,2,17,0,Mitchell,2022-01-20
3,26,11,15,0,Mitchell,2022-01-25
3,23,3,20,0,Mitchell,2022-02-07
3,11,6,5,0,Mitchell,2022-06-07
4,27,11,16,0,Mitchell,2021-12-29
4,34,10,24,0,Mitchell,2022-01-05
4,21,1,20,0,Mitchell,2022-01-08
4,11,3,8,0,Mitchell,2022-02-21
5,45,10,35,0,Mitchell,2022-01-04
5,22,6,16,0,Mitchell,2022-02-08
5,12,8,4,0,Mitchell,2022-06-03
6,18,7,11,0,Mitchell,2022-01-27
6,30,15,15,0,Mitchell,2022-02-01
7,53,15,38,0,Mitchell,2022-01-24
,0,0,0,0,Montgomery,2022-02-26
,0,0,0,0,Montgomery,2022-02-27
,0,0,0,0,Montgomery,2022-03-05
,0,0,0,0,Montgomery,2022-03-06
,0,0,0,0,Montgomery,2022-03-10
,0,0,0,0,Montgomery,2022-03-12
,0,0,0,0,Montgomery,2022-03-13
,0,0,0,0,Montgomery,2022-03-15
,0,0,0,0,Montgomery,2022-03-16
,0,0,0,0,Montgomery,2022-03-18
,0,0,0,0,Montgomery,2022-03-19
,0,0,0,0,Montgomery,2022-03-20
,0,0,0,0,Montgomery,2022-03-21
,0,0,0,0,Montgomery,2022-03-24
,0,0,0,0,Montgomery,2022-03-28
,0,0,0,0,Montgomery,2022-03-30
,0,0,0,0,Montgomery,2022-03-31
,0,0,0,0,Montgomery,2022-04-01
,0,0,0,0,Montgomery,2022-04-02
,0,0,0,0,Montgomery,2022-04-03
,0,0,0,0,Montgomery,2022-04-04
,0,0,0,0,Montgomery,2022-04-06
,0,0,0,0,Montgomery,2022-04-07
,0,0,0,0,Montgomery,2022-04-08
,0,0,0,0,Montgomery,2022-04-09
,0,0,0,0,Montgomery,2022-04-10
,0,0,0,0,Montgomery,2022-04-11
,0,0,0,0,Montgomery,2022-04-13
,0,0,0,0,Montgomery,2022-04-14
,0,0,0,0,Montgomery,2022-04-15
,0,0,0,0,Montgomery,2022-04-16
,0,0,0,0,Montgomery,2022-04-17
,0,0,0,0,Montgomery,2022-04-18
,0,0,0,0,Montgomery,2022-04-19
,0,0,0,0,Montgomery,2022-04-21
,0,0,0,0,Montgomery,2022-04-22
,0,0,0,0,Montgomery,2022-04-23
,0,0,0,0,Montgomery,2022-04-24
,0,0,0,0,Montgomery,2022-05-01
,0,0,0,0,Montgomery,2022-05-07
0,8,0,8,0,Montgomery,2021-12-14
0,3,0,3,0,Montgomery,2021-12-18
0,2,1,1,0,Montgomery,2021-12-19
0,13,0,13,0,Montgomery,2021-12-22
0,1,0,1,0,Montgomery,2021-12-25
0,25,5,20,0,Montgomery,2021-12-27
0,3,0,3,0,Montgomery,2022-01-16
0,17,3,14,0,Montgomery,2022-01-22
0,17,3,14,0,Montgomery,2022-01-23
0,21,2,19,0,Montgomery,2022-02-01
0,12,2,10,0,Montgomery,2022-02-04
0,7,1,6,0,Montgomery,2022-02-17
0,11,1,10,0,Montgomery,2022-02-18
0,2,0,2,0,Montgomery,2022-02-20
0,5,1,4,0,Montgomery,2022-02-21
0,5,1,4,0,Montgomery,2022-02-23
0,2,0,2,0,Montgomery,2022-03-01
0,1,0,1,0,Montgomery,2022-03-02
0,2,0,2,0,Montgomery,2022-03-04
0,2,0,2,0,Montgomery,2022-03-09
0,2,0,2,0,Montgomery,2022-03-11
0,1,0,1,0,Montgomery,2022-03-17
0,1,0,1,0,Montgomery,2022-03-22
0,1,0,1,0,Montgomery,2022-03-23
0,1,1,0,0,Montgomery,2022-03-25
0,1,0,1,0,Montgomery,2022-03-26
0,1,0,1,0,Montgomery,2022-03-27
0,2,1,1,0,Montgomery,2022-03-29
0,1,0,1,0,Montgomery,2022-04-12
0,5,5,0,0,Montgomery,2022-04-25
0,4,1,3,0,Montgomery,2022-04-27
0,1,1,0,0,Montgomery,2022-04-30
0,4,1,3,0,Montgomery,2022-05-05
0,1,0,1,0,Montgomery,2022-05-06
0,1,0,1,0,Montgomery,2022-05-08
0,1,0,1,0,Montgomery,2022-05-11
0,4,1,3,0,Montgomery,2022-05-12
0,4,0,4,0,Montgomery,2022-05-13
0,6,0,6,0,Montgomery,2022-05-15
0,2,1,1,0,Montgomery,2022-05-17
0,2,0,2,0,Montgomery,2022-05-18
0,4,3,1,0,Montgomery,2022-05-19
0,5,2,3,0,Montgomery,2022-05-20
0,10,2,8,0,Montgomery,2022-05-23
0,1,0,1,0,Montgomery,2022-05-29
0,5,2,3,0,Montgomery,2022-05-31
0,7,1,6,0,Montgomery,2022-06-01
0,3,1,2,0,Montgomery,2022-06-02
0,2,0,2,0,Montgomery,2022-06-03
0,8,3,5,0,Montgomery,2022-06-08
0,4,2,2,0,Montgomery,2022-06-09
1,5,0,5,0,Montgomery,2021-12-17
1,9,0,9,0,Montgomery,2021-12-20
1,10,2,8,0,Montgomery,2021-12-23
1,9,1,8,0,Montgomery,2021-12-24
1,28,6,22,0,Montgomery,2021-12-31
1,9,0,9,0,Montgomery,2022-01-01
1,5,1,4,0,Montgomery,2022-02-13
1,8,0,8,0,Montgomery,2022-02-15
1,4,2,2,0,Montgomery,2022-02-25
1,2,1,1,0,Montgomery,2022-02-28
1,4,2,2,0,Montgomery,2022-03-07
1,1,1,0,0,Montgomery,2022-03-14
1,1,0,1,0,Montgomery,2022-04-05
1,1,1,0,0,Montgomery,2022-04-20
1,4,2,2,0,Montgomery,2022-04-26
1,2,1,1,0,Montgomery,2022-04-29
1,2,0,2,0,Montgomery,2022-05-09
1,6,1,5,0,Montgomery,2022-05-10
1,2,0,2,0,Montgomery,2022-05-22
1,2,1,1,0,Montgomery,2022-05-24
1,5,3,2,0,Montgomery,2022-06-04
1,9,1,8,0,Montgomery,2022-06-07
1,3,1,2,0,Montgomery,2022-06-10
1,3,0,3,0,Montgomery,2022-06-11
2,10,0,10,0,Montgomery,2021-12-15
2,13,3,10,0,Montgomery,2022-02-10
2,10,1,9,0,Montgomery,2022-02-16
2,4,1,3,0,Montgomery,2022-02-24
2,2,1,1,0,Montgomery,2022-03-03
2,4,2,2,0,Montgomery,2022-05-04
2,6,2,4,0,Montgomery,2022-05-26
2,7,1,6,0,Montgomery,2022-05-27
2,6,4,2,0,Montgomery,2022-05-28
2,3,0,3,0,Montgomery,2022-06-06
3,30,2,28,0,Montgomery,2021-12-28
3,32,2,30,0,Montgomery,2021-12-29
3,20,2,18,0,Montgomery,2022-01-02
3,58,11,47,0,Montgomery,2022-01-25
3,16,1,15,0,Montgomery,2022-02-11
3,7,3,4,0,Montgomery,2022-02-22
4,53,11,42,0,Montgomery,2022-01-03
4,43,11,32,0,Montgomery,2022-01-27
5,37,5,32,0,Montgomery,2022-01-31
6,83,9,74,0,Montgomery,2022-01-04
6,71,13,58,0,Montgomery,2022-01-20
6,56,3,53,0,Montgomery,2022-01-26
7,42,6,36,0,Montgomery,2022-01-08
7,55,12,43,0,Montgomery,2022-01-21
9,98,12,86,0,Montgomery,2022-01-14
9,61,17,44,0,Montgomery,2022-01-17
9,87,11,76,0,Montgomery,2022-01-24
10,78,14,64,0,Montgomery,2022-01-05
10,87,10,77,0,Montgomery,2022-01-06
12,133,15,118,0,Montgomery,2022-01-12
17,114,15,99,0,Montgomery,2022-01-19
18,144,17,127,0,Montgomery,2022-01-18
19,143,11,132,0,Montgomery,2022-01-11
21,139,17,122,0,Montgomery,2022-01-10
,0,0,0,0,Moore,2022-03-12
,0,0,0,0,Moore,2022-03-20
,0,0,0,0,Moore,2022-03-29
0,32,3,29,0,Moore,2021-12-15
0,22,4,18,0,Moore,2022-02-05
0,31,5,26,0,Moore,2022-02-22
0,9,2,7,0,Moore,2022-02-25
0,8,4,4,0,Moore,2022-02-27
0,10,1,9,0,Moore,2022-03-04
0,4,1,3,0,Moore,2022-03-08
0,3,1,2,0,Moore,2022-03-13
0,8,0,8,0,Moore,2022-03-14
0,5,0,5,0,Moore,2022-03-16
0,3,0,3,0,Moore,2022-03-17
0,3,0,3,0,Moore,2022-03-18
0,1,0,1,0,Moore,2022-03-19
0,2,0,2,0,Moore,2022-03-21
0,3,1,2,0,Moore,2022-03-22
0,1,0,1,0,Moore,2022-03-23
0,1,0,1,0,Moore,2022-03-24
0,1,0,1,0,Moore,2022-03-25
0,2,2,0,0,Moore,2022-03-26
0,3,1,2,0,Moore,2022-03-28
0,4,2,2,0,Moore,2022-03-30
0,3,1,2,0,Moore,2022-03-31
0,1,0,1,0,Moore,2022-04-01
0,1,1,0,0,Moore,2022-04-02
0,1,0,1,0,Moore,2022-04-03
0,3,1,2,0,Moore,2022-04-04
0,1,0,1,0,Moore,2022-04-05
0,2,1,1,0,Moore,2022-04-08
0,2,0,2,0,Moore,2022-04-09
0,1,0,1,0,Moore,2022-04-10
0,10,5,5,0,Moore,2022-04-14
0,12,3,9,0,Moore,2022-04-16
0,4,2,2,0,Moore,2022-04-17
0,10,2,8,0,Moore,2022-04-18
0,14,6,8,0,Moore,2022-04-19
0,10,2,8,0,Moore,2022-04-21
0,13,7,6,0,Moore,2022-04-23
0,10,3,7,0,Moore,2022-04-26
0,23,10,13,0,Moore,2022-05-06
0,29,10,19,0,Moore,2022-05-29
0,23,9,14,0,Moore,2022-06-03
0,10,0,10,0,Moore,2022-06-11
1,28,2,26,0,Moore,2021-12-17
1,28,2,26,0,Moore,2021-12-19
1,49,5,44,0,Moore,2021-12-20
1,12,1,11,0,Moore,2021-12-25
1,41,6,35,0,Moore,2022-01-29
1,20,6,14,0,Moore,2022-02-20
1,7,1,6,0,Moore,2022-03-02
1,6,0,6,0,Moore,2022-03-15
1,2,1,1,0,Moore,2022-03-27
1,6,2,4,0,Moore,2022-04-07
1,9,2,7,0,Moore,2022-04-11
1,5,2,3,0,Moore,2022-04-12
1,7,2,5,0,Moore,2022-04-13
1,7,3,4,0,Moore,2022-04-22
1,15,4,11,0,Moore,2022-04-27
1,12,4,8,0,Moore,2022-04-30
1,8,6,2,0,Moore,2022-05-01
1,32,10,22,0,Moore,2022-05-02
1,15,1,14,0,Moore,2022-05-10
1,36,10,26,0,Moore,2022-05-18
1,31,11,20,0,Moore,2022-05-22
1,32,14,18,0,Moore,2022-05-27
1,36,9,27,0,Moore,2022-05-28
1,19,10,9,0,Moore,2022-05-30
1,12,4,8,0,Moore,2022-06-04
1,26,10,16,0,Moore,2022-06-08
2,32,6,26,0,Moore,2021-12-16
2,35,7,28,0,Moore,2022-01-22
2,27,6,21,0,Moore,2022-02-13
2,17,3,14,0,Moore,2022-02-28
2,7,3,4,0,Moore,2022-04-15
2,10,3,7,0,Moore,2022-04-24
2,12,5,7,0,Moore,2022-04-25
2,13,4,9,0,Moore,2022-04-29
2,14,2,12,0,Moore,2022-05-05
2,13,2,11,0,Moore,2022-05-08
2,14,6,8,0,Moore,2022-05-14
2,35,13,22,0,Moore,2022-05-17
2,30,9,21,0,Moore,2022-05-19
2,41,13,28,0,Moore,2022-06-01
2,30,10,20,0,Moore,2022-06-07
2,23,10,13,0,Moore,2022-06-09
3,40,1,39,0,Moore,2021-12-24
3,80,12,68,0,Moore,2022-01-01
3,40,5,35,0,Moore,2022-02-17
3,11,2,9,0,Moore,2022-04-20
3,24,11,13,0,Moore,2022-05-04
3,15,2,13,0,Moore,2022-05-07
3,35,14,21,0,Moore,2022-05-09
3,17,7,10,0,Moore,2022-05-15
3,42,14,28,0,Moore,2022-05-16
3,27,6,21,0,Moore,2022-05-20
3,26,5,21,0,Moore,2022-05-24
3,12,6,6,0,Moore,2022-06-10
4,55,7,48,0,Moore,2021-12-23
4,100,7,93,0,Moore,2021-12-27
4,23,9,14,0,Moore,2022-05-21
4,42,12,30,0,Moore,2022-05-25
4,30,7,23,0,Moore,2022-06-06
5,110,13,97,0,Moore,2021-12-31
5,34,7,27,0,Moore,2022-02-21
5,44,19,25,0,Moore,2022-05-12
5,23,10,13,0,Moore,2022-05-13
5,27,9,18,0,Moore,2022-05-26
5,37,14,23,0,Moore,2022-06-02
6,104,10,94,0,Moore,2022-01-28
6,47,19,28,0,Moore,2022-05-31
8,45,14,31,0,Moore,2022-05-23
10,187,33,154,0,Moore,2021-12-28
10,168,33,135,0,Moore,2022-01-21
11,155,24,131,0,Moore,2022-01-31
12,203,15,188,0,Moore,2022-01-08
13,179,24,155,0,Moore,2021-12-30
14,204,30,174,0,Moore,2021-12-29
19,241,30,211,0,Moore,2022-01-03
21,417,47,370,0,Moore,2022-01-12
22,268,15,253,0,Moore,2022-01-07
22,206,20,186,0,Moore,2022-01-15
25,332,53,279,0,Moore,2022-01-17
29,430,41,389,0,Moore,2022-01-13
34,395,22,373,0,Moore,2022-01-14
,0,0,0,0,Nash,2022-03-19
,0,0,0,0,Nash,2022-03-26
,0,0,0,0,Nash,2022-03-31
,0,0,0,0,Nash,2022-04-03
0,29,4,25,0,Nash,2021-12-14
0,29,5,24,0,Nash,2021-12-25
0,6,2,4,0,Nash,2022-02-27
0,4,0,4,0,Nash,2022-03-04
0,7,0,7,0,Nash,2022-03-05
0,5,0,5,0,Nash,2022-03-07
0,6,0,6,0,Nash,2022-03-08
0,4,0,4,0,Nash,2022-03-09
0,5,0,5,0,Nash,2022-03-10
0,3,1,2,0,Nash,2022-03-11
0,1,0,1,0,Nash,2022-03-12
0,3,0,3,0,Nash,2022-03-13
0,3,0,3,0,Nash,2022-03-15
0,3,0,3,0,Nash,2022-03-16
0,6,0,6,0,Nash,2022-03-17
0,2,0,2,0,Nash,2022-03-18
0,1,0,1,0,Nash,2022-03-20
0,6,0,6,0,Nash,2022-03-23
0,2,0,2,0,Nash,2022-03-25
0,2,0,2,0,Nash,2022-03-27
0,3,1,2,0,Nash,2022-03-28
0,1,0,1,0,Nash,2022-03-29
0,1,0,1,0,Nash,2022-03-30
0,1,0,1,0,Nash,2022-04-01
0,2,0,2,0,Nash,2022-04-04
0,3,0,3,0,Nash,2022-04-07
0,1,0,1,0,Nash,2022-04-08
0,2,0,2,0,Nash,2022-04-09
0,9,1,8,0,Nash,2022-04-11
0,4,0,4,0,Nash,2022-04-15
0,2,0,2,0,Nash,2022-04-17
0,5,1,4,0,Nash,2022-04-18
0,9,6,3,0,Nash,2022-04-19
0,6,1,5,0,Nash,2022-04-22
0,8,3,5,0,Nash,2022-04-26
0,7,3,4,0,Nash,2022-05-06
0,7,1,6,0,Nash,2022-05-07
1,34,3,31,0,Nash,2021-12-18
1,10,2,8,0,Nash,2022-02-13
1,11,4,7,0,Nash,2022-02-28
1,8,2,6,0,Nash,2022-03-03
1,4,0,4,0,Nash,2022-03-21
1,7,0,7,0,Nash,2022-04-13
1,5,1,4,0,Nash,2022-04-23
1,5,0,5,0,Nash,2022-04-25
1,10,0,10,0,Nash,2022-04-28
1,12,5,7,0,Nash,2022-04-29
1,5,0,5,0,Nash,2022-04-30
1,2,0,2,0,Nash,2022-05-01
1,10,4,6,0,Nash,2022-05-02
1,10,0,10,0,Nash,2022-05-03
1,14,4,10,0,Nash,2022-05-04
1,7,1,6,0,Nash,2022-05-08
1,11,5,6,0,Nash,2022-05-13
1,16,3,13,0,Nash,2022-05-14
1,22,4,18,0,Nash,2022-05-21
1,24,5,19,0,Nash,2022-05-29
1,22,5,17,0,Nash,2022-06-03
1,22,6,16,0,Nash,2022-06-08
2,32,10,22,0,Nash,2022-02-14
2,6,2,4,0,Nash,2022-03-01
2,7,3,4,0,Nash,2022-04-14
2,21,3,18,0,Nash,2022-04-21
2,9,1,8,0,Nash,2022-05-05
2,21,3,18,0,Nash,2022-05-09
2,22,7,15,0,Nash,2022-05-11
2,32,5,27,0,Nash,2022-05-26
2,17,8,9,0,Nash,2022-06-04
3,62,0,62,0,Nash,2021-12-20
3,59,4,55,0,Nash,2021-12-21
3,15,1,14,0,Nash,2022-02-25
3,6,2,4,0,Nash,2022-04-24
3,8,3,5,0,Nash,2022-05-15
3,33,5,28,0,Nash,2022-05-20
3,25,6,19,0,Nash,2022-05-22
3,26,6,20,0,Nash,2022-05-25
3,13,5,8,0,Nash,2022-05-28
4,43,10,33,0,Nash,2021-12-24
4,33,12,21,0,Nash,2022-02-06
4,51,9,42,0,Nash,2022-02-09
4,21,2,19,0,Nash,2022-02-21
4,18,1,17,0,Nash,2022-02-24
4,13,2,11,0,Nash,2022-04-20
4,18,5,13,0,Nash,2022-05-10
4,29,7,22,0,Nash,2022-05-18
4,37,1,36,0,Nash,2022-06-01
4,34,3,31,0,Nash,2022-06-07
5,99,12,87,0,Nash,2022-01-08
5,30,1,29,0,Nash,2022-01-22
5,27,6,21,0,Nash,2022-05-12
5,29,10,19,0,Nash,2022-05-23
5,26,3,23,0,Nash,2022-06-10
5,22,8,14,0,Nash,2022-06-11
6,39,10,29,0,Nash,2022-05-16
6,31,8,23,0,Nash,2022-05-19
6,27,8,19,0,Nash,2022-05-27
6,53,18,35,0,Nash,2022-05-31
7,64,7,57,0,Nash,2022-01-01
7,75,15,60,0,Nash,2022-02-03
7,33,6,27,0,Nash,2022-05-17
9,66,13,53,0,Nash,2021-12-22
9,122,8,114,0,Nash,2022-01-02
9,36,6,30,0,Nash,2022-06-02
10,96,12,84,0,Nash,2022-02-01
13,47,15,32,0,Nash,2022-06-06
19,266,34,232,0,Nash,2022-01-17
20,294,39,255,0,Nash,2021-12-29
22,271,27,244,0,Nash,2022-01-20
23,244,20,224,0,Nash,2021-12-28
25,359,25,334,0,Nash,2022-01-11
26,395,56,339,0,Nash,2021-12-30
27,294,22,272,0,Nash,2022-01-14
31,409,27,382,0,Nash,2022-01-12
,0,0,0,0,New Hanover,2022-03-26
0,12,3,9,0,New Hanover,2022-03-01
0,10,0,10,0,New Hanover,2022-03-04
0,6,3,3,0,New Hanover,2022-03-13
0,8,0,8,0,New Hanover,2022-03-14
0,6,0,6,0,New Hanover,2022-03-16
0,3,1,2,0,New Hanover,2022-03-19
0,8,2,6,0,New Hanover,2022-03-20
0,6,1,5,0,New Hanover,2022-03-22
0,8,3,5,0,New Hanover,2022-03-24
0,5,1,4,0,New Hanover,2022-03-28
0,9,5,4,0,New Hanover,2022-04-01
0,5,1,4,0,New Hanover,2022-04-03
0,14,3,11,0,New Hanover,2022-04-05
0,11,4,7,0,New Hanover,2022-04-08
0,8,1,7,0,New Hanover,2022-04-09
0,20,1,19,0,New Hanover,2022-04-12
0,18,4,14,0,New Hanover,2022-04-15
0,8,1,7,0,New Hanover,2022-04-16
0,5,1,4,0,New Hanover,2022-04-17
0,26,2,24,0,New Hanover,2022-04-22
0,16,4,12,0,New Hanover,2022-04-24
0,19,1,18,0,New Hanover,2022-05-08
1,37,8,29,0,New Hanover,2022-02-18
1,38,12,26,0,New Hanover,2022-02-23
1,32,5,27,0,New Hanover,2022-02-24
1,5,2,3,0,New Hanover,2022-03-06
1,16,4,12,0,New Hanover,2022-03-23
1,7,1,6,0,New Hanover,2022-03-25
1,4,0,4,0,New Hanover,2022-03-27
1,10,2,8,0,New Hanover,2022-03-29
1,10,4,6,0,New Hanover,2022-03-30
1,8,5,3,0,New Hanover,2022-03-31
1,6,0,6,0,New Hanover,2022-04-02
1,17,6,11,0,New Hanover,2022-04-04
1,5,1,4,0,New Hanover,2022-04-10
1,16,8,8,0,New Hanover,2022-04-11
1,36,6,30,0,New Hanover,2022-04-18
1,27,6,21,0,New Hanover,2022-04-23
1,39,15,24,0,New Hanover,2022-04-27
1,41,12,29,0,New Hanover,2022-04-29
1,22,8,14,0,New Hanover,2022-05-07
1,32,10,22,0,New Hanover,2022-05-22
1,29,3,26,0,New Hanover,2022-05-29
2,57,19,38,0,New Hanover,2021-12-15
2,17,5,12,0,New Hanover,2022-03-09
2,36,11,25,0,New Hanover,2022-04-13
2,26,7,19,0,New Hanover,2022-04-19
2,24,5,19,0,New Hanover,2022-04-21
2,11,4,7,0,New Hanover,2022-04-30
2,69,11,58,0,New Hanover,2022-05-09
2,48,12,36,0,New Hanover,2022-05-10
2,64,14,50,0,New Hanover,2022-05-11
2,32,6,26,0,New Hanover,2022-05-14
3,50,9,41,0,New Hanover,2021-12-18
3,11,3,8,0,New Hanover,2022-03-15
3,24,5,19,0,New Hanover,2022-04-14
3,31,8,23,0,New Hanover,2022-04-20
3,41,11,30,0,New Hanover,2022-04-26
3,51,8,43,0,New Hanover,2022-05-05
3,52,7,45,0,New Hanover,2022-05-12
3,69,12,57,0,New Hanover,2022-05-18
3,31,8,23,0,New Hanover,2022-05-30
3,59,18,41,0,New Hanover,2022-06-03
3,73,14,59,0,New Hanover,2022-06-08
3,77,22,55,0,New Hanover,2022-06-10
4,124,51,73,0,New Hanover,2021-12-20
4,50,9,41,0,New Hanover,2022-04-25
4,38,8,30,0,New Hanover,2022-04-28
4,56,17,39,0,New Hanover,2022-05-02
4,61,10,51,0,New Hanover,2022-05-04
4,48,15,33,0,New Hanover,2022-05-06
4,44,19,25,0,New Hanover,2022-05-15
4,76,17,59,0,New Hanover,2022-05-16
4,77,21,56,0,New Hanover,2022-05-20
4,42,4,38,0,New Hanover,2022-06-04
4,53,9,44,0,New Hanover,2022-06-09
4,42,7,35,0,New Hanover,2022-06-11
5,84,27,57,0,New Hanover,2022-02-11
5,73,21,52,0,New Hanover,2022-05-23
5,83,16,67,0,New Hanover,2022-06-01
5,84,12,72,0,New Hanover,2022-06-02
5,35,5,30,0,New Hanover,2022-06-05
6,104,36,68,0,New Hanover,2021-12-24
6,89,15,74,0,New Hanover,2022-05-24
6,55,14,41,0,New Hanover,2022-05-27
7,78,15,63,0,New Hanover,2022-05-26
8,54,10,44,0,New Hanover,2022-05-13
8,74,11,63,0,New Hanover,2022-06-06
8,73,10,63,0,New Hanover,2022-06-07
10,191,59,132,0,New Hanover,2022-01-02
10,87,12,75,0,New Hanover,2022-05-19
10,103,11,92,0,New Hanover,2022-05-31
11,195,36,159,0,New Hanover,2021-12-22
15,200,53,147,0,New Hanover,2021-12-23
18,259,36,223,0,New Hanover,2022-01-16
18,257,69,188,0,New Hanover,2022-02-02
26,395,100,295,0,New Hanover,2021-12-27
27,472,95,377,0,New Hanover,2021-12-29
35,480,148,332,0,New Hanover,2021-12-30
35,569,105,464,0,New Hanover,2022-01-07
35,766,145,621,0,New Hanover,2022-01-17
38,682,129,553,0,New Hanover,2022-01-14
41,656,112,544,0,New Hanover,2022-01-06
47,645,169,476,0,New Hanover,2022-01-03
53,888,201,687,0,New Hanover,2022-01-19
58,716,243,473,0,New Hanover,2022-01-04
,0,0,0,0,Northampton,2022-02-19
,0,0,0,0,Northampton,2022-03-01
,0,0,0,0,Northampton,2022-03-05
,0,0,0,0,Northampton,2022-03-08
,0,0,0,0,Northampton,2022-03-09
,0,0,0,0,Northampton,2022-03-10
,0,0,0,0,Northampton,2022-03-11
,0,0,0,0,Northampton,2022-03-13
,0,0,0,0,Northampton,2022-03-14
,0,0,0,0,Northampton,2022-03-15
,0,0,0,0,Northampton,2022-03-17
,0,0,0,0,Northampton,2022-03-18
,0,0,0,0,Northampton,2022-03-19
,0,0,0,0,Northampton,2022-03-20
,0,0,0,0,Northampton,2022-03-23
,0,0,0,0,Northampton,2022-03-24
,0,0,0,0,Northampton,2022-03-25
,0,0,0,0,Northampton,2022-03-26
,0,0,0,0,Northampton,2022-03-27
,0,0,0,0,Northampton,2022-03-28
,0,0,0,0,Northampton,2022-03-29
,0,0,0,0,Northampton,2022-03-30
,0,0,0,0,Northampton,2022-03-31
,0,0,0,0,Northampton,2022-04-01
,0,0,0,0,Northampton,2022-04-02
,0,0,0,0,Northampton,2022-04-03
,0,0,0,0,Northampton,2022-04-04
,0,0,0,0,Northampton,2022-04-05
,0,0,0,0,Northampton,2022-04-07
,0,0,0,0,Northampton,2022-04-09
,0,0,0,0,Northampton,2022-04-10
,0,0,0,0,Northampton,2022-04-11
,0,0,0,0,Northampton,2022-04-12
,0,0,0,0,Northampton,2022-04-14
,0,0,0,0,Northampton,2022-04-15
,0,0,0,0,Northampton,2022-04-17
,0,0,0,0,Northampton,2022-04-18
,0,0,0,0,Northampton,2022-04-23
,0,0,0,0,Northampton,2022-04-24
,0,0,0,0,Northampton,2022-04-27
,0,0,0,0,Northampton,2022-04-30
,0,0,0,0,Northampton,2022-05-01
,0,0,0,0,Northampton,2022-05-06
,0,0,0,0,Northampton,2022-05-13
,0,0,0,0,Northampton,2022-05-15
0,2,1,1,0,Northampton,2021-12-15
0,3,2,1,0,Northampton,2021-12-18
0,1,0,1,0,Northampton,2021-12-19
0,8,1,7,0,Northampton,2021-12-21
0,9,2,7,0,Northampton,2021-12-22
0,2,0,2,0,Northampton,2021-12-24
0,18,2,16,0,Northampton,2022-01-02
0,5,1,4,0,Northampton,2022-01-16
0,3,1,2,0,Northampton,2022-01-22
0,6,1,5,0,Northampton,2022-01-29
0,6,2,4,0,Northampton,2022-02-03
0,2,1,1,0,Northampton,2022-02-05
0,4,1,3,0,Northampton,2022-02-06
0,9,1,8,0,Northampton,2022-02-07
0,1,0,1,0,Northampton,2022-02-08
0,6,2,4,0,Northampton,2022-02-09
0,6,0,6,0,Northampton,2022-02-10
0,2,0,2,0,Northampton,2022-02-16
0,4,0,4,0,Northampton,2022-02-17
0,1,0,1,0,Northampton,2022-02-18
0,5,2,3,0,Northampton,2022-02-21
0,1,0,1,0,Northampton,2022-02-23
0,1,0,1,0,Northampton,2022-02-24
0,1,0,1,0,Northampton,2022-02-26
0,1,0,1,0,Northampton,2022-02-28
0,1,0,1,0,Northampton,2022-03-02
0,2,1,1,0,Northampton,2022-03-03
0,1,1,0,0,Northampton,2022-03-04
0,1,0,1,0,Northampton,2022-03-06
0,1,0,1,0,Northampton,2022-03-07
0,1,0,1,0,Northampton,2022-03-12
0,4,0,4,0,Northampton,2022-03-21
0,1,0,1,0,Northampton,2022-03-22
0,1,1,0,0,Northampton,2022-04-06
0,1,0,1,0,Northampton,2022-04-08
0,1,0,1,0,Northampton,2022-04-13
0,1,0,1,0,Northampton,2022-04-16
0,1,0,1,0,Northampton,2022-04-19
0,2,0,2,0,Northampton,2022-04-20
0,1,0,1,0,Northampton,2022-04-21
0,1,1,0,0,Northampton,2022-04-22
0,2,0,2,0,Northampton,2022-04-29
0,3,0,3,0,Northampton,2022-05-03
0,5,2,3,0,Northampton,2022-05-04
0,2,1,1,0,Northampton,2022-05-05
0,1,0,1,0,Northampton,2022-05-07
0,1,1,0,0,Northampton,2022-05-08
0,4,0,4,0,Northampton,2022-05-09
0,3,1,2,0,Northampton,2022-05-22
0,4,1,3,0,Northampton,2022-05-23
0,2,1,1,0,Northampton,2022-05-28
0,3,1,2,0,Northampton,2022-05-29
0,1,1,0,0,Northampton,2022-05-30
0,13,4,9,0,Northampton,2022-06-01
0,4,0,4,0,Northampton,2022-06-04
0,14,3,11,0,Northampton,2022-06-06
0,10,5,5,0,Northampton,2022-06-07
0,6,3,3,0,Northampton,2022-06-09
0,4,0,4,0,Northampton,2022-06-11
1,7,2,5,0,Northampton,2021-12-20
1,10,2,8,0,Northampton,2021-12-23
1,3,0,3,0,Northampton,2021-12-25
1,37,6,31,0,Northampton,2021-12-28
1,15,2,13,0,Northampton,2022-01-15
1,8,0,8,0,Northampton,2022-01-23
1,24,5,19,0,Northampton,2022-01-26
1,3,0,3,0,Northampton,2022-02-11
1,7,0,7,0,Northampton,2022-02-15
1,2,0,2,0,Northampton,2022-02-20
1,1,0,1,0,Northampton,2022-02-25
1,3,2,1,0,Northampton,2022-04-25
1,6,0,6,0,Northampton,2022-04-26
1,5,4,1,0,Northampton,2022-05-10
1,3,0,3,0,Northampton,2022-05-11
1,5,5,0,0,Northampton,2022-05-12
1,3,0,3,0,Northampton,2022-05-17
1,3,2,1,0,Northampton,2022-05-18
1,8,0,8,0,Northampton,2022-05-19
1,3,2,1,0,Northampton,2022-05-26
1,8,2,6,0,Northampton,2022-05-27
1,6,2,4,0,Northampton,2022-06-02
1,11,1,10,0,Northampton,2022-06-03
1,7,3,4,0,Northampton,2022-06-08
1,6,2,4,0,Northampton,2022-06-10
2,6,0,6,0,Northampton,2021-12-26
2,29,2,27,0,Northampton,2021-12-27
2,15,3,12,0,Northampton,2022-01-01
2,26,0,26,0,Northampton,2022-01-08
2,42,7,35,0,Northampton,2022-01-14
2,46,13,33,0,Northampton,2022-01-25
2,9,2,7,0,Northampton,2022-05-16
2,10,4,6,0,Northampton,2022-05-20
3,61,10,51,0,Northampton,2022-01-03
3,51,7,44,0,Northampton,2022-01-20
3,9,5,4,0,Northampton,2022-05-24
4,77,16,61,0,Northampton,2022-01-06
4,37,9,28,0,Northampton,2022-01-17
4,57,4,53,0,Northampton,2022-01-19
4,20,6,14,0,Northampton,2022-02-01
6,48,1,47,0,Northampton,2021-12-31
6,59,7,52,0,Northampton,2022-01-13
7,52,11,41,0,Northampton,2021-12-29
8,74,21,53,0,Northampton,2022-01-18
9,90,16,74,0,Northampton,2022-01-10
11,63,13,50,0,Northampton,2021-12-30
16,91,10,81,0,Northampton,2022-01-04
,0,0,0,0,Onslow,2022-04-03
0,15,0,15,0,Onslow,2021-12-25
0,7,1,6,0,Onslow,2022-03-04
0,5,1,4,0,Onslow,2022-03-09
0,3,0,3,0,Onslow,2022-03-12
0,5,0,5,0,Onslow,2022-03-15
0,4,0,4,0,Onslow,2022-03-17
0,4,1,3,0,Onslow,2022-03-20
0,7,0,7,0,Onslow,2022-03-21
0,4,1,3,0,Onslow,2022-03-25
0,5,4,1,0,Onslow,2022-03-27
0,3,0,3,0,Onslow,2022-03-28
0,4,1,3,0,Onslow,2022-03-29
0,6,2,4,0,Onslow,2022-03-30
0,2,1,1,0,Onslow,2022-04-01
0,8,0,8,0,Onslow,2022-04-05
0,6,0,6,0,Onslow,2022-04-06
0,8,1,7,0,Onslow,2022-04-10
0,2,0,2,0,Onslow,2022-04-15
0,2,0,2,0,Onslow,2022-04-17
0,11,2,9,0,Onslow,2022-04-21
0,22,4,18,0,Onslow,2022-04-25
0,22,4,18,0,Onslow,2022-04-27
0,23,4,19,0,Onslow,2022-05-29
0,38,3,35,0,Onslow,2022-06-09
0,26,3,23,0,Onslow,2022-06-11
1,69,12,57,0,Onslow,2021-12-14
1,58,10,48,0,Onslow,2021-12-15
1,29,4,25,0,Onslow,2021-12-18
1,16,3,13,0,Onslow,2022-02-19
1,6,1,5,0,Onslow,2022-03-06
1,16,1,15,0,Onslow,2022-03-07
1,21,4,17,0,Onslow,2022-03-08
1,6,1,5,0,Onslow,2022-03-13
1,6,0,6,0,Onslow,2022-03-18
1,3,0,3,0,Onslow,2022-03-19
1,5,1,4,0,Onslow,2022-03-31
1,8,1,7,0,Onslow,2022-04-08
1,5,0,5,0,Onslow,2022-04-09
1,12,4,8,0,Onslow,2022-04-11
1,11,2,9,0,Onslow,2022-04-13
1,8,2,6,0,Onslow,2022-04-14
1,8,0,8,0,Onslow,2022-04-16
1,19,4,15,0,Onslow,2022-04-18
1,18,3,15,0,Onslow,2022-04-19
1,16,2,14,0,Onslow,2022-04-20
1,19,1,18,0,Onslow,2022-04-22
1,9,0,9,0,Onslow,2022-04-23
1,9,2,7,0,Onslow,2022-04-24
1,26,1,25,0,Onslow,2022-04-28
1,23,3,20,0,Onslow,2022-04-29
1,31,3,28,0,Onslow,2022-05-03
1,17,10,7,0,Onslow,2022-05-30
2,20,2,18,0,Onslow,2022-02-20
2,29,1,28,0,Onslow,2022-02-25
2,18,7,11,0,Onslow,2022-03-01
2,21,3,18,0,Onslow,2022-05-01
2,48,9,39,0,Onslow,2022-05-04
2,20,5,15,0,Onslow,2022-05-28
3,83,14,69,0,Onslow,2021-12-23
3,47,7,40,0,Onslow,2021-12-24
3,5,3,2,0,Onslow,2022-03-26
3,13,0,13,0,Onslow,2022-05-07
3,18,2,16,0,Onslow,2022-06-04
4,82,11,71,0,Onslow,2021-12-22
4,21,0,21,0,Onslow,2022-02-21
4,37,4,33,0,Onslow,2022-02-23
4,35,7,28,0,Onslow,2022-02-28
4,21,4,17,0,Onslow,2022-04-26
4,25,3,22,0,Onslow,2022-05-06
4,23,3,20,0,Onslow,2022-05-14
4,24,1,23,0,Onslow,2022-05-15
4,44,10,34,0,Onslow,2022-05-27
4,28,4,24,0,Onslow,2022-06-05
4,66,9,57,0,Onslow,2022-06-08
4,50,9,41,0,Onslow,2022-06-10
5,41,7,34,0,Onslow,2022-05-05
5,63,5,58,0,Onslow,2022-05-12
5,32,6,26,0,Onslow,2022-05-22
5,67,8,59,0,Onslow,2022-05-26
6,162,51,111,0,Onslow,2021-12-31
6,90,13,77,0,Onslow,2022-06-07
7,58,6,52,0,Onslow,2022-05-10
7,71,12,59,0,Onslow,2022-05-19
8,88,11,77,0,Onslow,2022-02-15
8,56,12,44,0,Onslow,2022-05-13
8,56,4,52,0,Onslow,2022-05-20
9,129,4,125,0,Onslow,2022-01-30
9,66,15,51,0,Onslow,2022-05-09
9,72,15,57,0,Onslow,2022-05-11
9,82,6,76,0,Onslow,2022-05-17
9,64,6,58,0,Onslow,2022-06-03
10,44,4,40,0,Onslow,2022-05-02
10,110,6,104,0,Onslow,2022-06-01
11,214,25,189,0,Onslow,2021-12-27
12,189,51,138,0,Onslow,2022-01-08
12,154,20,134,0,Onslow,2022-02-08
12,107,9,98,0,Onslow,2022-05-23
12,126,11,115,0,Onslow,2022-06-06
13,90,12,78,0,Onslow,2022-05-18
13,96,14,82,0,Onslow,2022-05-25
15,338,22,316,0,Onslow,2021-12-28
17,140,55,85,0,Onslow,2022-01-02
23,321,29,292,0,Onslow,2021-12-29
25,342,57,285,0,Onslow,2021-12-30
33,437,55,382,0,Onslow,2022-01-31
37,441,91,350,0,Onslow,2022-01-03
44,703,114,589,0,Onslow,2022-01-17
57,741,81,660,0,Onslow,2022-01-06
59,878,135,743,0,Onslow,2022-01-12
62,841,131,710,0,Onslow,2022-01-04
73,932,127,805,0,Onslow,2022-01-13
84,1154,91,1063,0,Onslow,2022-01-18
0,53,3,50,0,Orange,2022-02-05
0,58,3,55,0,Orange,2022-02-11
0,15,2,13,0,Orange,2022-02-13
0,22,2,20,0,Orange,2022-02-19
0,14,3,11,0,Orange,2022-02-20
0,5,2,3,0,Orange,2022-02-26
0,16,1,15,0,Orange,2022-03-01
0,12,2,10,0,Orange,2022-03-02
0,13,3,10,0,Orange,2022-03-04
0,7,0,7,0,Orange,2022-03-05
0,20,3,17,0,Orange,2022-03-09
0,15,0,15,0,Orange,2022-03-10
0,9,1,8,0,Orange,2022-03-11
0,9,3,6,0,Orange,2022-03-12
0,6,0,6,0,Orange,2022-03-13
0,6,0,6,0,Orange,2022-03-14
0,10,2,8,0,Orange,2022-03-15
0,11,0,11,0,Orange,2022-03-16
0,9,1,8,0,Orange,2022-03-18
0,13,1,12,0,Orange,2022-03-24
0,19,6,13,0,Orange,2022-03-25
0,5,0,5,0,Orange,2022-03-26
0,10,0,10,0,Orange,2022-03-27
0,20,1,19,0,Orange,2022-03-30
0,11,5,6,0,Orange,2022-04-01
0,7,1,6,0,Orange,2022-04-02
0,9,2,7,0,Orange,2022-04-03
0,9,1,8,0,Orange,2022-04-17
0,39,5,34,0,Orange,2022-05-15
0,41,3,38,0,Orange,2022-05-30
1,43,3,40,0,Orange,2021-12-14
1,44,1,43,0,Orange,2021-12-15
1,30,1,29,0,Orange,2021-12-18
1,94,2,92,0,Orange,2021-12-20
1,43,2,41,0,Orange,2022-02-17
1,17,1,16,0,Orange,2022-02-25
1,4,1,3,0,Orange,2022-02-27
1,22,1,21,0,Orange,2022-02-28
1,7,0,7,0,Orange,2022-03-06
1,13,1,12,0,Orange,2022-03-08
1,4,2,2,0,Orange,2022-03-20
1,21,4,17,0,Orange,2022-03-21
1,17,3,14,0,Orange,2022-03-22
1,20,1,19,0,Orange,2022-03-28
1,21,1,20,0,Orange,2022-03-29
1,22,2,20,0,Orange,2022-03-31
1,29,4,25,0,Orange,2022-04-05
1,57,2,55,0,Orange,2022-04-06
1,26,2,24,0,Orange,2022-04-10
1,57,2,55,0,Orange,2022-04-15
1,30,1,29,0,Orange,2022-04-16
1,52,6,46,0,Orange,2022-04-20
1,51,4,47,0,Orange,2022-04-29
1,31,4,27,0,Orange,2022-04-30
1,63,4,59,0,Orange,2022-05-06
1,43,4,39,0,Orange,2022-05-21
1,36,1,35,0,Orange,2022-05-22
1,55,5,50,0,Orange,2022-05-27
1,43,3,40,0,Orange,2022-05-29
1,83,8,75,0,Orange,2022-06-07
2,53,9,44,0,Orange,2021-12-24
2,19,4,15,0,Orange,2021-12-25
2,94,8,86,0,Orange,2022-01-01
2,75,4,71,0,Orange,2022-01-29
2,56,5,51,0,Orange,2022-02-15
2,29,1,28,0,Orange,2022-02-22
2,28,2,26,0,Orange,2022-02-24
2,55,4,51,0,Orange,2022-04-07
2,31,3,28,0,Orange,2022-04-23
2,18,5,13,0,Orange,2022-04-24
2,57,5,52,0,Orange,2022-04-25
2,53,3,50,0,Orange,2022-04-27
2,72,4,68,0,Orange,2022-05-04
2,31,5,26,0,Orange,2022-05-08
2,71,6,65,0,Orange,2022-06-03
2,46,1,45,0,Orange,2022-06-04
2,28,3,25,0,Orange,2022-06-11
3,52,6,46,0,Orange,2022-01-22
3,134,8,126,0,Orange,2022-02-07
3,88,3,85,0,Orange,2022-02-09
3,76,3,73,0,Orange,2022-02-14
3,32,2,30,0,Orange,2022-02-23
3,19,1,18,0,Orange,2022-03-23
3,61,7,54,0,Orange,2022-04-21
3,57,6,51,0,Orange,2022-04-26
3,52,7,45,0,Orange,2022-04-28
3,25,2,23,0,Orange,2022-05-01
3,32,7,25,0,Orange,2022-05-07
3,82,4,78,0,Orange,2022-05-10
3,78,8,70,0,Orange,2022-05-20
3,91,7,84,0,Orange,2022-06-06
3,88,5,83,0,Orange,2022-06-08
3,71,6,65,0,Orange,2022-06-09
4,125,9,116,0,Orange,2021-12-23
4,113,1,112,0,Orange,2021-12-26
4,196,6,190,0,Orange,2022-01-21
4,141,9,132,0,Orange,2022-02-03
4,29,3,26,0,Orange,2022-04-04
4,75,4,71,0,Orange,2022-04-14
4,92,5,87,0,Orange,2022-04-18
4,52,3,49,0,Orange,2022-04-22
4,77,6,71,0,Orange,2022-05-05
4,62,14,48,0,Orange,2022-05-14
4,105,12,93,0,Orange,2022-05-17
4,96,9,87,0,Orange,2022-06-01
4,76,7,69,0,Orange,2022-06-02
4,35,1,34,0,Orange,2022-06-05
5,91,3,88,0,Orange,2022-02-08
5,94,5,89,0,Orange,2022-04-12
5,83,3,80,0,Orange,2022-04-19
5,81,12,69,0,Orange,2022-05-02
5,103,8,95,0,Orange,2022-05-09
5,83,9,74,0,Orange,2022-05-12
5,92,12,80,0,Orange,2022-05-18
5,111,17,94,0,Orange,2022-05-25
5,63,6,57,0,Orange,2022-05-28
5,141,13,128,0,Orange,2022-05-31
6,245,20,225,0,Orange,2021-12-27
6,152,9,143,0,Orange,2022-02-01
6,127,7,120,0,Orange,2022-02-02
6,57,4,53,0,Orange,2022-06-10
7,97,2,95,0,Orange,2022-04-08
7,135,6,129,0,Orange,2022-04-11
7,97,3,94,0,Orange,2022-04-13
7,92,10,82,0,Orange,2022-05-03
7,93,8,85,0,Orange,2022-05-11
7,85,11,74,0,Orange,2022-05-13
7,88,13,75,0,Orange,2022-05-19
7,88,14,74,0,Orange,2022-05-26
8,120,2,118,0,Orange,2021-12-22
8,195,5,190,0,Orange,2022-01-15
8,81,14,67,0,Orange,2022-05-24
9,170,11,159,0,Orange,2022-01-28
10,226,11,215,0,Orange,2022-01-31
10,122,16,106,0,Orange,2022-05-23
11,212,14,198,0,Orange,2022-01-17
11,152,17,135,0,Orange,2022-05-16
12,145,7,138,0,Orange,2022-01-02
13,136,7,129,0,Orange,2021-12-31
14,287,14,273,0,Orange,2021-12-30
15,309,14,295,0,Orange,2021-12-28
15,253,10,243,0,Orange,2022-01-26
16,489,25,464,0,Orange,2022-01-12
17,482,24,458,0,Orange,2022-01-06
17,354,15,339,0,Orange,2022-01-07
20,586,25,561,0,Orange,2022-01-11
24,481,29,452,0,Orange,2022-01-03
26,332,22,310,0,Orange,2021-12-29
26,579,20,559,0,Orange,2022-01-10
26,521,25,496,0,Orange,2022-01-13
26,412,13,399,0,Orange,2022-01-20
28,516,25,491,0,Orange,2022-01-18
,0,0,0,0,Pamlico,2021-12-25
,0,0,0,0,Pamlico,2022-02-20
,0,0,0,0,Pamlico,2022-02-27
,0,0,0,0,Pamlico,2022-02-28
,0,0,0,0,Pamlico,2022-03-05
,0,0,0,0,Pamlico,2022-03-06
,0,0,0,0,Pamlico,2022-03-08
,0,0,0,0,Pamlico,2022-03-10
,0,0,0,0,Pamlico,2022-03-11
,0,0,0,0,Pamlico,2022-03-12
,0,0,0,0,Pamlico,2022-03-13
,0,0,0,0,Pamlico,2022-03-14
,0,0,0,0,Pamlico,2022-03-15
,0,0,0,0,Pamlico,2022-03-17
,0,0,0,0,Pamlico,2022-03-18
,0,0,0,0,Pamlico,2022-03-19
,0,0,0,0,Pamlico,2022-03-20
,0,0,0,0,Pamlico,2022-03-22
,0,0,0,0,Pamlico,2022-03-23
,0,0,0,0,Pamlico,2022-03-24
,0,0,0,0,Pamlico,2022-03-25
,0,0,0,0,Pamlico,2022-03-26
,0,0,0,0,Pamlico,2022-03-27
,0,0,0,0,Pamlico,2022-03-28
,0,0,0,0,Pamlico,2022-03-29
,0,0,0,0,Pamlico,2022-03-31
,0,0,0,0,Pamlico,2022-04-01
,0,0,0,0,Pamlico,2022-04-02
,0,0,0,0,Pamlico,2022-04-03
,0,0,0,0,Pamlico,2022-04-04
,0,0,0,0,Pamlico,2022-04-06
,0,0,0,0,Pamlico,2022-04-07
,0,0,0,0,Pamlico,2022-04-09
,0,0,0,0,Pamlico,2022-04-10
,0,0,0,0,Pamlico,2022-04-11
,0,0,0,0,Pamlico,2022-04-12
,0,0,0,0,Pamlico,2022-04-15
,0,0,0,0,Pamlico,2022-04-16
,0,0,0,0,Pamlico,2022-04-21
,0,0,0,0,Pamlico,2022-04-23
,0,0,0,0,Pamlico,2022-04-24
,0,0,0,0,Pamlico,2022-04-26
,0,0,0,0,Pamlico,2022-04-27
,0,0,0,0,Pamlico,2022-04-29
,0,0,0,0,Pamlico,2022-05-03
,0,0,0,0,Pamlico,2022-05-14
,0,0,0,0,Pamlico,2022-05-30
,0,0,0,0,Pamlico,2022-06-11
0,3,0,3,0,Pamlico,2021-12-14
0,1,1,0,0,Pamlico,2021-12-15
0,1,1,0,0,Pamlico,2021-12-16
0,3,2,1,0,Pamlico,2021-12-17
0,1,0,1,0,Pamlico,2021-12-18
0,5,2,3,0,Pamlico,2021-12-20
0,4,0,4,0,Pamlico,2021-12-21
0,2,0,2,0,Pamlico,2021-12-22
0,2,0,2,0,Pamlico,2021-12-23
0,3,0,3,0,Pamlico,2021-12-24
0,6,0,6,0,Pamlico,2021-12-28
0,5,3,2,0,Pamlico,2021-12-29
0,6,3,3,0,Pamlico,2021-12-30
0,3,0,3,0,Pamlico,2022-01-01
0,21,2,19,0,Pamlico,2022-01-04
0,18,2,16,0,Pamlico,2022-01-05
0,22,1,21,0,Pamlico,2022-01-06
0,9,0,9,0,Pamlico,2022-01-15
0,24,2,22,0,Pamlico,2022-01-17
0,5,0,5,0,Pamlico,2022-01-21
0,1,0,1,0,Pamlico,2022-01-22
0,5,0,5,0,Pamlico,2022-01-23
0,22,1,21,0,Pamlico,2022-01-25
0,13,1,12,0,Pamlico,2022-01-26
0,17,3,14,0,Pamlico,2022-01-27
0,5,0,5,0,Pamlico,2022-01-29
0,2,0,2,0,Pamlico,2022-02-05
0,8,0,8,0,Pamlico,2022-02-06
0,4,0,4,0,Pamlico,2022-02-09
0,4,0,4,0,Pamlico,2022-02-10
0,5,1,4,0,Pamlico,2022-02-11
0,2,0,2,0,Pamlico,2022-02-13
0,6,0,6,0,Pamlico,2022-02-15
0,6,0,6,0,Pamlico,2022-02-16
0,5,1,4,0,Pamlico,2022-02-17
0,2,0,2,0,Pamlico,2022-02-18
0,4,0,4,0,Pamlico,2022-02-21
0,2,0,2,0,Pamlico,2022-02-22
0,3,0,3,0,Pamlico,2022-02-23
0,2,0,2,0,Pamlico,2022-02-24
0,2,0,2,0,Pamlico,2022-02-25
0,1,0,1,0,Pamlico,2022-02-26
0,2,0,2,0,Pamlico,2022-03-01
0,1,0,1,0,Pamlico,2022-03-02
0,1,0,1,0,Pamlico,2022-03-03
0,1,0,1,0,Pamlico,2022-03-04
0,1,0,1,0,Pamlico,2022-03-07
0,2,0,2,0,Pamlico,2022-03-09
0,2,0,2,0,Pamlico,2022-03-16
0,1,1,0,0,Pamlico,2022-03-21
0,1,1,0,0,Pamlico,2022-03-30
0,1,1,0,0,Pamlico,2022-04-05
0,3,2,1,0,Pamlico,2022-04-08
0,2,0,2,0,Pamlico,2022-04-13
0,3,0,3,0,Pamlico,2022-04-14
0,1,1,0,0,Pamlico,2022-04-17
0,3,1,2,0,Pamlico,2022-04-18
0,3,2,1,0,Pamlico,2022-04-19
0,1,0,1,0,Pamlico,2022-04-20
0,2,1,1,0,Pamlico,2022-04-22
0,2,1,1,0,Pamlico,2022-04-25
0,1,0,1,0,Pamlico,2022-04-30
0,2,0,2,0,Pamlico,2022-05-01
0,1,1,0,0,Pamlico,2022-05-04
0,2,1,1,0,Pamlico,2022-05-05
0,1,0,1,0,Pamlico,2022-05-06
0,2,1,1,0,Pamlico,2022-05-07
0,4,1,3,0,Pamlico,2022-05-10
0,6,0,6,0,Pamlico,2022-05-11
0,2,0,2,0,Pamlico,2022-05-13
0,1,0,1,0,Pamlico,2022-05-15
0,4,2,2,0,Pamlico,2022-05-16
0,2,0,2,0,Pamlico,2022-05-17
0,2,0,2,0,Pamlico,2022-05-20
0,3,0,3,0,Pamlico,2022-05-26
0,4,2,2,0,Pamlico,2022-05-28
0,1,0,1,0,Pamlico,2022-05-29
0,2,0,2,0,Pamlico,2022-06-01
0,2,0,2,0,Pamlico,2022-06-03
0,1,0,1,0,Pamlico,2022-06-04
0,2,0,2,0,Pamlico,2022-06-06
0,4,2,2,0,Pamlico,2022-06-07
0,2,1,1,0,Pamlico,2022-06-08
0,5,2,3,0,Pamlico,2022-06-09
1,10,4,6,0,Pamlico,2021-12-27
1,5,0,5,0,Pamlico,2021-12-31
1,7,2,5,0,Pamlico,2022-01-02
1,5,0,5,0,Pamlico,2022-01-08
1,4,2,2,0,Pamlico,2022-01-09
1,23,1,22,0,Pamlico,2022-01-12
1,9,0,9,0,Pamlico,2022-01-28
1,6,0,6,0,Pamlico,2022-01-30
1,18,4,14,0,Pamlico,2022-01-31
1,13,0,13,0,Pamlico,2022-02-02
1,9,0,9,0,Pamlico,2022-02-03
1,6,0,6,0,Pamlico,2022-02-04
1,11,1,10,0,Pamlico,2022-02-07
1,16,1,15,0,Pamlico,2022-02-08
1,4,0,4,0,Pamlico,2022-05-09
1,2,0,2,0,Pamlico,2022-05-18
1,4,1,3,0,Pamlico,2022-05-19
1,8,0,8,0,Pamlico,2022-05-22
1,6,0,6,0,Pamlico,2022-05-24
1,3,1,2,0,Pamlico,2022-06-10
2,33,1,32,0,Pamlico,2022-01-14
2,45,4,41,0,Pamlico,2022-01-19
2,7,0,7,0,Pamlico,2022-02-12
2,7,1,6,0,Pamlico,2022-05-12
2,4,0,4,0,Pamlico,2022-05-27
3,47,6,41,0,Pamlico,2022-01-11
3,8,1,7,0,Pamlico,2022-01-16
3,32,4,28,0,Pamlico,2022-01-20
3,39,2,37,0,Pamlico,2022-01-24
3,5,0,5,0,Pamlico,2022-05-23
4,34,5,29,0,Pamlico,2022-01-10
4,40,5,35,0,Pamlico,2022-01-18
,0,0,0,0,Pasquotank,2022-02-25
,0,0,0,0,Pasquotank,2022-03-05
,0,0,0,0,Pasquotank,2022-03-06
,0,0,0,0,Pasquotank,2022-03-09
,0,0,0,0,Pasquotank,2022-03-12
,0,0,0,0,Pasquotank,2022-03-14
,0,0,0,0,Pasquotank,2022-03-15
,0,0,0,0,Pasquotank,2022-03-21
,0,0,0,0,Pasquotank,2022-03-24
,0,0,0,0,Pasquotank,2022-03-27
,0,0,0,0,Pasquotank,2022-03-29
,0,0,0,0,Pasquotank,2022-03-31
,0,0,0,0,Pasquotank,2022-04-01
,0,0,0,0,Pasquotank,2022-04-02
,0,0,0,0,Pasquotank,2022-04-03
,0,0,0,0,Pasquotank,2022-04-04
,0,0,0,0,Pasquotank,2022-04-09
,0,0,0,0,Pasquotank,2022-04-13
,0,0,0,0,Pasquotank,2022-04-14
,0,0,0,0,Pasquotank,2022-04-21
,0,0,0,0,Pasquotank,2022-04-30
0,18,7,11,0,Pasquotank,2021-12-14
0,13,6,7,0,Pasquotank,2021-12-15
0,6,1,5,0,Pasquotank,2021-12-16
0,4,1,3,0,Pasquotank,2021-12-18
0,14,4,10,0,Pasquotank,2021-12-21
0,6,2,4,0,Pasquotank,2021-12-22
0,12,4,8,0,Pasquotank,2021-12-24
0,6,2,4,0,Pasquotank,2021-12-25
0,17,3,14,0,Pasquotank,2021-12-26
0,9,0,9,0,Pasquotank,2022-01-22
0,4,0,4,0,Pasquotank,2022-02-06
0,6,0,6,0,Pasquotank,2022-02-09
0,6,2,4,0,Pasquotank,2022-02-12
0,2,1,1,0,Pasquotank,2022-02-13
0,9,2,7,0,Pasquotank,2022-02-14
0,5,1,4,0,Pasquotank,2022-02-18
0,2,1,1,0,Pasquotank,2022-02-19
0,4,0,4,0,Pasquotank,2022-02-20
0,4,0,4,0,Pasquotank,2022-02-21
0,5,0,5,0,Pasquotank,2022-02-22
0,9,2,7,0,Pasquotank,2022-02-24
0,2,0,2,0,Pasquotank,2022-02-26
0,1,0,1,0,Pasquotank,2022-02-27
0,5,1,4,0,Pasquotank,2022-02-28
0,2,0,2,0,Pasquotank,2022-03-04
0,1,1,0,0,Pasquotank,2022-03-08
0,1,0,1,0,Pasquotank,2022-03-10
0,2,0,2,0,Pasquotank,2022-03-11
0,2,1,1,0,Pasquotank,2022-03-13
0,2,0,2,0,Pasquotank,2022-03-16
0,3,2,1,0,Pasquotank,2022-03-17
0,1,0,1,0,Pasquotank,2022-03-19
0,2,2,0,0,Pasquotank,2022-03-23
0,4,2,2,0,Pasquotank,2022-03-25
0,1,0,1,0,Pasquotank,2022-03-26
0,2,1,1,0,Pasquotank,2022-03-28
0,1,1,0,0,Pasquotank,2022-03-30
0,1,0,1,0,Pasquotank,2022-04-06
0,2,0,2,0,Pasquotank,2022-04-07
0,1,0,1,0,Pasquotank,2022-04-08
0,1,0,1,0,Pasquotank,2022-04-10
0,2,0,2,0,Pasquotank,2022-04-11
0,1,1,0,0,Pasquotank,2022-04-15
0,1,0,1,0,Pasquotank,2022-04-16
0,1,1,0,0,Pasquotank,2022-04-17
0,1,0,1,0,Pasquotank,2022-04-18
0,1,0,1,0,Pasquotank,2022-04-19
0,2,1,1,0,Pasquotank,2022-04-20
0,2,1,1,0,Pasquotank,2022-04-22
0,1,0,1,0,Pasquotank,2022-04-23
0,2,0,2,0,Pasquotank,2022-04-24
0,2,0,2,0,Pasquotank,2022-04-25
0,2,1,1,0,Pasquotank,2022-04-26
0,2,1,1,0,Pasquotank,2022-04-27
0,9,3,6,0,Pasquotank,2022-04-28
0,3,1,2,0,Pasquotank,2022-04-29
0,2,1,1,0,Pasquotank,2022-05-01
0,1,1,0,0,Pasquotank,2022-05-02
0,5,1,4,0,Pasquotank,2022-05-05
0,8,2,6,0,Pasquotank,2022-05-06
0,4,2,2,0,Pasquotank,2022-05-07
0,2,0,2,0,Pasquotank,2022-05-08
0,8,3,5,0,Pasquotank,2022-05-10
0,5,1,4,0,Pasquotank,2022-05-14
0,3,0,3,0,Pasquotank,2022-05-15
0,9,4,5,0,Pasquotank,2022-05-18
0,5,2,3,0,Pasquotank,2022-05-21
0,3,3,0,0,Pasquotank,2022-05-22
0,8,6,2,0,Pasquotank,2022-05-23
0,8,5,3,0,Pasquotank,2022-05-24
0,13,6,7,0,Pasquotank,2022-05-26
0,3,0,3,0,Pasquotank,2022-05-27
0,4,1,3,0,Pasquotank,2022-05-28
0,2,1,1,0,Pasquotank,2022-05-29
0,8,4,4,0,Pasquotank,2022-06-08
0,4,2,2,0,Pasquotank,2022-06-10
0,6,3,3,0,Pasquotank,2022-06-11
1,14,3,11,0,Pasquotank,2021-12-20
1,10,5,5,0,Pasquotank,2021-12-23
1,35,3,32,0,Pasquotank,2022-01-01
1,40,16,24,0,Pasquotank,2022-01-15
1,6,4,2,0,Pasquotank,2022-02-08
1,8,1,7,0,Pasquotank,2022-02-10
1,8,5,3,0,Pasquotank,2022-02-15
1,13,4,9,0,Pasquotank,2022-02-17
1,7,5,2,0,Pasquotank,2022-02-23
1,5,3,2,0,Pasquotank,2022-03-01
1,2,0,2,0,Pasquotank,2022-03-02
1,8,1,7,0,Pasquotank,2022-05-04
1,8,4,4,0,Pasquotank,2022-05-12
1,10,3,7,0,Pasquotank,2022-05-16
1,11,7,4,0,Pasquotank,2022-05-20
1,16,8,8,0,Pasquotank,2022-05-31
1,7,2,5,0,Pasquotank,2022-06-04
2,38,7,31,0,Pasquotank,2022-01-02
2,45,9,36,0,Pasquotank,2022-01-31
2,34,6,28,0,Pasquotank,2022-02-07
2,27,1,26,0,Pasquotank,2022-02-16
2,3,2,1,0,Pasquotank,2022-05-03
2,9,5,4,0,Pasquotank,2022-05-13
2,14,5,9,0,Pasquotank,2022-05-17
2,17,7,10,0,Pasquotank,2022-05-19
2,6,4,2,0,Pasquotank,2022-05-30
2,13,5,8,0,Pasquotank,2022-06-03
2,17,14,3,0,Pasquotank,2022-06-06
2,7,4,3,0,Pasquotank,2022-06-07
2,10,7,3,0,Pasquotank,2022-06-09
3,48,13,35,0,Pasquotank,2021-12-27
3,46,5,41,0,Pasquotank,2021-12-31
3,75,31,44,0,Pasquotank,2022-01-14
3,3,2,1,0,Pasquotank,2022-05-09
3,7,4,3,0,Pasquotank,2022-05-11
3,17,9,8,0,Pasquotank,2022-05-25
3,25,8,17,0,Pasquotank,2022-06-01
4,33,2,31,0,Pasquotank,2022-01-09
4,16,2,14,0,Pasquotank,2022-01-29
5,36,12,24,0,Pasquotank,2021-12-28
5,57,12,45,0,Pasquotank,2021-12-29
6,58,12,46,0,Pasquotank,2021-12-30
6,100,25,75,0,Pasquotank,2022-01-06
6,35,3,32,0,Pasquotank,2022-01-08
6,68,19,49,0,Pasquotank,2022-01-12
6,87,21,66,0,Pasquotank,2022-01-17
6,63,12,51,0,Pasquotank,2022-01-27
6,33,9,24,0,Pasquotank,2022-02-01
7,72,34,38,0,Pasquotank,2022-01-11
7,67,6,61,0,Pasquotank,2022-01-26
8,118,15,103,0,Pasquotank,2022-01-03
8,138,19,119,0,Pasquotank,2022-01-19
8,101,13,88,0,Pasquotank,2022-01-20
11,107,23,84,0,Pasquotank,2022-01-04
12,94,16,78,0,Pasquotank,2022-01-24
15,135,38,97,0,Pasquotank,2022-01-10
,0,0,0,0,Pender,2022-03-10
,0,0,0,0,Pender,2022-03-13
,0,0,0,0,Pender,2022-03-18
,0,0,0,0,Pender,2022-03-20
,0,0,0,0,Pender,2022-03-23
,0,0,0,0,Pender,2022-03-25
,0,0,0,0,Pender,2022-03-27
,0,0,0,0,Pender,2022-04-02
,0,0,0,0,Pender,2022-04-03
,0,0,0,0,Pender,2022-04-05
,0,0,0,0,Pender,2022-04-10
,0,0,0,0,Pender,2022-05-01
0,27,7,20,0,Pender,2021-12-14
0,12,0,12,0,Pender,2021-12-17
0,20,9,11,0,Pender,2021-12-24
0,13,0,13,0,Pender,2021-12-25
0,15,4,11,0,Pender,2022-02-05
0,16,1,15,0,Pender,2022-02-16
0,5,0,5,0,Pender,2022-02-17
0,4,1,3,0,Pender,2022-02-20
0,5,0,5,0,Pender,2022-02-23
0,5,1,4,0,Pender,2022-02-24
0,1,0,1,0,Pender,2022-02-28
0,5,1,4,0,Pender,2022-03-01
0,5,2,3,0,Pender,2022-03-03
0,2,0,2,0,Pender,2022-03-04
0,1,0,1,0,Pender,2022-03-05
0,2,0,2,0,Pender,2022-03-06
0,3,0,3,0,Pender,2022-03-07
0,1,0,1,0,Pender,2022-03-09
0,1,0,1,0,Pender,2022-03-11
0,1,0,1,0,Pender,2022-03-12
0,5,0,5,0,Pender,2022-03-17
0,1,0,1,0,Pender,2022-03-19
0,2,0,2,0,Pender,2022-03-21
0,1,0,1,0,Pender,2022-03-22
0,1,0,1,0,Pender,2022-03-24
0,2,0,2,0,Pender,2022-03-28
0,1,0,1,0,Pender,2022-03-29
0,2,0,2,0,Pender,2022-03-30
0,2,0,2,0,Pender,2022-03-31
0,2,0,2,0,Pender,2022-04-01
0,2,0,2,0,Pender,2022-04-06
0,5,0,5,0,Pender,2022-04-07
0,2,0,2,0,Pender,2022-04-09
0,8,1,7,0,Pender,2022-04-13
0,5,2,3,0,Pender,2022-04-14
0,7,1,6,0,Pender,2022-04-15
0,1,0,1,0,Pender,2022-04-16
0,2,0,2,0,Pender,2022-04-17
0,3,1,2,0,Pender,2022-04-18
0,3,3,0,0,Pender,2022-04-19
0,2,0,2,0,Pender,2022-04-20
0,7,1,6,0,Pender,2022-04-21
0,5,1,4,0,Pender,2022-04-22
0,3,0,3,0,Pender,2022-04-23
0,4,1,3,0,Pender,2022-04-26
0,1,0,1,0,Pender,2022-04-30
0,7,2,5,0,Pender,2022-05-02
0,5,1,4,0,Pender,2022-05-06
0,6,0,6,0,Pender,2022-05-08
0,12,3,9,0,Pender,2022-05-11
0,7,0,7,0,Pender,2022-05-15
0,26,3,23,0,Pender,2022-05-16
0,6,1,5,0,Pender,2022-05-22
0,17,1,16,0,Pender,2022-05-24
0,6,1,5,0,Pender,2022-05-29
0,6,1,5,0,Pender,2022-05-30
0,13,2,11,0,Pender,2022-06-02
0,13,1,12,0,Pender,2022-06-03
0,16,1,15,0,Pender,2022-06-07
0,9,0,9,0,Pender,2022-06-09
1,17,2,15,0,Pender,2021-12-15
1,37,7,30,0,Pender,2021-12-21
1,33,2,31,0,Pender,2022-01-30
1,12,1,11,0,Pender,2022-02-12
1,4,1,3,0,Pender,2022-02-13
1,14,0,14,0,Pender,2022-02-15
1,9,3,6,0,Pender,2022-02-18
1,7,0,7,0,Pender,2022-02-21
1,12,1,11,0,Pender,2022-02-22
1,5,1,4,0,Pender,2022-02-27
1,2,0,2,0,Pender,2022-03-16
1,4,0,4,0,Pender,2022-04-04
1,9,0,9,0,Pender,2022-04-08
1,9,2,7,0,Pender,2022-04-11
1,6,1,5,0,Pender,2022-04-12
1,9,3,6,0,Pender,2022-04-27
1,6,0,6,0,Pender,2022-04-28
1,4,1,3,0,Pender,2022-04-29
1,11,2,9,0,Pender,2022-05-04
1,3,0,3,0,Pender,2022-05-07
1,13,1,12,0,Pender,2022-05-09
1,22,2,20,0,Pender,2022-05-10
1,20,1,19,0,Pender,2022-05-19
1,12,0,12,0,Pender,2022-05-21
1,15,1,14,0,Pender,2022-05-26
1,12,2,10,0,Pender,2022-05-28
1,7,2,5,0,Pender,2022-06-08
1,12,0,12,0,Pender,2022-06-11
2,37,4,33,0,Pender,2021-12-20
2,44,10,34,0,Pender,2022-01-02
2,68,12,56,0,Pender,2022-01-08
2,36,5,31,0,Pender,2022-01-22
2,24,1,23,0,Pender,2022-02-10
2,7,1,6,0,Pender,2022-03-15
2,6,2,4,0,Pender,2022-04-24
2,16,4,12,0,Pender,2022-05-12
2,13,1,12,0,Pender,2022-05-13
2,13,1,12,0,Pender,2022-05-18
2,11,1,10,0,Pender,2022-06-04
2,21,4,17,0,Pender,2022-06-06
2,14,3,11,0,Pender,2022-06-10
3,31,5,26,0,Pender,2021-12-22
3,40,7,33,0,Pender,2021-12-23
3,26,7,19,0,Pender,2022-01-01
3,35,2,33,0,Pender,2022-02-08
3,12,2,10,0,Pender,2022-05-20
3,19,2,17,0,Pender,2022-06-01
4,92,5,87,0,Pender,2021-12-29
4,56,17,39,0,Pender,2022-01-23
4,24,5,19,0,Pender,2022-05-31
5,47,10,37,0,Pender,2021-12-31
5,102,14,88,0,Pender,2022-01-28
5,62,14,48,0,Pender,2022-02-02
5,18,2,16,0,Pender,2022-05-23
6,104,10,94,0,Pender,2021-12-28
6,78,6,72,0,Pender,2022-02-01
6,83,14,69,0,Pender,2022-02-07
7,110,19,91,0,Pender,2021-12-30
7,129,14,115,0,Pender,2022-01-07
10,200,18,182,0,Pender,2022-01-03
14,214,27,187,0,Pender,2022-01-12
14,104,18,86,0,Pender,2022-01-27
16,155,17,138,0,Pender,2022-01-06
16,281,42,239,0,Pender,2022-01-19
17,156,37,119,0,Pender,2022-01-04
22,345,53,292,0,Pender,2022-01-18
22,224,26,198,0,Pender,2022-01-20
22,267,45,222,0,Pender,2022-01-24
24,249,32,217,0,Pender,2022-01-10
,0,0,0,0,Perquimans,2021-12-19
,0,0,0,0,Perquimans,2021-12-25
,0,0,0,0,Perquimans,2022-02-19
,0,0,0,0,Perquimans,2022-02-24
,0,0,0,0,Perquimans,2022-02-25
,0,0,0,0,Perquimans,2022-02-27
,0,0,0,0,Perquimans,2022-03-05
,0,0,0,0,Perquimans,2022-03-07
,0,0,0,0,Perquimans,2022-03-09
,0,0,0,0,Perquimans,2022-03-10
,0,0,0,0,Perquimans,2022-03-12
,0,0,0,0,Perquimans,2022-03-14
,0,0,0,0,Perquimans,2022-03-15
,0,0,0,0,Perquimans,2022-03-16
,0,0,0,0,Perquimans,2022-03-17
,0,0,0,0,Perquimans,2022-03-19
,0,0,0,0,Perquimans,2022-03-20
,0,0,0,0,Perquimans,2022-03-22
,0,0,0,0,Perquimans,2022-03-23
,0,0,0,0,Perquimans,2022-03-25
,0,0,0,0,Perquimans,2022-03-26
,0,0,0,0,Perquimans,2022-03-28
,0,0,0,0,Perquimans,2022-03-29
,0,0,0,0,Perquimans,2022-03-30
,0,0,0,0,Perquimans,2022-03-31
,0,0,0,0,Perquimans,2022-04-01
,0,0,0,0,Perquimans,2022-04-02
,0,0,0,0,Perquimans,2022-04-03
,0,0,0,0,Perquimans,2022-04-05
,0,0,0,0,Perquimans,2022-04-07
,0,0,0,0,Perquimans,2022-04-08
,0,0,0,0,Perquimans,2022-04-09
,0,0,0,0,Perquimans,2022-04-10
,0,0,0,0,Perquimans,2022-04-12
,0,0,0,0,Perquimans,2022-04-13
,0,0,0,0,Perquimans,2022-04-14
,0,0,0,0,Perquimans,2022-04-15
,0,0,0,0,Perquimans,2022-04-16
,0,0,0,0,Perquimans,2022-04-17
,0,0,0,0,Perquimans,2022-04-18
,0,0,0,0,Perquimans,2022-04-19
,0,0,0,0,Perquimans,2022-04-20
,0,0,0,0,Perquimans,2022-04-21
,0,0,0,0,Perquimans,2022-04-22
,0,0,0,0,Perquimans,2022-04-23
,0,0,0,0,Perquimans,2022-04-30
,0,0,0,0,Perquimans,2022-05-07
,0,0,0,0,Perquimans,2022-05-08
,0,0,0,0,Perquimans,2022-05-10
,0,0,0,0,Perquimans,2022-05-12
,0,0,0,0,Perquimans,2022-05-13
,0,0,0,0,Perquimans,2022-06-05
0,9,1,8,0,Perquimans,2021-12-14
0,2,0,2,0,Perquimans,2021-12-15
0,3,2,1,0,Perquimans,2021-12-17
0,6,1,5,0,Perquimans,2021-12-18
0,10,5,5,0,Perquimans,2021-12-20
0,3,1,2,0,Perquimans,2021-12-21
0,15,6,9,0,Perquimans,2021-12-22
0,6,0,6,0,Perquimans,2021-12-23
0,3,0,3,0,Perquimans,2021-12-24
0,8,0,8,0,Perquimans,2022-01-01
0,3,0,3,0,Perquimans,2022-01-02
0,13,0,13,0,Perquimans,2022-01-09
0,10,3,7,0,Perquimans,2022-01-16
0,10,1,9,0,Perquimans,2022-01-21
0,21,7,14,0,Perquimans,2022-01-26
0,4,0,4,0,Perquimans,2022-01-29
0,8,1,7,0,Perquimans,2022-02-02
0,5,1,4,0,Perquimans,2022-02-06
0,4,2,2,0,Perquimans,2022-02-10
0,3,0,3,0,Perquimans,2022-02-11
0,1,0,1,0,Perquimans,2022-02-12
0,7,3,4,0,Perquimans,2022-02-14
0,2,0,2,0,Perquimans,2022-02-15
0,2,0,2,0,Perquimans,2022-02-17
0,2,0,2,0,Perquimans,2022-02-18
0,2,0,2,0,Perquimans,2022-02-20
0,2,2,0,0,Perquimans,2022-02-22
0,1,1,0,0,Perquimans,2022-02-23
0,1,0,1,0,Perquimans,2022-02-26
0,1,0,1,0,Perquimans,2022-02-28
0,1,0,1,0,Perquimans,2022-03-01
0,1,0,1,0,Perquimans,2022-03-03
0,1,0,1,0,Perquimans,2022-03-06
0,2,0,2,0,Perquimans,2022-03-08
0,3,0,3,0,Perquimans,2022-03-11
0,1,0,1,0,Perquimans,2022-03-13
0,1,1,0,0,Perquimans,2022-03-18
0,1,1,0,0,Perquimans,2022-03-27
0,1,0,1,0,Perquimans,2022-04-04
0,1,1,0,0,Perquimans,2022-04-11
0,2,2,0,0,Perquimans,2022-04-24
0,1,0,1,0,Perquimans,2022-04-29
0,2,1,1,0,Perquimans,2022-05-02
0,5,0,5,0,Perquimans,2022-05-04
0,6,5,1,0,Perquimans,2022-05-05
0,3,1,2,0,Perquimans,2022-05-06
0,3,0,3,0,Perquimans,2022-05-09
0,2,1,1,0,Perquimans,2022-05-11
0,2,0,2,0,Perquimans,2022-05-15
0,2,1,1,0,Perquimans,2022-05-16
0,4,2,2,0,Perquimans,2022-05-17
0,2,0,2,0,Perquimans,2022-05-18
0,5,2,3,0,Perquimans,2022-05-19
0,4,1,3,0,Perquimans,2022-05-20
0,2,2,0,0,Perquimans,2022-05-21
0,4,2,2,0,Perquimans,2022-05-23
0,5,2,3,0,Perquimans,2022-05-24
0,3,2,1,0,Perquimans,2022-05-28
0,2,0,2,0,Perquimans,2022-05-29
0,2,1,1,0,Perquimans,2022-05-30
0,3,1,2,0,Perquimans,2022-06-02
0,2,0,2,0,Perquimans,2022-06-03
0,2,0,2,0,Perquimans,2022-06-04
0,4,1,3,0,Perquimans,2022-06-07
0,2,0,2,0,Perquimans,2022-06-08
0,1,0,1,0,Perquimans,2022-06-10
0,3,0,3,0,Perquimans,2022-06-11
1,5,1,4,0,Perquimans,2021-12-26
1,17,1,16,0,Perquimans,2021-12-29
1,18,5,13,0,Perquimans,2021-12-30
1,13,0,13,0,Perquimans,2022-01-08
1,52,19,33,0,Perquimans,2022-01-10
1,18,2,16,0,Perquimans,2022-01-15
1,24,5,19,0,Perquimans,2022-01-19
1,6,1,5,0,Perquimans,2022-01-22
1,6,0,6,0,Perquimans,2022-01-23
1,5,0,5,0,Perquimans,2022-01-30
1,5,3,2,0,Perquimans,2022-02-05
1,5,1,4,0,Perquimans,2022-02-08
1,17,0,17,0,Perquimans,2022-02-09
1,6,1,5,0,Perquimans,2022-02-13
1,4,0,4,0,Perquimans,2022-02-21
1,1,1,0,0,Perquimans,2022-03-04
1,1,0,1,0,Perquimans,2022-03-24
1,3,2,1,0,Perquimans,2022-04-06
1,3,0,3,0,Perquimans,2022-04-26
1,2,0,2,0,Perquimans,2022-05-01
1,2,0,2,0,Perquimans,2022-05-22
1,5,2,3,0,Perquimans,2022-05-26
1,4,1,3,0,Perquimans,2022-05-27
1,1,1,0,0,Perquimans,2022-06-09
2,12,1,11,0,Perquimans,2021-12-27
2,9,0,9,0,Perquimans,2021-12-31
2,35,7,28,0,Perquimans,2022-01-11
2,34,6,28,0,Perquimans,2022-01-14
2,29,4,25,0,Perquimans,2022-01-24
2,23,4,19,0,Perquimans,2022-01-25
2,11,1,10,0,Perquimans,2022-01-28
2,19,3,16,0,Perquimans,2022-01-31
2,12,4,8,0,Perquimans,2022-02-01
2,2,2,0,0,Perquimans,2022-04-27
2,5,1,4,0,Perquimans,2022-06-01
2,5,2,3,0,Perquimans,2022-06-06
3,29,7,22,0,Perquimans,2022-01-20
3,22,6,16,0,Perquimans,2022-01-27
3,13,0,13,0,Perquimans,2022-02-03
3,12,3,9,0,Perquimans,2022-02-07
4,26,0,26,0,Perquimans,2021-12-28
4,55,10,45,0,Perquimans,2022-01-04
4,21,6,15,0,Perquimans,2022-01-13
4,32,4,28,0,Perquimans,2022-01-17
7,33,8,25,0,Perquimans,2022-01-06
9,30,3,27,0,Perquimans,2022-01-03
,0,0,0,0,Person,2022-03-10
,0,0,0,0,Person,2022-03-11
,0,0,0,0,Person,2022-03-12
,0,0,0,0,Person,2022-03-24
,0,0,0,0,Person,2022-03-25
,0,0,0,0,Person,2022-03-27
,0,0,0,0,Person,2022-03-28
,0,0,0,0,Person,2022-04-03
,0,0,0,0,Person,2022-04-08
,0,0,0,0,Person,2022-04-21
0,21,9,12,0,Person,2021-12-16
0,11,6,5,0,Person,2021-12-18
0,19,2,17,0,Person,2021-12-20
0,17,2,15,0,Person,2021-12-22
0,6,1,5,0,Person,2021-12-24
0,7,0,7,0,Person,2021-12-25
0,7,0,7,0,Person,2022-01-16
0,9,2,7,0,Person,2022-02-12
0,4,0,4,0,Person,2022-02-13
0,10,2,8,0,Person,2022-02-16
0,8,2,6,0,Person,2022-02-18
0,2,0,2,0,Person,2022-02-20
0,5,2,3,0,Person,2022-02-25
0,2,1,1,0,Person,2022-02-26
0,4,0,4,0,Person,2022-02-27
0,3,1,2,0,Person,2022-02-28
0,7,2,5,0,Person,2022-03-01
0,4,0,4,0,Person,2022-03-03
0,3,0,3,0,Person,2022-03-04
0,1,0,1,0,Person,2022-03-05
0,3,3,0,0,Person,2022-03-06
0,2,1,1,0,Person,2022-03-07
0,2,1,1,0,Person,2022-03-08
0,6,1,5,0,Person,2022-03-09
0,1,0,1,0,Person,2022-03-13
0,5,0,5,0,Person,2022-03-14
0,1,1,0,0,Person,2022-03-15
0,3,0,3,0,Person,2022-03-17
0,1,1,0,0,Person,2022-03-18
0,1,0,1,0,Person,2022-03-19
0,1,1,0,0,Person,2022-03-20
0,3,0,3,0,Person,2022-03-21
0,2,0,2,0,Person,2022-03-22
0,1,1,0,0,Person,2022-03-23
0,1,0,1,0,Person,2022-03-26
0,2,0,2,0,Person,2022-03-30
0,2,1,1,0,Person,2022-03-31
0,2,0,2,0,Person,2022-04-01
0,1,1,0,0,Person,2022-04-02
0,3,0,3,0,Person,2022-04-04
0,2,1,1,0,Person,2022-04-05
0,1,0,1,0,Person,2022-04-06
0,3,0,3,0,Person,2022-04-07
0,2,1,1,0,Person,2022-04-09
0,1,0,1,0,Person,2022-04-10
0,3,0,3,0,Person,2022-04-11
0,4,1,3,0,Person,2022-04-13
0,2,0,2,0,Person,2022-04-14
0,3,0,3,0,Person,2022-04-15
0,1,0,1,0,Person,2022-04-16
0,1,0,1,0,Person,2022-04-17
0,2,0,2,0,Person,2022-04-20
0,5,3,2,0,Person,2022-04-22
0,4,3,1,0,Person,2022-04-27
0,5,1,4,0,Person,2022-04-30
0,6,2,4,0,Person,2022-05-03
0,10,2,8,0,Person,2022-05-06
0,2,1,1,0,Person,2022-05-07
0,13,3,10,0,Person,2022-05-09
0,9,1,8,0,Person,2022-05-10
0,19,4,15,0,Person,2022-05-13
0,16,3,13,0,Person,2022-05-14
0,8,5,3,0,Person,2022-05-15
0,7,1,6,0,Person,2022-05-22
0,12,5,7,0,Person,2022-05-25
0,16,4,12,0,Person,2022-05-26
0,14,3,11,0,Person,2022-05-28
0,16,3,13,0,Person,2022-06-10
0,2,1,1,0,Person,2022-06-11
1,17,1,16,0,Person,2021-12-14
1,28,10,18,0,Person,2021-12-15
1,30,4,26,0,Person,2021-12-23
1,15,4,11,0,Person,2021-12-26
1,15,3,12,0,Person,2022-02-05
1,9,2,7,0,Person,2022-02-11
1,11,2,9,0,Person,2022-02-15
1,14,2,12,0,Person,2022-02-17
1,10,3,7,0,Person,2022-02-22
1,13,2,11,0,Person,2022-02-23
1,11,3,8,0,Person,2022-03-02
1,1,1,0,0,Person,2022-03-29
1,4,1,3,0,Person,2022-04-12
1,1,1,0,0,Person,2022-04-18
1,2,2,0,0,Person,2022-04-19
1,3,1,2,0,Person,2022-04-23
1,2,1,1,0,Person,2022-04-24
1,13,3,10,0,Person,2022-04-25
1,3,1,2,0,Person,2022-04-26
1,11,1,10,0,Person,2022-04-28
1,7,2,5,0,Person,2022-04-29
1,6,3,3,0,Person,2022-05-01
1,8,3,5,0,Person,2022-05-05
1,15,6,9,0,Person,2022-05-16
1,13,4,9,0,Person,2022-05-18
1,15,5,10,0,Person,2022-05-19
1,13,3,10,0,Person,2022-05-20
1,12,3,9,0,Person,2022-05-21
1,12,3,9,0,Person,2022-05-27
1,7,4,3,0,Person,2022-05-30
1,13,1,12,0,Person,2022-05-31
1,8,2,6,0,Person,2022-06-05
1,20,4,16,0,Person,2022-06-08
1,6,1,5,0,Person,2022-06-09
2,49,17,32,0,Person,2021-12-27
2,32,12,20,0,Person,2022-01-02
2,53,3,50,0,Person,2022-01-23
2,73,12,61,0,Person,2022-01-26
2,33,11,22,0,Person,2022-01-30
2,43,5,38,0,Person,2022-02-02
2,30,6,24,0,Person,2022-02-04
2,15,1,14,0,Person,2022-02-06
2,22,6,16,0,Person,2022-02-10
2,18,4,14,0,Person,2022-02-14
2,14,2,12,0,Person,2022-05-04
2,6,4,2,0,Person,2022-05-08
2,16,4,12,0,Person,2022-05-11
2,23,8,15,0,Person,2022-05-23
2,13,5,8,0,Person,2022-05-29
2,18,5,13,0,Person,2022-06-01
2,11,4,7,0,Person,2022-06-02
3,27,10,17,0,Person,2021-12-21
3,36,10,26,0,Person,2022-01-01
3,62,15,47,0,Person,2022-01-21
3,25,1,24,0,Person,2022-01-22
3,66,8,58,0,Person,2022-01-27
3,58,16,42,0,Person,2022-01-28
3,31,6,25,0,Person,2022-02-08
3,19,7,12,0,Person,2022-05-12
3,24,7,17,0,Person,2022-05-24
3,16,5,11,0,Person,2022-06-06
4,82,11,71,0,Person,2021-12-28
4,63,3,60,0,Person,2022-01-17
4,27,4,23,0,Person,2022-02-07
4,21,3,18,0,Person,2022-05-17
4,11,10,1,0,Person,2022-06-04
4,18,6,12,0,Person,2022-06-07
5,52,13,39,0,Person,2021-12-31
6,59,27,32,0,Person,2022-01-03
6,74,8,66,0,Person,2022-01-15
6,72,14,58,0,Person,2022-01-31
6,13,3,10,0,Person,2022-06-03
7,83,16,67,0,Person,2021-12-29
7,39,6,33,0,Person,2022-01-09
9,153,12,141,0,Person,2022-01-10
9,170,26,144,0,Person,2022-01-12
10,138,23,115,0,Person,2022-01-11
10,110,6,104,0,Person,2022-01-13
10,91,5,86,0,Person,2022-01-14
12,144,16,128,0,Person,2022-01-04
13,148,23,125,0,Person,2022-01-24
,0,0,0,0,Pitt,2022-03-27
0,22,5,17,0,Pitt,2021-12-18
0,21,5,16,0,Pitt,2021-12-25
0,7,0,7,0,Pitt,2022-02-27
0,5,1,4,0,Pitt,2022-03-11
0,1,0,1,0,Pitt,2022-03-12
0,1,0,1,0,Pitt,2022-03-13
0,4,1,3,0,Pitt,2022-03-15
0,6,1,5,0,Pitt,2022-03-18
0,2,0,2,0,Pitt,2022-03-20
0,3,0,3,0,Pitt,2022-03-21
0,4,1,3,0,Pitt,2022-03-22
0,5,0,5,0,Pitt,2022-03-23
0,4,0,4,0,Pitt,2022-03-26
0,4,1,3,0,Pitt,2022-03-30
0,2,0,2,0,Pitt,2022-03-31
0,4,0,4,0,Pitt,2022-04-01
0,4,0,4,0,Pitt,2022-04-03
0,10,3,7,0,Pitt,2022-04-04
0,16,0,16,0,Pitt,2022-04-13
0,4,0,4,0,Pitt,2022-04-16
0,4,2,2,0,Pitt,2022-04-17
0,12,5,7,0,Pitt,2022-04-20
0,11,0,11,0,Pitt,2022-04-21
0,12,4,8,0,Pitt,2022-04-23
0,2,0,2,0,Pitt,2022-04-24
0,15,3,12,0,Pitt,2022-05-07
1,36,2,34,0,Pitt,2021-12-17
1,11,1,10,0,Pitt,2022-03-01
1,10,3,7,0,Pitt,2022-03-09
1,3,1,2,0,Pitt,2022-03-24
1,3,1,2,0,Pitt,2022-03-29
1,3,0,3,0,Pitt,2022-04-02
1,11,0,11,0,Pitt,2022-04-08
1,6,0,6,0,Pitt,2022-04-09
1,5,0,5,0,Pitt,2022-04-10
1,17,4,13,0,Pitt,2022-04-12
1,11,0,11,0,Pitt,2022-04-18
1,25,7,18,0,Pitt,2022-04-26
1,24,3,21,0,Pitt,2022-04-28
1,9,0,9,0,Pitt,2022-04-30
1,11,1,10,0,Pitt,2022-05-01
1,34,2,32,0,Pitt,2022-05-15
1,25,4,21,0,Pitt,2022-05-21
1,16,3,13,0,Pitt,2022-05-30
2,9,2,7,0,Pitt,2022-03-10
2,7,0,7,0,Pitt,2022-03-28
2,13,0,13,0,Pitt,2022-04-06
2,11,1,10,0,Pitt,2022-04-07
2,22,2,20,0,Pitt,2022-04-11
2,15,2,13,0,Pitt,2022-04-14
2,11,1,10,0,Pitt,2022-04-22
2,26,2,24,0,Pitt,2022-06-04
3,41,1,40,0,Pitt,2021-12-19
3,86,8,78,0,Pitt,2021-12-20
3,52,7,45,0,Pitt,2021-12-26
3,71,12,59,0,Pitt,2022-01-29
3,41,3,38,0,Pitt,2022-02-13
3,20,4,16,0,Pitt,2022-03-03
3,25,2,23,0,Pitt,2022-04-25
3,16,4,12,0,Pitt,2022-04-29
3,20,3,17,0,Pitt,2022-05-08
3,24,5,19,0,Pitt,2022-05-28
3,33,1,32,0,Pitt,2022-06-05
4,41,2,39,0,Pitt,2022-02-17
4,42,6,36,0,Pitt,2022-02-22
4,13,1,12,0,Pitt,2022-04-05
4,16,0,16,0,Pitt,2022-04-19
4,29,2,27,0,Pitt,2022-05-29
5,93,8,85,0,Pitt,2022-02-10
5,62,13,49,0,Pitt,2022-02-15
5,30,2,28,0,Pitt,2022-05-02
5,38,2,36,0,Pitt,2022-05-04
5,37,1,36,0,Pitt,2022-05-05
5,28,5,23,0,Pitt,2022-05-06
5,65,15,50,0,Pitt,2022-05-10
5,23,2,21,0,Pitt,2022-05-14
5,41,1,40,0,Pitt,2022-05-22
6,61,2,59,0,Pitt,2022-02-06
6,42,5,37,0,Pitt,2022-02-21
6,28,2,26,0,Pitt,2022-02-28
6,55,7,48,0,Pitt,2022-05-09
6,57,10,47,0,Pitt,2022-05-13
6,65,8,57,0,Pitt,2022-05-27
6,19,0,19,0,Pitt,2022-06-11
7,70,8,62,0,Pitt,2021-12-15
7,129,10,119,0,Pitt,2021-12-22
7,28,2,26,0,Pitt,2022-04-27
7,60,8,52,0,Pitt,2022-05-12
7,73,14,59,0,Pitt,2022-05-17
8,146,8,138,0,Pitt,2021-12-23
8,86,12,74,0,Pitt,2022-05-24
8,64,13,51,0,Pitt,2022-06-02
8,62,6,56,0,Pitt,2022-06-09
9,101,5,96,0,Pitt,2021-12-21
9,85,12,73,0,Pitt,2022-01-01
10,63,11,52,0,Pitt,2022-05-11
10,95,15,80,0,Pitt,2022-05-16
10,66,7,59,0,Pitt,2022-06-03
11,91,15,76,0,Pitt,2022-05-18
11,56,6,50,0,Pitt,2022-05-20
11,100,11,89,0,Pitt,2022-06-01
11,67,6,61,0,Pitt,2022-06-07
12,61,1,60,0,Pitt,2022-06-10
13,157,8,149,0,Pitt,2022-02-04
13,96,14,82,0,Pitt,2022-05-23
13,88,9,79,0,Pitt,2022-05-26
13,89,18,71,0,Pitt,2022-06-06
15,109,0,109,0,Pitt,2022-01-21
15,129,5,124,0,Pitt,2022-01-30
15,82,15,67,0,Pitt,2022-05-25
15,68,5,63,0,Pitt,2022-06-08
18,252,44,208,0,Pitt,2022-01-15
18,132,19,113,0,Pitt,2022-01-16
18,78,19,59,0,Pitt,2022-05-19
19,134,14,120,0,Pitt,2022-02-08
23,217,21,196,0,Pitt,2022-01-02
27,271,42,229,0,Pitt,2022-01-08
27,151,24,127,0,Pitt,2022-05-31
31,435,22,413,0,Pitt,2021-12-28
36,356,15,341,0,Pitt,2022-01-09
39,428,23,405,0,Pitt,2021-12-27
40,348,11,337,0,Pitt,2021-12-31
50,495,34,461,0,Pitt,2021-12-29
63,667,52,615,0,Pitt,2022-01-24
64,522,41,481,0,Pitt,2021-12-30
71,657,75,582,0,Pitt,2022-01-03
75,838,90,748,0,Pitt,2022-01-19
84,716,65,651,0,Pitt,2022-01-20
92,916,74,842,0,Pitt,2022-01-04
93,850,78,772,0,Pitt,2022-01-13
115,980,62,918,0,Pitt,2022-01-11
,0,0,0,0,Polk,2022-03-06
,0,0,0,0,Polk,2022-03-09
,0,0,0,0,Polk,2022-03-11
,0,0,0,0,Polk,2022-03-12
,0,0,0,0,Polk,2022-03-13
,0,0,0,0,Polk,2022-03-15
,0,0,0,0,Polk,2022-03-16
,0,0,0,0,Polk,2022-03-17
,0,0,0,0,Polk,2022-03-20
,0,0,0,0,Polk,2022-04-02
,0,0,0,0,Polk,2022-04-03
,0,0,0,0,Polk,2022-04-05
,0,0,0,0,Polk,2022-04-06
,0,0,0,0,Polk,2022-04-08
,0,0,0,0,Polk,2022-04-10
,0,0,0,0,Polk,2022-04-12
,0,0,0,0,Polk,2022-04-14
,0,0,0,0,Polk,2022-04-17
,0,0,0,0,Polk,2022-04-20
,0,0,0,0,Polk,2022-04-21
,0,0,0,0,Polk,2022-04-23
,0,0,0,0,Polk,2022-04-24
,0,0,0,0,Polk,2022-04-27
,0,0,0,0,Polk,2022-05-04
,0,0,0,0,Polk,2022-05-06
,0,0,0,0,Polk,2022-05-15
,0,0,0,0,Polk,2022-05-26
0,3,2,1,0,Polk,2021-12-14
0,3,1,2,0,Polk,2021-12-15
0,8,1,7,0,Polk,2021-12-16
0,5,2,3,0,Polk,2021-12-17
0,3,0,3,0,Polk,2021-12-18
0,3,3,0,0,Polk,2021-12-19
0,3,1,2,0,Polk,2021-12-21
0,5,3,2,0,Polk,2021-12-22
0,3,2,1,0,Polk,2021-12-23
0,5,2,3,0,Polk,2021-12-24
0,1,0,1,0,Polk,2021-12-25
0,4,1,3,0,Polk,2021-12-26
0,8,6,2,0,Polk,2022-01-01
0,1,1,0,0,Polk,2022-01-16
0,16,7,9,0,Polk,2022-01-22
0,12,6,6,0,Polk,2022-01-23
0,9,6,3,0,Polk,2022-02-05
0,4,1,3,0,Polk,2022-02-12
0,1,1,0,0,Polk,2022-02-13
0,4,3,1,0,Polk,2022-02-15
0,5,2,3,0,Polk,2022-02-16
0,3,1,2,0,Polk,2022-02-18
0,2,0,2,0,Polk,2022-02-19
0,5,2,3,0,Polk,2022-02-21
0,1,0,1,0,Polk,2022-02-22
0,3,2,1,0,Polk,2022-02-23
0,2,1,1,0,Polk,2022-02-25
0,1,1,0,0,Polk,2022-02-28
0,1,1,0,0,Polk,2022-03-02
0,3,1,2,0,Polk,2022-03-04
0,2,1,1,0,Polk,2022-03-05
0,1,1,0,0,Polk,2022-03-07
0,1,0,1,0,Polk,2022-03-10
0,1,1,0,0,Polk,2022-03-18
0,2,2,0,0,Polk,2022-03-19
0,1,0,1,0,Polk,2022-03-21
0,3,0,3,0,Polk,2022-03-22
0,4,1,3,0,Polk,2022-03-24
0,5,1,4,0,Polk,2022-03-25
0,2,2,0,0,Polk,2022-03-26
0,1,1,0,0,Polk,2022-03-27
0,5,2,3,0,Polk,2022-03-28
0,5,0,5,0,Polk,2022-03-29
0,10,4,6,0,Polk,2022-03-30
0,6,4,2,0,Polk,2022-03-31
0,3,1,2,0,Polk,2022-04-01
0,5,4,1,0,Polk,2022-04-04
0,2,2,0,0,Polk,2022-04-07
0,1,1,0,0,Polk,2022-04-09
0,1,0,1,0,Polk,2022-04-13
0,1,1,0,0,Polk,2022-04-15
0,1,0,1,0,Polk,2022-04-16
0,1,0,1,0,Polk,2022-04-22
0,1,1,0,0,Polk,2022-04-25
0,1,0,1,0,Polk,2022-04-26
0,1,0,1,0,Polk,2022-04-28
0,1,0,1,0,Polk,2022-04-29
0,2,1,1,0,Polk,2022-04-30
0,1,0,1,0,Polk,2022-05-01
0,1,0,1,0,Polk,2022-05-07
0,1,1,0,0,Polk,2022-05-08
0,2,1,1,0,Polk,2022-05-09
0,2,0,2,0,Polk,2022-05-10
0,2,2,0,0,Polk,2022-05-11
0,3,1,2,0,Polk,2022-05-12
0,2,0,2,0,Polk,2022-05-13
0,3,2,1,0,Polk,2022-05-14
0,4,4,0,0,Polk,2022-05-17
0,3,2,1,0,Polk,2022-05-18
0,3,1,2,0,Polk,2022-05-19
0,3,2,1,0,Polk,2022-05-20
0,2,1,1,0,Polk,2022-05-21
0,1,1,0,0,Polk,2022-05-22
0,1,1,0,0,Polk,2022-05-23
0,2,0,2,0,Polk,2022-05-24
0,5,2,3,0,Polk,2022-05-25
0,2,1,1,0,Polk,2022-05-30
0,4,4,0,0,Polk,2022-05-31
0,4,2,2,0,Polk,2022-06-01
0,2,2,0,0,Polk,2022-06-03
0,1,1,0,0,Polk,2022-06-04
0,5,3,2,0,Polk,2022-06-06
0,4,1,3,0,Polk,2022-06-10
0,1,1,0,0,Polk,2022-06-11
1,11,7,4,0,Polk,2021-12-20
1,12,2,10,0,Polk,2021-12-30
1,12,7,5,0,Polk,2021-12-31
1,10,6,4,0,Polk,2022-01-02
1,10,1,9,0,Polk,2022-01-09
1,41,23,18,0,Polk,2022-01-19
1,28,13,15,0,Polk,2022-01-26
1,10,3,7,0,Polk,2022-01-29
1,15,10,5,0,Polk,2022-02-02
1,3,1,2,0,Polk,2022-02-06
1,9,4,5,0,Polk,2022-02-11
1,8,3,5,0,Polk,2022-02-14
1,4,4,0,0,Polk,2022-02-24
1,2,1,1,0,Polk,2022-02-27
1,2,2,0,0,Polk,2022-03-01
1,1,1,0,0,Polk,2022-04-18
1,5,3,2,0,Polk,2022-05-02
1,8,3,5,0,Polk,2022-05-16
1,7,2,5,0,Polk,2022-05-27
1,3,1,2,0,Polk,2022-05-28
1,7,4,3,0,Polk,2022-06-02
1,3,2,1,0,Polk,2022-06-07
1,2,0,2,0,Polk,2022-06-09
2,21,10,11,0,Polk,2021-12-27
2,17,3,14,0,Polk,2021-12-28
2,26,18,8,0,Polk,2021-12-29
2,27,8,19,0,Polk,2022-01-06
2,24,4,20,0,Polk,2022-01-08
2,46,29,17,0,Polk,2022-01-18
2,29,13,16,0,Polk,2022-01-25
2,26,15,11,0,Polk,2022-01-27
2,23,15,8,0,Polk,2022-02-07
2,14,8,6,0,Polk,2022-02-10
2,2,0,2,0,Polk,2022-03-23
2,3,3,0,0,Polk,2022-05-03
2,3,2,1,0,Polk,2022-05-29
2,4,3,1,0,Polk,2022-06-08
3,35,16,19,0,Polk,2022-01-03
3,41,17,24,0,Polk,2022-01-04
3,29,12,17,0,Polk,2022-01-31
4,33,18,15,0,Polk,2022-01-07
4,52,27,25,0,Polk,2022-01-14
4,24,15,9,0,Polk,2022-01-15
4,35,15,20,0,Polk,2022-01-21
4,61,23,38,0,Polk,2022-01-24
5,48,27,21,0,Polk,2022-01-20
5,28,14,14,0,Polk,2022-02-01
6,56,26,30,0,Polk,2022-01-12
8,66,15,51,0,Polk,2022-01-10
11,71,38,33,0,Polk,2022-01-13
0,40,19,21,0,Randolph,2021-12-18
0,21,0,21,0,Randolph,2021-12-25
0,8,1,7,0,Randolph,2022-02-27
0,9,3,6,0,Randolph,2022-03-04
0,11,1,10,0,Randolph,2022-03-09
0,5,1,4,0,Randolph,2022-03-10
0,2,0,2,0,Randolph,2022-03-12
0,5,3,2,0,Randolph,2022-03-13
0,3,0,3,0,Randolph,2022-03-15
0,3,1,2,0,Randolph,2022-03-18
0,3,3,0,0,Randolph,2022-03-19
0,5,1,4,0,Randolph,2022-03-22
0,1,0,1,0,Randolph,2022-03-23
0,2,0,2,0,Randolph,2022-03-24
0,1,0,1,0,Randolph,2022-03-27
0,3,1,2,0,Randolph,2022-03-28
0,4,1,3,0,Randolph,2022-03-29
0,5,1,4,0,Randolph,2022-03-30
0,2,2,0,0,Randolph,2022-03-31
0,2,1,1,0,Randolph,2022-04-01
0,3,0,3,0,Randolph,2022-04-02
0,3,0,3,0,Randolph,2022-04-03
0,7,4,3,0,Randolph,2022-04-06
0,8,4,4,0,Randolph,2022-04-09
0,2,0,2,0,Randolph,2022-04-10
0,2,1,1,0,Randolph,2022-04-17
0,9,1,8,0,Randolph,2022-04-22
0,3,1,2,0,Randolph,2022-04-23
0,4,2,2,0,Randolph,2022-04-24
0,18,8,10,0,Randolph,2022-04-26
0,14,5,9,0,Randolph,2022-05-06
0,14,5,9,0,Randolph,2022-05-14
0,19,8,11,0,Randolph,2022-06-11
1,61,32,29,0,Randolph,2021-12-15
1,61,28,33,0,Randolph,2021-12-26
1,21,4,17,0,Randolph,2022-02-25
1,16,5,11,0,Randolph,2022-03-01
1,11,5,6,0,Randolph,2022-03-05
1,4,0,4,0,Randolph,2022-03-21
1,2,0,2,0,Randolph,2022-03-25
1,2,1,1,0,Randolph,2022-03-26
1,4,1,3,0,Randolph,2022-04-07
1,9,6,3,0,Randolph,2022-04-11
1,12,1,11,0,Randolph,2022-04-13
1,4,1,3,0,Randolph,2022-04-16
1,4,1,3,0,Randolph,2022-04-20
1,21,15,6,0,Randolph,2022-04-28
1,5,3,2,0,Randolph,2022-04-30
1,13,4,9,0,Randolph,2022-05-01
2,29,8,21,0,Randolph,2022-02-23
2,24,9,15,0,Randolph,2022-02-28
2,13,4,9,0,Randolph,2022-03-06
2,8,2,6,0,Randolph,2022-04-05
2,11,2,9,0,Randolph,2022-04-14
2,11,3,8,0,Randolph,2022-04-21
2,18,8,10,0,Randolph,2022-05-03
2,29,12,17,0,Randolph,2022-05-17
2,28,14,14,0,Randolph,2022-05-21
2,25,14,11,0,Randolph,2022-05-22
2,16,6,10,0,Randolph,2022-05-29
2,16,12,4,0,Randolph,2022-05-30
3,11,7,4,0,Randolph,2022-04-18
3,22,10,12,0,Randolph,2022-04-27
3,17,7,10,0,Randolph,2022-04-29
3,11,4,7,0,Randolph,2022-05-04
3,14,8,6,0,Randolph,2022-05-07
3,23,9,14,0,Randolph,2022-05-11
3,26,14,12,0,Randolph,2022-05-12
3,28,14,14,0,Randolph,2022-05-13
3,22,12,10,0,Randolph,2022-05-20
3,33,14,19,0,Randolph,2022-05-24
3,31,19,12,0,Randolph,2022-05-26
3,17,7,10,0,Randolph,2022-05-28
3,19,3,16,0,Randolph,2022-06-05
3,29,15,14,0,Randolph,2022-06-06
4,22,7,15,0,Randolph,2022-06-04
4,33,13,20,0,Randolph,2022-06-07
4,26,12,14,0,Randolph,2022-06-09
5,91,33,58,0,Randolph,2021-12-23
5,31,11,20,0,Randolph,2022-06-01
5,26,15,11,0,Randolph,2022-06-10
6,23,11,12,0,Randolph,2022-02-24
6,34,16,18,0,Randolph,2022-05-18
6,41,21,20,0,Randolph,2022-05-19
6,34,9,25,0,Randolph,2022-06-08
7,97,19,78,0,Randolph,2022-01-17
7,23,8,15,0,Randolph,2022-05-09
7,35,20,15,0,Randolph,2022-05-10
7,44,21,23,0,Randolph,2022-05-27
8,34,11,23,0,Randolph,2022-04-25
9,117,53,64,0,Randolph,2021-12-31
9,50,27,23,0,Randolph,2022-05-16
10,188,79,109,0,Randolph,2021-12-27
14,198,72,126,0,Randolph,2021-12-30
14,69,44,25,0,Randolph,2022-05-23
25,312,114,198,0,Randolph,2022-01-04
46,511,63,448,0,Randolph,2022-01-11
,0,0,0,0,Richmond,2022-03-06
,0,0,0,0,Richmond,2022-03-12
,0,0,0,0,Richmond,2022-03-15
,0,0,0,0,Richmond,2022-03-17
,0,0,0,0,Richmond,2022-03-18
,0,0,0,0,Richmond,2022-03-19
,0,0,0,0,Richmond,2022-03-20
,0,0,0,0,Richmond,2022-03-22
,0,0,0,0,Richmond,2022-03-26
,0,0,0,0,Richmond,2022-03-27
,0,0,0,0,Richmond,2022-03-28
,0,0,0,0,Richmond,2022-03-29
,0,0,0,0,Richmond,2022-03-30
,0,0,0,0,Richmond,2022-03-31
,0,0,0,0,Richmond,2022-04-02
,0,0,0,0,Richmond,2022-04-03
,0,0,0,0,Richmond,2022-04-06
,0,0,0,0,Richmond,2022-04-07
,0,0,0,0,Richmond,2022-04-08
,0,0,0,0,Richmond,2022-04-09
,0,0,0,0,Richmond,2022-04-17
0,12,4,8,0,Richmond,2021-12-15
0,8,4,4,0,Richmond,2021-12-17
0,8,1,7,0,Richmond,2021-12-18
0,20,6,14,0,Richmond,2021-12-22
0,23,5,18,0,Richmond,2022-01-30
0,14,6,8,0,Richmond,2022-02-16
0,11,1,10,0,Richmond,2022-02-18
0,2,1,1,0,Richmond,2022-02-20
0,11,1,10,0,Richmond,2022-02-21
0,12,0,12,0,Richmond,2022-02-22
0,1,0,1,0,Richmond,2022-02-24
0,2,0,2,0,Richmond,2022-02-26
0,1,0,1,0,Richmond,2022-03-01
0,2,1,1,0,Richmond,2022-03-03
0,4,1,3,0,Richmond,2022-03-09
0,2,0,2,0,Richmond,2022-03-10
0,1,0,1,0,Richmond,2022-03-11
0,3,0,3,0,Richmond,2022-03-13
0,2,0,2,0,Richmond,2022-03-14
0,1,1,0,0,Richmond,2022-03-16
0,1,0,1,0,Richmond,2022-03-21
0,1,0,1,0,Richmond,2022-03-23
0,4,1,3,0,Richmond,2022-03-24
0,1,0,1,0,Richmond,2022-03-25
0,1,1,0,0,Richmond,2022-04-01
0,1,0,1,0,Richmond,2022-04-05
0,1,0,1,0,Richmond,2022-04-10
0,1,0,1,0,Richmond,2022-04-11
0,2,0,2,0,Richmond,2022-04-12
0,4,1,3,0,Richmond,2022-04-14
0,3,0,3,0,Richmond,2022-04-15
0,1,1,0,0,Richmond,2022-04-16
0,4,1,3,0,Richmond,2022-04-19
0,5,3,2,0,Richmond,2022-04-22
0,1,0,1,0,Richmond,2022-04-23
0,5,1,4,0,Richmond,2022-04-24
0,3,2,1,0,Richmond,2022-04-25
0,6,0,6,0,Richmond,2022-04-27
0,4,0,4,0,Richmond,2022-05-01
0,14,3,11,0,Richmond,2022-05-02
0,5,3,2,0,Richmond,2022-05-04
0,12,6,6,0,Richmond,2022-05-06
0,2,0,2,0,Richmond,2022-05-07
0,2,0,2,0,Richmond,2022-05-08
0,6,2,4,0,Richmond,2022-05-14
0,11,5,6,0,Richmond,2022-05-20
0,4,2,2,0,Richmond,2022-05-28
0,7,1,6,0,Richmond,2022-05-30
1,19,5,14,0,Richmond,2021-12-14
1,19,5,14,0,Richmond,2021-12-20
1,12,2,10,0,Richmond,2022-02-05
1,7,1,6,0,Richmond,2022-02-12
1,12,4,8,0,Richmond,2022-02-17
1,9,1,8,0,Richmond,2022-02-28
1,5,2,3,0,Richmond,2022-03-02
1,3,0,3,0,Richmond,2022-03-08
1,1,0,1,0,Richmond,2022-04-04
1,6,4,2,0,Richmond,2022-04-13
1,4,0,4,0,Richmond,2022-04-18
1,7,1,6,0,Richmond,2022-04-20
1,3,1,2,0,Richmond,2022-04-26
1,5,2,3,0,Richmond,2022-04-29
1,4,1,3,0,Richmond,2022-04-30
1,13,7,6,0,Richmond,2022-05-09
1,9,3,6,0,Richmond,2022-05-15
1,14,5,9,0,Richmond,2022-05-18
1,6,0,6,0,Richmond,2022-05-22
1,22,14,8,0,Richmond,2022-05-24
1,18,10,8,0,Richmond,2022-05-26
1,17,6,11,0,Richmond,2022-06-01
1,7,4,3,0,Richmond,2022-06-04
1,6,1,5,0,Richmond,2022-06-05
1,15,3,12,0,Richmond,2022-06-09
1,9,5,4,0,Richmond,2022-06-10
2,41,4,37,0,Richmond,2022-01-23
2,6,2,4,0,Richmond,2022-04-21
2,7,1,6,0,Richmond,2022-04-28
2,10,4,6,0,Richmond,2022-05-05
2,7,4,3,0,Richmond,2022-05-10
2,10,6,4,0,Richmond,2022-05-12
2,12,3,9,0,Richmond,2022-05-13
2,12,6,6,0,Richmond,2022-05-29
2,12,4,8,0,Richmond,2022-06-02
2,8,0,8,0,Richmond,2022-06-11
3,32,3,29,0,Richmond,2021-12-26
3,29,6,23,0,Richmond,2022-01-16
3,23,7,16,0,Richmond,2022-02-09
3,33,9,24,0,Richmond,2022-02-14
3,14,3,11,0,Richmond,2022-05-11
3,17,6,11,0,Richmond,2022-05-16
3,14,7,7,0,Richmond,2022-05-19
3,12,5,7,0,Richmond,2022-06-03
3,20,5,15,0,Richmond,2022-06-06
3,23,10,13,0,Richmond,2022-06-07
3,12,3,9,0,Richmond,2022-06-08
4,8,3,5,0,Richmond,2022-02-19
4,24,7,17,0,Richmond,2022-05-23
5,69,3,66,0,Richmond,2021-12-31
5,69,7,62,0,Richmond,2022-01-08
5,68,8,60,0,Richmond,2022-01-28
5,78,26,52,0,Richmond,2022-01-31
5,14,0,14,0,Richmond,2022-05-27
5,26,8,18,0,Richmond,2022-05-31
6,64,3,61,0,Richmond,2022-01-01
7,79,11,68,0,Richmond,2022-01-15
7,55,21,34,0,Richmond,2022-02-01
7,23,10,13,0,Richmond,2022-02-10
9,107,8,99,0,Richmond,2021-12-28
9,95,14,81,0,Richmond,2022-01-17
10,93,7,86,0,Richmond,2021-12-30
13,107,4,103,0,Richmond,2021-12-29
20,282,46,236,0,Richmond,2022-01-11
23,204,21,183,0,Richmond,2022-01-04
26,202,35,167,0,Richmond,2022-01-06
28,352,61,291,0,Richmond,2022-01-18
31,320,66,254,0,Richmond,2022-01-10
,0,0,0,0,Robeson,2022-03-19
,0,0,0,0,Robeson,2022-03-22
0,7,3,4,0,Robeson,2022-03-05
0,5,4,1,0,Robeson,2022-03-10
0,3,1,2,0,Robeson,2022-03-11
0,3,2,1,0,Robeson,2022-03-12
0,3,3,0,0,Robeson,2022-03-16
0,2,1,1,0,Robeson,2022-03-18
0,2,0,2,0,Robeson,2022-03-20
0,7,3,4,0,Robeson,2022-03-23
0,3,1,2,0,Robeson,2022-03-24
0,1,1,0,0,Robeson,2022-03-25
0,4,0,4,0,Robeson,2022-03-30
0,3,1,2,0,Robeson,2022-03-31
0,1,1,0,0,Robeson,2022-04-02
0,2,1,1,0,Robeson,2022-04-03
0,4,2,2,0,Robeson,2022-04-07
0,2,2,0,0,Robeson,2022-04-10
0,5,1,4,0,Robeson,2022-04-17
0,8,3,5,0,Robeson,2022-04-18
0,3,1,2,0,Robeson,2022-04-20
0,15,9,6,0,Robeson,2022-04-28
1,48,18,30,0,Robeson,2021-12-14
1,38,10,28,0,Robeson,2021-12-15
1,52,19,33,0,Robeson,2021-12-22
1,4,1,3,0,Robeson,2022-02-26
1,9,2,7,0,Robeson,2022-02-28
1,13,7,6,0,Robeson,2022-03-02
1,12,3,9,0,Robeson,2022-03-03
1,7,0,7,0,Robeson,2022-03-04
1,3,2,1,0,Robeson,2022-03-06
1,8,4,4,0,Robeson,2022-03-08
1,6,2,4,0,Robeson,2022-03-15
1,8,3,5,0,Robeson,2022-03-17
1,4,1,3,0,Robeson,2022-03-21
1,1,0,1,0,Robeson,2022-03-27
1,7,3,4,0,Robeson,2022-03-29
1,3,3,0,0,Robeson,2022-04-01
1,6,2,4,0,Robeson,2022-04-05
1,10,5,5,0,Robeson,2022-04-06
1,10,5,5,0,Robeson,2022-04-08
1,3,3,0,0,Robeson,2022-04-09
1,9,6,3,0,Robeson,2022-04-11
1,10,5,5,0,Robeson,2022-04-19
1,7,5,2,0,Robeson,2022-04-22
1,6,5,1,0,Robeson,2022-04-23
1,4,1,3,0,Robeson,2022-04-24
1,18,10,8,0,Robeson,2022-04-26
1,22,11,11,0,Robeson,2022-05-22
2,55,17,38,0,Robeson,2021-12-20
2,3,0,3,0,Robeson,2022-03-26
2,7,4,3,0,Robeson,2022-04-14
2,5,4,1,0,Robeson,2022-04-16
2,16,13,3,0,Robeson,2022-04-21
2,13,8,5,0,Robeson,2022-04-27
2,18,14,4,0,Robeson,2022-04-29
2,9,3,6,0,Robeson,2022-04-30
2,11,7,4,0,Robeson,2022-05-01
2,22,14,8,0,Robeson,2022-05-02
3,34,6,28,0,Robeson,2022-02-15
3,6,5,1,0,Robeson,2022-03-07
3,28,16,12,0,Robeson,2022-06-05
4,64,28,36,0,Robeson,2021-12-26
4,22,5,17,0,Robeson,2022-02-12
4,34,12,22,0,Robeson,2022-02-22
4,9,3,6,0,Robeson,2022-04-15
4,23,14,9,0,Robeson,2022-05-03
4,26,11,15,0,Robeson,2022-05-04
4,23,15,8,0,Robeson,2022-05-29
4,40,25,15,0,Robeson,2022-06-10
4,23,9,14,0,Robeson,2022-06-11
5,43,26,17,0,Robeson,2022-01-22
5,24,11,13,0,Robeson,2022-05-06
5,39,21,18,0,Robeson,2022-05-12
5,25,12,13,0,Robeson,2022-05-15
5,29,18,11,0,Robeson,2022-05-30
5,27,13,14,0,Robeson,2022-06-04
6,33,16,17,0,Robeson,2022-02-14
6,22,11,11,0,Robeson,2022-04-25
6,29,15,14,0,Robeson,2022-05-14
6,44,23,21,0,Robeson,2022-05-27
7,40,16,24,0,Robeson,2022-05-09
7,33,14,19,0,Robeson,2022-05-10
8,50,19,31,0,Robeson,2022-05-13
8,57,29,28,0,Robeson,2022-05-18
8,39,21,18,0,Robeson,2022-05-20
8,27,18,9,0,Robeson,2022-05-28
9,52,20,32,0,Robeson,2022-01-01
9,155,61,94,0,Robeson,2022-02-01
10,80,44,36,0,Robeson,2022-05-19
10,63,34,29,0,Robeson,2022-05-24
10,51,26,25,0,Robeson,2022-06-03
11,84,43,41,0,Robeson,2022-05-17
12,68,29,39,0,Robeson,2022-05-16
13,140,61,79,0,Robeson,2022-01-02
13,52,30,22,0,Robeson,2022-05-11
13,74,36,38,0,Robeson,2022-05-23
16,67,34,33,0,Robeson,2022-06-08
18,83,44,39,0,Robeson,2022-06-06
18,68,38,30,0,Robeson,2022-06-07
18,69,32,37,0,Robeson,2022-06-09
19,75,39,36,0,Robeson,2022-05-26
19,78,40,38,0,Robeson,2022-06-01
22,236,80,156,0,Robeson,2022-01-31
23,197,90,107,0,Robeson,2022-01-09
26,205,88,117,0,Robeson,2022-01-08
46,496,152,344,0,Robeson,2022-01-04
46,501,186,315,0,Robeson,2022-01-24
56,471,202,269,0,Robeson,2022-01-03
69,717,269,448,0,Robeson,2022-01-12
80,516,189,327,0,Robeson,2022-01-06
80,746,279,467,0,Robeson,2022-01-10
86,760,287,473,0,Robeson,2022-01-11
,0,0,0,0,Rockingham,2022-03-17
,0,0,0,0,Rockingham,2022-04-02
0,31,8,23,0,Rockingham,2021-12-15
0,11,2,9,0,Rockingham,2022-02-12
0,27,6,21,0,Rockingham,2022-02-17
0,11,2,9,0,Rockingham,2022-02-23
0,9,0,9,0,Rockingham,2022-02-26
0,11,2,9,0,Rockingham,2022-03-01
0,8,1,7,0,Rockingham,2022-03-03
0,4,0,4,0,Rockingham,2022-03-05
0,6,0,6,0,Rockingham,2022-03-10
0,2,0,2,0,Rockingham,2022-03-11
0,1,0,1,0,Rockingham,2022-03-13
0,4,0,4,0,Rockingham,2022-03-15
0,1,0,1,0,Rockingham,2022-03-16
0,5,0,5,0,Rockingham,2022-03-19
0,3,0,3,0,Rockingham,2022-03-21
0,3,1,2,0,Rockingham,2022-03-24
0,3,0,3,0,Rockingham,2022-03-25
0,1,0,1,0,Rockingham,2022-03-27
0,7,1,6,0,Rockingham,2022-03-28
0,3,3,0,0,Rockingham,2022-03-31
0,1,0,1,0,Rockingham,2022-04-01
0,2,0,2,0,Rockingham,2022-04-03
0,4,0,4,0,Rockingham,2022-04-05
0,4,0,4,0,Rockingham,2022-04-06
0,1,0,1,0,Rockingham,2022-04-07
0,3,0,3,0,Rockingham,2022-04-08
0,3,1,2,0,Rockingham,2022-04-09
0,1,1,0,0,Rockingham,2022-04-14
0,1,0,1,0,Rockingham,2022-04-16
0,1,0,1,0,Rockingham,2022-04-17
0,7,1,6,0,Rockingham,2022-04-22
0,3,0,3,0,Rockingham,2022-04-23
0,6,1,5,0,Rockingham,2022-04-29
0,5,0,5,0,Rockingham,2022-04-30
0,11,5,6,0,Rockingham,2022-05-15
0,23,8,15,0,Rockingham,2022-05-24
0,12,4,8,0,Rockingham,2022-05-28
0,14,1,13,0,Rockingham,2022-06-03
1,40,10,30,0,Rockingham,2021-12-17
1,68,15,53,0,Rockingham,2021-12-20
1,48,9,39,0,Rockingham,2021-12-23
1,12,2,10,0,Rockingham,2022-02-24
1,9,0,9,0,Rockingham,2022-02-27
1,23,3,20,0,Rockingham,2022-02-28
1,7,1,6,0,Rockingham,2022-03-18
1,1,0,1,0,Rockingham,2022-03-20
1,2,0,2,0,Rockingham,2022-03-22
1,6,0,6,0,Rockingham,2022-03-29
1,2,0,2,0,Rockingham,2022-03-30
1,4,0,4,0,Rockingham,2022-04-04
1,6,0,6,0,Rockingham,2022-04-10
1,10,3,7,0,Rockingham,2022-04-11
1,6,1,5,0,Rockingham,2022-04-19
1,5,2,3,0,Rockingham,2022-04-20
1,6,0,6,0,Rockingham,2022-04-27
1,13,1,12,0,Rockingham,2022-04-28
1,14,5,9,0,Rockingham,2022-05-04
1,16,4,12,0,Rockingham,2022-05-06
1,9,2,7,0,Rockingham,2022-05-08
1,20,5,15,0,Rockingham,2022-05-11
1,15,7,8,0,Rockingham,2022-05-13
1,28,5,23,0,Rockingham,2022-05-19
1,15,3,12,0,Rockingham,2022-05-21
1,19,0,19,0,Rockingham,2022-05-22
1,35,6,29,0,Rockingham,2022-05-23
1,9,2,7,0,Rockingham,2022-06-04
1,12,4,8,0,Rockingham,2022-06-05
1,20,3,17,0,Rockingham,2022-06-08
1,10,4,6,0,Rockingham,2022-06-10
1,10,1,9,0,Rockingham,2022-06-11
2,29,4,25,0,Rockingham,2022-02-06
2,26,3,23,0,Rockingham,2022-02-22
2,4,0,4,0,Rockingham,2022-04-15
2,6,0,6,0,Rockingham,2022-04-21
2,13,3,10,0,Rockingham,2022-04-25
2,7,1,6,0,Rockingham,2022-05-01
2,7,1,6,0,Rockingham,2022-05-07
2,31,6,25,0,Rockingham,2022-05-10
2,32,6,26,0,Rockingham,2022-06-06
2,36,8,28,0,Rockingham,2022-06-07
3,105,6,99,0,Rockingham,2022-02-01
3,6,1,5,0,Rockingham,2022-04-24
3,8,3,5,0,Rockingham,2022-04-26
3,15,1,14,0,Rockingham,2022-05-02
3,28,8,20,0,Rockingham,2022-05-12
3,15,4,11,0,Rockingham,2022-05-30
3,17,7,10,0,Rockingham,2022-06-02
3,17,1,16,0,Rockingham,2022-06-09
4,12,4,8,0,Rockingham,2022-04-18
4,18,1,17,0,Rockingham,2022-05-05
4,20,6,14,0,Rockingham,2022-05-09
4,30,5,25,0,Rockingham,2022-05-16
4,25,7,18,0,Rockingham,2022-05-20
4,9,5,4,0,Rockingham,2022-05-27
4,13,7,6,0,Rockingham,2022-05-29
5,50,9,41,0,Rockingham,2021-12-22
5,83,32,51,0,Rockingham,2022-01-17
5,25,2,23,0,Rockingham,2022-05-25
5,31,11,20,0,Rockingham,2022-05-26
6,59,6,53,0,Rockingham,2022-01-02
6,42,5,37,0,Rockingham,2022-01-30
6,60,4,56,0,Rockingham,2022-02-10
6,26,4,22,0,Rockingham,2022-06-01
8,143,23,120,0,Rockingham,2021-12-28
8,115,11,104,0,Rockingham,2022-01-08
10,40,6,34,0,Rockingham,2022-05-18
11,162,35,127,0,Rockingham,2021-12-27
18,190,57,133,0,Rockingham,2022-01-03
19,264,56,208,0,Rockingham,2022-01-04
20,316,25,291,0,Rockingham,2022-01-12
24,291,65,226,0,Rockingham,2022-01-24
,0,0,0,0,Rowan,2022-03-27
,0,0,0,0,Rowan,2022-04-02
0,30,5,25,0,Rowan,2021-12-18
0,6,0,6,0,Rowan,2022-03-04
0,2,1,1,0,Rowan,2022-03-12
0,2,0,2,0,Rowan,2022-03-13
0,7,1,6,0,Rowan,2022-03-16
0,4,0,4,0,Rowan,2022-03-17
0,3,1,2,0,Rowan,2022-03-21
0,5,2,3,0,Rowan,2022-03-25
0,3,1,2,0,Rowan,2022-03-26
0,3,1,2,0,Rowan,2022-03-30
0,2,1,1,0,Rowan,2022-03-31
0,3,0,3,0,Rowan,2022-04-01
0,4,2,2,0,Rowan,2022-04-03
0,6,3,3,0,Rowan,2022-04-06
0,3,0,3,0,Rowan,2022-04-09
0,3,1,2,0,Rowan,2022-04-16
0,12,1,11,0,Rowan,2022-04-20
0,13,1,12,0,Rowan,2022-04-24
0,6,3,3,0,Rowan,2022-05-01
1,21,3,18,0,Rowan,2022-02-28
1,2,0,2,0,Rowan,2022-03-03
1,5,2,3,0,Rowan,2022-03-24
1,2,0,2,0,Rowan,2022-03-28
1,9,4,5,0,Rowan,2022-04-07
1,8,2,6,0,Rowan,2022-04-08
1,4,1,3,0,Rowan,2022-04-10
1,6,0,6,0,Rowan,2022-04-11
1,12,2,10,0,Rowan,2022-04-12
1,11,1,10,0,Rowan,2022-04-15
1,7,2,5,0,Rowan,2022-04-17
1,11,3,8,0,Rowan,2022-04-18
1,12,1,11,0,Rowan,2022-04-29
1,28,8,20,0,Rowan,2022-05-15
1,9,0,9,0,Rowan,2022-05-21
1,12,3,9,0,Rowan,2022-05-22
1,20,2,18,0,Rowan,2022-06-11
2,59,5,54,0,Rowan,2021-12-14
2,9,0,9,0,Rowan,2022-02-20
2,11,3,8,0,Rowan,2022-03-06
2,10,0,10,0,Rowan,2022-03-14
2,9,1,8,0,Rowan,2022-03-18
2,11,3,8,0,Rowan,2022-03-22
2,12,4,8,0,Rowan,2022-04-19
2,12,3,9,0,Rowan,2022-04-21
2,20,2,18,0,Rowan,2022-04-27
2,14,3,11,0,Rowan,2022-05-07
2,27,2,25,0,Rowan,2022-05-12
3,48,2,46,0,Rowan,2022-02-16
3,6,1,5,0,Rowan,2022-04-05
3,9,1,8,0,Rowan,2022-04-14
3,15,3,12,0,Rowan,2022-04-22
3,28,5,23,0,Rowan,2022-05-04
3,19,6,13,0,Rowan,2022-05-06
3,31,6,25,0,Rowan,2022-05-09
3,42,9,33,0,Rowan,2022-05-19
3,36,6,30,0,Rowan,2022-05-20
3,15,4,11,0,Rowan,2022-06-04
3,19,2,17,0,Rowan,2022-06-05
4,14,3,11,0,Rowan,2022-04-13
4,32,8,24,0,Rowan,2022-05-13
5,46,6,40,0,Rowan,2022-02-17
5,31,6,25,0,Rowan,2022-02-22
5,14,3,11,0,Rowan,2022-04-23
5,42,4,38,0,Rowan,2022-05-16
5,30,6,24,0,Rowan,2022-05-18
5,50,9,41,0,Rowan,2022-05-26
5,25,10,15,0,Rowan,2022-05-30
5,26,7,19,0,Rowan,2022-06-10
6,92,16,76,0,Rowan,2021-12-23
6,71,14,57,0,Rowan,2022-01-01
6,66,17,49,0,Rowan,2022-01-29
6,55,6,49,0,Rowan,2022-02-14
6,31,2,29,0,Rowan,2022-05-02
6,36,9,27,0,Rowan,2022-05-10
6,51,10,41,0,Rowan,2022-05-23
6,41,10,31,0,Rowan,2022-05-25
6,25,7,18,0,Rowan,2022-05-27
6,27,10,17,0,Rowan,2022-05-28
6,25,5,20,0,Rowan,2022-05-29
6,40,7,33,0,Rowan,2022-06-09
7,38,4,34,0,Rowan,2022-05-03
7,53,8,45,0,Rowan,2022-06-07
8,119,15,104,0,Rowan,2022-02-03
8,25,10,15,0,Rowan,2022-04-25
8,32,3,29,0,Rowan,2022-05-11
8,52,12,40,0,Rowan,2022-05-24
8,53,21,32,0,Rowan,2022-06-06
9,53,5,48,0,Rowan,2022-02-15
9,57,16,41,0,Rowan,2022-06-01
10,73,18,55,0,Rowan,2022-05-31
10,63,21,42,0,Rowan,2022-06-02
12,36,23,13,0,Rowan,2022-03-01
12,43,9,34,0,Rowan,2022-05-17
13,42,3,39,0,Rowan,2022-06-08
18,178,16,162,0,Rowan,2022-02-01
19,108,43,65,0,Rowan,2022-01-02
19,247,36,211,0,Rowan,2022-01-31
23,301,44,257,0,Rowan,2021-12-30
26,253,39,214,0,Rowan,2021-12-27
27,296,25,271,0,Rowan,2021-12-29
37,317,54,263,0,Rowan,2022-01-25
39,409,63,346,0,Rowan,2022-01-06
55,475,65,410,0,Rowan,2022-01-14
,0,0,0,0,Rutherford,2022-03-13
,0,0,0,0,Rutherford,2022-03-14
,0,0,0,0,Rutherford,2022-03-17
,0,0,0,0,Rutherford,2022-03-20
,0,0,0,0,Rutherford,2022-03-24
,0,0,0,0,Rutherford,2022-03-26
,0,0,0,0,Rutherford,2022-04-01
,0,0,0,0,Rutherford,2022-04-03
,0,0,0,0,Rutherford,2022-04-07
,0,0,0,0,Rutherford,2022-04-09
,0,0,0,0,Rutherford,2022-04-11
,0,0,0,0,Rutherford,2022-04-30
0,26,9,17,0,Rutherford,2021-12-15
0,5,2,3,0,Rutherford,2021-12-18
0,23,3,20,0,Rutherford,2021-12-22
0,14,1,13,0,Rutherford,2021-12-24
0,6,2,4,0,Rutherford,2021-12-25
0,6,0,6,0,Rutherford,2022-02-20
0,3,0,3,0,Rutherford,2022-02-26
0,4,0,4,0,Rutherford,2022-02-27
0,7,2,5,0,Rutherford,2022-02-28
0,3,1,2,0,Rutherford,2022-03-03
0,4,0,4,0,Rutherford,2022-03-05
0,1,1,0,0,Rutherford,2022-03-06
0,1,0,1,0,Rutherford,2022-03-07
0,2,0,2,0,Rutherford,2022-03-09
0,4,3,1,0,Rutherford,2022-03-10
0,3,0,3,0,Rutherford,2022-03-12
0,6,1,5,0,Rutherford,2022-03-16
0,1,0,1,0,Rutherford,2022-03-18
0,1,0,1,0,Rutherford,2022-03-19
0,2,1,1,0,Rutherford,2022-03-21
0,1,1,0,0,Rutherford,2022-03-22
0,1,1,0,0,Rutherford,2022-03-23
0,3,1,2,0,Rutherford,2022-03-25
0,2,0,2,0,Rutherford,2022-03-27
0,2,0,2,0,Rutherford,2022-03-28
0,1,1,0,0,Rutherford,2022-03-29
0,1,0,1,0,Rutherford,2022-03-31
0,1,0,1,0,Rutherford,2022-04-02
0,1,0,1,0,Rutherford,2022-04-06
0,1,0,1,0,Rutherford,2022-04-10
0,3,2,1,0,Rutherford,2022-04-12
0,3,0,3,0,Rutherford,2022-04-13
0,1,0,1,0,Rutherford,2022-04-15
0,2,0,2,0,Rutherford,2022-04-16
0,1,0,1,0,Rutherford,2022-04-17
0,1,0,1,0,Rutherford,2022-04-19
0,3,1,2,0,Rutherford,2022-04-24
0,2,1,1,0,Rutherford,2022-04-28
0,3,1,2,0,Rutherford,2022-04-29
0,2,0,2,0,Rutherford,2022-05-01
0,3,0,3,0,Rutherford,2022-05-03
0,5,1,4,0,Rutherford,2022-05-05
0,6,1,5,0,Rutherford,2022-05-14
0,4,2,2,0,Rutherford,2022-05-15
1,17,6,11,0,Rutherford,2021-12-16
1,20,2,18,0,Rutherford,2021-12-20
1,13,0,13,0,Rutherford,2022-02-06
1,5,1,4,0,Rutherford,2022-03-04
1,1,0,1,0,Rutherford,2022-03-08
1,3,1,2,0,Rutherford,2022-03-30
1,2,0,2,0,Rutherford,2022-04-04
1,1,0,1,0,Rutherford,2022-04-05
1,3,0,3,0,Rutherford,2022-04-08
1,4,0,4,0,Rutherford,2022-04-14
1,5,1,4,0,Rutherford,2022-04-18
1,6,0,6,0,Rutherford,2022-04-20
1,4,0,4,0,Rutherford,2022-04-21
1,3,1,2,0,Rutherford,2022-04-23
1,4,1,3,0,Rutherford,2022-04-25
1,5,1,4,0,Rutherford,2022-05-08
1,5,0,5,0,Rutherford,2022-05-09
1,11,5,6,0,Rutherford,2022-05-12
1,25,8,17,0,Rutherford,2022-05-18
1,18,4,14,0,Rutherford,2022-05-19
1,8,4,4,0,Rutherford,2022-05-20
1,8,4,4,0,Rutherford,2022-05-21
1,10,6,4,0,Rutherford,2022-05-26
1,11,3,8,0,Rutherford,2022-05-27
1,6,3,3,0,Rutherford,2022-05-28
1,8,2,6,0,Rutherford,2022-06-04
1,20,3,17,0,Rutherford,2022-06-09
1,13,0,13,0,Rutherford,2022-06-11
2,31,13,18,0,Rutherford,2021-12-23
2,17,3,14,0,Rutherford,2021-12-26
2,50,12,38,0,Rutherford,2021-12-27
2,3,0,3,0,Rutherford,2022-02-25
2,4,4,0,0,Rutherford,2022-03-11
2,7,2,5,0,Rutherford,2022-04-22
2,8,4,4,0,Rutherford,2022-04-27
2,12,1,11,0,Rutherford,2022-05-04
2,11,2,9,0,Rutherford,2022-05-06
2,6,2,4,0,Rutherford,2022-05-07
2,13,3,10,0,Rutherford,2022-05-13
2,16,2,14,0,Rutherford,2022-05-16
2,10,7,3,0,Rutherford,2022-05-22
2,9,2,7,0,Rutherford,2022-05-29
2,9,5,4,0,Rutherford,2022-05-30
3,44,18,26,0,Rutherford,2022-02-10
3,32,8,24,0,Rutherford,2022-02-16
3,13,3,10,0,Rutherford,2022-02-21
3,10,2,8,0,Rutherford,2022-02-22
3,13,4,9,0,Rutherford,2022-05-25
3,12,3,9,0,Rutherford,2022-06-03
3,16,1,15,0,Rutherford,2022-06-10
4,21,9,12,0,Rutherford,2022-05-23
4,15,5,10,0,Rutherford,2022-06-01
4,21,5,16,0,Rutherford,2022-06-02
4,15,2,13,0,Rutherford,2022-06-07
4,16,0,16,0,Rutherford,2022-06-08
5,49,19,30,0,Rutherford,2022-01-02
5,33,12,21,0,Rutherford,2022-01-30
5,13,3,10,0,Rutherford,2022-05-17
5,16,3,13,0,Rutherford,2022-05-31
6,83,28,55,0,Rutherford,2021-12-30
6,53,16,37,0,Rutherford,2021-12-31
6,52,22,30,0,Rutherford,2022-01-08
6,75,23,52,0,Rutherford,2022-02-02
6,17,5,12,0,Rutherford,2022-06-06
7,44,13,31,0,Rutherford,2022-01-17
7,25,8,17,0,Rutherford,2022-05-24
8,46,23,23,0,Rutherford,2022-01-09
10,81,18,63,0,Rutherford,2021-12-28
11,127,63,64,0,Rutherford,2021-12-29
13,76,34,42,0,Rutherford,2022-02-07
14,182,66,116,0,Rutherford,2022-01-19
15,172,45,127,0,Rutherford,2022-01-06
15,152,74,78,0,Rutherford,2022-01-07
15,123,51,72,0,Rutherford,2022-01-26
16,149,50,99,0,Rutherford,2022-01-21
16,124,31,93,0,Rutherford,2022-01-27
17,114,26,88,0,Rutherford,2022-01-04
20,122,54,68,0,Rutherford,2022-01-03
20,192,69,123,0,Rutherford,2022-01-20
28,310,79,231,0,Rutherford,2022-01-11
31,231,107,124,0,Rutherford,2022-01-12
42,259,137,122,0,Rutherford,2022-01-10
,0,0,0,0,Sampson,2022-03-10
,0,0,0,0,Sampson,2022-03-27
,0,0,0,0,Sampson,2022-04-01
,0,0,0,0,Sampson,2022-04-10
,0,0,0,0,Sampson,2022-04-13
,0,0,0,0,Sampson,2022-04-17
0,13,9,4,0,Sampson,2021-12-15
0,13,7,6,0,Sampson,2021-12-17
0,5,4,1,0,Sampson,2021-12-18
0,7,2,5,0,Sampson,2021-12-24
0,5,2,3,0,Sampson,2021-12-25
0,3,1,2,0,Sampson,2022-02-19
0,4,3,1,0,Sampson,2022-02-26
0,3,1,2,0,Sampson,2022-02-27
0,8,0,8,0,Sampson,2022-02-28
0,4,1,3,0,Sampson,2022-03-02
0,3,1,2,0,Sampson,2022-03-04
0,1,1,0,0,Sampson,2022-03-05
0,3,1,2,0,Sampson,2022-03-08
0,1,1,0,0,Sampson,2022-03-09
0,1,0,1,0,Sampson,2022-03-11
0,1,0,1,0,Sampson,2022-03-12
0,1,0,1,0,Sampson,2022-03-13
0,6,4,2,0,Sampson,2022-03-15
0,4,2,2,0,Sampson,2022-03-16
0,3,1,2,0,Sampson,2022-03-17
0,2,1,1,0,Sampson,2022-03-18
0,3,1,2,0,Sampson,2022-03-22
0,1,0,1,0,Sampson,2022-03-23
0,1,0,1,0,Sampson,2022-03-25
0,1,0,1,0,Sampson,2022-03-26
0,3,3,0,0,Sampson,2022-03-29
0,10,0,10,0,Sampson,2022-03-31
0,1,1,0,0,Sampson,2022-04-02
0,3,3,0,0,Sampson,2022-04-03
0,2,1,1,0,Sampson,2022-04-04
0,4,2,2,0,Sampson,2022-04-07
0,1,0,1,0,Sampson,2022-04-08
0,4,1,3,0,Sampson,2022-04-11
0,9,3,6,0,Sampson,2022-04-14
0,4,1,3,0,Sampson,2022-04-15
0,5,4,1,0,Sampson,2022-04-20
0,9,6,3,0,Sampson,2022-04-22
0,1,0,1,0,Sampson,2022-04-23
0,2,1,1,0,Sampson,2022-04-24
0,6,4,2,0,Sampson,2022-04-25
0,4,2,2,0,Sampson,2022-04-28
0,4,2,2,0,Sampson,2022-04-29
0,1,1,0,0,Sampson,2022-04-30
0,8,5,3,0,Sampson,2022-05-04
0,1,0,1,0,Sampson,2022-05-06
0,4,3,1,0,Sampson,2022-05-08
0,4,1,3,0,Sampson,2022-05-10
0,3,1,2,0,Sampson,2022-05-11
0,7,3,4,0,Sampson,2022-05-13
0,2,2,0,0,Sampson,2022-05-15
0,12,6,6,0,Sampson,2022-05-19
0,5,3,2,0,Sampson,2022-05-22
0,9,7,2,0,Sampson,2022-05-26
0,9,6,3,0,Sampson,2022-05-29
0,25,13,12,0,Sampson,2022-06-06
0,10,2,8,0,Sampson,2022-06-08
0,5,3,2,0,Sampson,2022-06-11
1,28,14,14,0,Sampson,2021-12-14
1,24,17,7,0,Sampson,2021-12-16
1,19,11,8,0,Sampson,2021-12-19
1,27,14,13,0,Sampson,2021-12-20
1,24,10,14,0,Sampson,2021-12-23
1,13,2,11,0,Sampson,2021-12-26
1,48,17,31,0,Sampson,2022-01-16
1,16,7,9,0,Sampson,2022-02-15
1,25,11,14,0,Sampson,2022-02-21
1,12,5,7,0,Sampson,2022-02-22
1,7,5,2,0,Sampson,2022-03-01
1,4,3,1,0,Sampson,2022-03-14
1,3,1,2,0,Sampson,2022-03-21
1,5,3,2,0,Sampson,2022-03-24
1,2,0,2,0,Sampson,2022-03-28
1,7,5,2,0,Sampson,2022-03-30
1,6,6,0,0,Sampson,2022-04-05
1,11,7,4,0,Sampson,2022-04-06
1,6,4,2,0,Sampson,2022-04-21
1,10,3,7,0,Sampson,2022-04-26
1,1,1,0,0,Sampson,2022-04-27
1,3,2,1,0,Sampson,2022-05-01
1,13,9,4,0,Sampson,2022-05-05
1,5,1,4,0,Sampson,2022-05-07
1,3,2,1,0,Sampson,2022-05-09
1,11,4,7,0,Sampson,2022-05-12
1,5,3,2,0,Sampson,2022-05-14
1,15,9,6,0,Sampson,2022-05-17
1,8,7,1,0,Sampson,2022-05-21
1,9,5,4,0,Sampson,2022-05-27
1,4,1,3,0,Sampson,2022-05-28
1,6,6,0,0,Sampson,2022-05-30
1,30,22,8,0,Sampson,2022-05-31
1,19,14,5,0,Sampson,2022-06-02
1,13,9,4,0,Sampson,2022-06-03
1,7,5,2,0,Sampson,2022-06-04
1,11,7,4,0,Sampson,2022-06-09
1,12,7,5,0,Sampson,2022-06-10
2,26,12,14,0,Sampson,2021-12-22
2,75,22,53,0,Sampson,2022-02-01
2,43,18,25,0,Sampson,2022-02-09
2,10,4,6,0,Sampson,2022-02-12
2,15,5,10,0,Sampson,2022-02-25
2,3,1,2,0,Sampson,2022-03-19
2,12,8,4,0,Sampson,2022-05-02
2,9,5,4,0,Sampson,2022-05-03
2,25,17,8,0,Sampson,2022-05-16
2,17,8,9,0,Sampson,2022-05-18
2,16,11,5,0,Sampson,2022-05-20
2,19,10,9,0,Sampson,2022-05-23
3,113,56,57,0,Sampson,2021-12-30
3,25,12,13,0,Sampson,2022-01-01
3,26,10,16,0,Sampson,2022-01-22
3,42,6,36,0,Sampson,2022-01-23
3,54,17,37,0,Sampson,2022-02-04
3,10,4,6,0,Sampson,2022-04-18
3,10,4,6,0,Sampson,2022-04-19
4,91,48,43,0,Sampson,2021-12-28
4,97,48,49,0,Sampson,2021-12-29
4,101,36,65,0,Sampson,2022-01-28
4,17,11,6,0,Sampson,2022-05-24
4,16,8,8,0,Sampson,2022-05-25
4,23,12,11,0,Sampson,2022-06-01
4,29,16,13,0,Sampson,2022-06-07
5,45,23,22,0,Sampson,2022-01-02
5,125,59,66,0,Sampson,2022-01-15
5,31,16,15,0,Sampson,2022-02-10
6,69,39,30,0,Sampson,2021-12-31
6,111,45,66,0,Sampson,2022-01-27
7,86,29,57,0,Sampson,2022-01-09
7,59,22,37,0,Sampson,2022-01-21
12,207,107,100,0,Sampson,2022-01-03
22,282,68,214,0,Sampson,2022-01-13
24,259,80,179,0,Sampson,2022-01-14
25,269,117,152,0,Sampson,2022-01-06
28,390,142,248,0,Sampson,2022-01-10
35,385,130,255,0,Sampson,2022-01-11
36,399,132,267,0,Sampson,2022-01-12
,0,0,0,0,Scotland,2022-03-12
,0,0,0,0,Scotland,2022-03-13
,0,0,0,0,Scotland,2022-03-23
,0,0,0,0,Scotland,2022-03-26
,0,0,0,0,Scotland,2022-03-27
,0,0,0,0,Scotland,2022-03-31
,0,0,0,0,Scotland,2022-04-01
,0,0,0,0,Scotland,2022-04-02
,0,0,0,0,Scotland,2022-04-03
,0,0,0,0,Scotland,2022-04-06
,0,0,0,0,Scotland,2022-04-07
,0,0,0,0,Scotland,2022-04-10
,0,0,0,0,Scotland,2022-04-17
,0,0,0,0,Scotland,2022-04-29
0,10,3,7,0,Scotland,2021-12-15
0,7,6,1,0,Scotland,2021-12-19
0,24,9,15,0,Scotland,2021-12-23
0,8,1,7,0,Scotland,2021-12-24
0,10,6,4,0,Scotland,2021-12-25
0,12,5,7,0,Scotland,2022-02-05
0,10,1,9,0,Scotland,2022-02-16
0,12,6,6,0,Scotland,2022-02-17
0,4,2,2,0,Scotland,2022-02-18
0,5,1,4,0,Scotland,2022-02-20
0,2,1,1,0,Scotland,2022-02-22
0,1,0,1,0,Scotland,2022-02-23
0,3,2,1,0,Scotland,2022-02-24
0,6,1,5,0,Scotland,2022-02-25
0,1,1,0,0,Scotland,2022-02-27
0,6,1,5,0,Scotland,2022-02-28
0,1,0,1,0,Scotland,2022-03-01
0,1,0,1,0,Scotland,2022-03-04
0,1,1,0,0,Scotland,2022-03-06
0,1,1,0,0,Scotland,2022-03-08
0,2,0,2,0,Scotland,2022-03-09
0,1,0,1,0,Scotland,2022-03-10
0,2,0,2,0,Scotland,2022-03-11
0,2,1,1,0,Scotland,2022-03-15
0,2,1,1,0,Scotland,2022-03-16
0,1,0,1,0,Scotland,2022-03-17
0,1,0,1,0,Scotland,2022-03-18
0,1,0,1,0,Scotland,2022-03-19
0,1,1,0,0,Scotland,2022-03-20
0,2,1,1,0,Scotland,2022-03-21
0,1,0,1,0,Scotland,2022-03-22
0,2,2,0,0,Scotland,2022-03-24
0,2,0,2,0,Scotland,2022-03-25
0,1,1,0,0,Scotland,2022-03-28
0,3,1,2,0,Scotland,2022-03-30
0,2,2,0,0,Scotland,2022-04-04
0,5,0,5,0,Scotland,2022-04-08
0,1,1,0,0,Scotland,2022-04-09
0,3,2,1,0,Scotland,2022-04-12
0,1,1,0,0,Scotland,2022-04-14
0,1,1,0,0,Scotland,2022-04-16
0,8,2,6,0,Scotland,2022-04-20
0,4,3,1,0,Scotland,2022-04-23
0,3,1,2,0,Scotland,2022-04-24
0,4,3,1,0,Scotland,2022-04-26
0,6,3,3,0,Scotland,2022-04-27
0,3,3,0,0,Scotland,2022-04-30
0,3,3,0,0,Scotland,2022-05-01
0,3,0,3,0,Scotland,2022-05-02
0,8,3,5,0,Scotland,2022-05-04
0,4,1,3,0,Scotland,2022-05-05
0,10,4,6,0,Scotland,2022-05-06
0,9,5,4,0,Scotland,2022-05-08
0,8,2,6,0,Scotland,2022-05-09
0,4,1,3,0,Scotland,2022-05-10
0,15,4,11,0,Scotland,2022-05-13
0,4,4,0,0,Scotland,2022-05-15
0,5,2,3,0,Scotland,2022-05-18
0,6,3,3,0,Scotland,2022-05-21
0,12,4,8,0,Scotland,2022-05-28
0,8,7,1,0,Scotland,2022-05-29
0,9,7,2,0,Scotland,2022-05-30
1,16,3,13,0,Scotland,2021-12-17
1,4,2,2,0,Scotland,2021-12-18
1,9,2,7,0,Scotland,2021-12-20
1,27,10,17,0,Scotland,2021-12-26
1,7,2,5,0,Scotland,2022-02-11
1,6,3,3,0,Scotland,2022-02-13
1,1,1,0,0,Scotland,2022-03-05
1,2,1,1,0,Scotland,2022-03-14
1,1,0,1,0,Scotland,2022-03-29
1,4,2,2,0,Scotland,2022-04-11
1,9,0,9,0,Scotland,2022-04-13
1,8,1,7,0,Scotland,2022-04-15
1,2,2,0,0,Scotland,2022-04-18
1,2,1,1,0,Scotland,2022-04-19
1,2,1,1,0,Scotland,2022-04-21
1,9,6,3,0,Scotland,2022-04-22
1,4,1,3,0,Scotland,2022-04-25
1,5,2,3,0,Scotland,2022-04-28
1,7,3,4,0,Scotland,2022-05-07
1,6,1,5,0,Scotland,2022-05-14
1,17,4,13,0,Scotland,2022-05-16
1,13,9,4,0,Scotland,2022-05-19
1,13,5,8,0,Scotland,2022-05-22
1,20,12,8,0,Scotland,2022-05-23
1,19,13,6,0,Scotland,2022-06-03
1,14,13,1,0,Scotland,2022-06-04
1,5,3,2,0,Scotland,2022-06-05
1,15,8,7,0,Scotland,2022-06-07
1,11,8,3,0,Scotland,2022-06-09
1,9,6,3,0,Scotland,2022-06-11
2,19,3,16,0,Scotland,2021-12-14
2,46,11,35,0,Scotland,2021-12-31
2,62,23,39,0,Scotland,2022-01-17
2,29,10,19,0,Scotland,2022-01-23
2,50,17,33,0,Scotland,2022-01-31
2,38,10,28,0,Scotland,2022-02-03
2,32,11,21,0,Scotland,2022-02-07
2,16,2,14,0,Scotland,2022-02-08
2,22,7,15,0,Scotland,2022-02-09
2,7,3,4,0,Scotland,2022-02-15
2,10,5,5,0,Scotland,2022-02-21
2,9,2,7,0,Scotland,2022-05-11
2,8,4,4,0,Scotland,2022-05-12
2,14,10,4,0,Scotland,2022-05-24
2,14,7,7,0,Scotland,2022-05-27
2,27,19,8,0,Scotland,2022-06-02
2,15,5,10,0,Scotland,2022-06-10
3,17,4,13,0,Scotland,2021-12-22
3,63,19,44,0,Scotland,2022-01-08
3,17,8,9,0,Scotland,2022-05-20
3,12,8,4,0,Scotland,2022-05-26
3,21,12,9,0,Scotland,2022-06-08
4,46,8,38,0,Scotland,2022-01-01
4,49,14,35,0,Scotland,2022-01-02
4,21,8,13,0,Scotland,2022-05-25
4,12,7,5,0,Scotland,2022-05-31
5,63,15,48,0,Scotland,2021-12-27
5,116,38,78,0,Scotland,2022-01-20
6,62,16,46,0,Scotland,2022-01-27
7,82,28,54,0,Scotland,2022-01-25
7,16,8,8,0,Scotland,2022-06-01
7,28,15,13,0,Scotland,2022-06-06
8,109,13,96,0,Scotland,2021-12-28
9,86,26,60,0,Scotland,2022-01-15
9,59,19,40,0,Scotland,2022-01-26
10,126,21,105,0,Scotland,2022-01-03
10,134,35,99,0,Scotland,2022-01-14
13,116,20,96,0,Scotland,2021-12-30
14,158,47,111,0,Scotland,2022-01-13
14,197,55,142,0,Scotland,2022-01-18
15,215,40,175,0,Scotland,2022-01-10
15,215,42,173,0,Scotland,2022-01-11
19,206,39,167,0,Scotland,2022-01-06
20,214,49,165,0,Scotland,2022-01-12
,0,0,0,0,Stanly,2022-03-06
,0,0,0,0,Stanly,2022-03-09
,0,0,0,0,Stanly,2022-03-10
,0,0,0,0,Stanly,2022-03-11
,0,0,0,0,Stanly,2022-03-13
,0,0,0,0,Stanly,2022-03-26
,0,0,0,0,Stanly,2022-03-28
,0,0,0,0,Stanly,2022-04-01
,0,0,0,0,Stanly,2022-04-02
,0,0,0,0,Stanly,2022-04-04
,0,0,0,0,Stanly,2022-04-08
,0,0,0,0,Stanly,2022-04-11
,0,0,0,0,Stanly,2022-04-15
,0,0,0,0,Stanly,2022-04-17
,0,0,0,0,Stanly,2022-04-23
0,17,2,15,0,Stanly,2021-12-18
0,16,4,12,0,Stanly,2021-12-24
0,13,1,12,0,Stanly,2022-02-16
0,5,0,5,0,Stanly,2022-02-20
0,22,1,21,0,Stanly,2022-02-21
0,6,1,5,0,Stanly,2022-02-23
0,1,1,0,0,Stanly,2022-02-26
0,3,1,2,0,Stanly,2022-03-04
0,1,0,1,0,Stanly,2022-03-12
0,2,0,2,0,Stanly,2022-03-17
0,1,0,1,0,Stanly,2022-03-19
0,1,0,1,0,Stanly,2022-03-20
0,1,0,1,0,Stanly,2022-03-21
0,1,0,1,0,Stanly,2022-03-22
0,2,0,2,0,Stanly,2022-03-25
0,3,1,2,0,Stanly,2022-03-27
0,1,0,1,0,Stanly,2022-03-31
0,1,0,1,0,Stanly,2022-04-03
0,1,0,1,0,Stanly,2022-04-06
0,1,0,1,0,Stanly,2022-04-09
0,1,0,1,0,Stanly,2022-04-10
0,1,0,1,0,Stanly,2022-04-12
0,3,0,3,0,Stanly,2022-04-16
0,2,0,2,0,Stanly,2022-04-22
0,2,1,1,0,Stanly,2022-04-24
0,8,0,8,0,Stanly,2022-04-27
0,1,0,1,0,Stanly,2022-05-01
0,6,0,6,0,Stanly,2022-05-03
0,8,0,8,0,Stanly,2022-05-04
0,5,1,4,0,Stanly,2022-05-05
0,2,0,2,0,Stanly,2022-05-06
0,11,0,11,0,Stanly,2022-05-22
0,26,3,23,0,Stanly,2022-05-31
0,9,1,8,0,Stanly,2022-06-10
0,12,0,12,0,Stanly,2022-06-11
1,30,4,26,0,Stanly,2021-12-16
1,36,2,34,0,Stanly,2021-12-22
1,37,5,32,0,Stanly,2021-12-23
1,11,0,11,0,Stanly,2022-02-12
1,13,1,12,0,Stanly,2022-02-18
1,9,0,9,0,Stanly,2022-02-24
1,3,0,3,0,Stanly,2022-03-07
1,2,0,2,0,Stanly,2022-03-18
1,2,0,2,0,Stanly,2022-04-05
1,2,0,2,0,Stanly,2022-04-07
1,2,0,2,0,Stanly,2022-04-13
1,4,1,3,0,Stanly,2022-04-14
1,4,0,4,0,Stanly,2022-04-19
1,3,0,3,0,Stanly,2022-04-20
1,2,0,2,0,Stanly,2022-04-21
1,4,1,3,0,Stanly,2022-04-29
1,2,1,1,0,Stanly,2022-04-30
1,2,0,2,0,Stanly,2022-05-07
1,3,2,1,0,Stanly,2022-05-08
1,10,5,5,0,Stanly,2022-05-15
1,16,0,16,0,Stanly,2022-05-17
1,15,4,11,0,Stanly,2022-05-26
1,12,0,12,0,Stanly,2022-05-28
1,12,0,12,0,Stanly,2022-05-29
1,12,0,12,0,Stanly,2022-06-04
2,12,3,9,0,Stanly,2021-12-25
2,6,0,6,0,Stanly,2022-02-13
2,25,2,23,0,Stanly,2022-02-14
2,15,2,13,0,Stanly,2022-02-22
2,10,0,10,0,Stanly,2022-03-02
2,2,0,2,0,Stanly,2022-04-26
2,6,1,5,0,Stanly,2022-05-10
2,17,7,10,0,Stanly,2022-05-13
2,16,3,13,0,Stanly,2022-05-19
2,4,0,4,0,Stanly,2022-05-21
2,32,2,30,0,Stanly,2022-05-24
2,24,3,21,0,Stanly,2022-05-27
2,15,2,13,0,Stanly,2022-06-01
2,19,4,15,0,Stanly,2022-06-02
2,15,0,15,0,Stanly,2022-06-05
3,16,2,14,0,Stanly,2021-12-26
3,34,9,25,0,Stanly,2022-01-29
3,9,1,8,0,Stanly,2022-02-25
3,4,0,4,0,Stanly,2022-04-18
3,10,1,9,0,Stanly,2022-05-09
3,17,2,15,0,Stanly,2022-05-12
3,21,6,15,0,Stanly,2022-05-25
3,10,4,6,0,Stanly,2022-05-30
4,25,11,14,0,Stanly,2022-01-16
4,67,11,56,0,Stanly,2022-02-01
4,25,4,21,0,Stanly,2022-05-18
4,22,2,20,0,Stanly,2022-05-20
4,19,2,17,0,Stanly,2022-06-07
4,20,2,18,0,Stanly,2022-06-08
5,36,10,26,0,Stanly,2021-12-20
5,81,11,70,0,Stanly,2021-12-27
6,57,3,54,0,Stanly,2022-02-03
6,20,0,20,0,Stanly,2022-02-06
6,53,7,46,0,Stanly,2022-02-07
6,21,3,18,0,Stanly,2022-06-09
7,41,14,27,0,Stanly,2022-01-01
7,20,1,19,0,Stanly,2022-06-03
7,31,9,22,0,Stanly,2022-06-06
8,132,19,113,0,Stanly,2021-12-28
8,106,29,77,0,Stanly,2022-01-17
8,110,7,103,0,Stanly,2022-01-28
11,119,38,81,0,Stanly,2022-01-15
12,114,14,100,0,Stanly,2021-12-29
15,37,8,29,0,Stanly,2022-05-23
19,180,44,136,0,Stanly,2022-01-06
22,168,54,114,0,Stanly,2021-12-30
37,256,51,205,0,Stanly,2022-01-20
40,353,85,268,0,Stanly,2022-01-11
,0,0,0,0,Stokes,2022-03-13
,0,0,0,0,Stokes,2022-03-16
,0,0,0,0,Stokes,2022-03-17
,0,0,0,0,Stokes,2022-03-18
,0,0,0,0,Stokes,2022-03-20
,0,0,0,0,Stokes,2022-03-22
,0,0,0,0,Stokes,2022-03-24
,0,0,0,0,Stokes,2022-03-25
,0,0,0,0,Stokes,2022-04-03
,0,0,0,0,Stokes,2022-04-07
,0,0,0,0,Stokes,2022-04-12
,0,0,0,0,Stokes,2022-04-16
,0,0,0,0,Stokes,2022-04-17
0,41,7,34,0,Stokes,2021-12-14
0,3,0,3,0,Stokes,2021-12-25
0,15,3,12,0,Stokes,2022-02-06
0,6,3,3,0,Stokes,2022-02-20
0,3,0,3,0,Stokes,2022-02-26
0,2,0,2,0,Stokes,2022-02-27
0,2,0,2,0,Stokes,2022-03-02
0,4,1,3,0,Stokes,2022-03-04
0,2,0,2,0,Stokes,2022-03-06
0,5,0,5,0,Stokes,2022-03-07
0,5,0,5,0,Stokes,2022-03-08
0,3,1,2,0,Stokes,2022-03-09
0,2,2,0,0,Stokes,2022-03-10
0,2,0,2,0,Stokes,2022-03-12
0,3,0,3,0,Stokes,2022-03-14
0,1,0,1,0,Stokes,2022-03-15
0,1,0,1,0,Stokes,2022-03-19
0,2,1,1,0,Stokes,2022-03-23
0,4,4,0,0,Stokes,2022-03-26
0,1,0,1,0,Stokes,2022-03-27
0,2,2,0,0,Stokes,2022-03-29
0,4,0,4,0,Stokes,2022-03-30
0,3,3,0,0,Stokes,2022-03-31
0,1,1,0,0,Stokes,2022-04-01
0,5,2,3,0,Stokes,2022-04-04
0,1,1,0,0,Stokes,2022-04-05
0,3,0,3,0,Stokes,2022-04-06
0,1,1,0,0,Stokes,2022-04-09
0,2,0,2,0,Stokes,2022-04-11
0,3,1,2,0,Stokes,2022-04-13
0,2,0,2,0,Stokes,2022-04-14
0,1,0,1,0,Stokes,2022-04-15
0,1,0,1,0,Stokes,2022-04-18
0,1,0,1,0,Stokes,2022-04-19
0,4,3,1,0,Stokes,2022-04-20
0,4,0,4,0,Stokes,2022-04-21
0,3,1,2,0,Stokes,2022-04-22
0,2,1,1,0,Stokes,2022-04-23
0,5,2,3,0,Stokes,2022-04-29
0,4,1,3,0,Stokes,2022-04-30
0,10,2,8,0,Stokes,2022-05-02
0,4,0,4,0,Stokes,2022-05-03
0,8,0,8,0,Stokes,2022-05-04
0,11,3,8,0,Stokes,2022-05-12
0,8,2,6,0,Stokes,2022-05-15
0,11,3,8,0,Stokes,2022-05-25
0,6,3,3,0,Stokes,2022-05-29
0,4,2,2,0,Stokes,2022-05-30
0,8,3,5,0,Stokes,2022-06-05
0,5,1,4,0,Stokes,2022-06-07
0,13,4,9,0,Stokes,2022-06-08
0,12,1,11,0,Stokes,2022-06-10
1,35,8,27,0,Stokes,2021-12-15
1,16,1,15,0,Stokes,2021-12-18
1,43,11,32,0,Stokes,2021-12-20
1,15,2,13,0,Stokes,2021-12-24
1,9,1,8,0,Stokes,2021-12-26
1,58,8,50,0,Stokes,2021-12-28
1,28,8,20,0,Stokes,2022-01-02
1,13,2,11,0,Stokes,2022-02-13
1,30,7,23,0,Stokes,2022-02-14
1,8,3,5,0,Stokes,2022-02-23
1,8,1,7,0,Stokes,2022-02-25
1,7,1,6,0,Stokes,2022-02-28
1,3,2,1,0,Stokes,2022-03-21
1,3,1,2,0,Stokes,2022-03-28
1,2,0,2,0,Stokes,2022-04-08
1,4,1,3,0,Stokes,2022-04-25
1,6,1,5,0,Stokes,2022-04-26
1,5,1,4,0,Stokes,2022-04-28
1,17,6,11,0,Stokes,2022-05-05
1,8,2,6,0,Stokes,2022-05-06
1,6,1,5,0,Stokes,2022-05-07
1,6,4,2,0,Stokes,2022-05-08
1,16,4,12,0,Stokes,2022-05-10
1,10,2,8,0,Stokes,2022-05-14
1,19,4,15,0,Stokes,2022-05-19
1,5,2,3,0,Stokes,2022-05-22
1,13,2,11,0,Stokes,2022-05-26
1,7,1,6,0,Stokes,2022-05-28
1,17,2,15,0,Stokes,2022-05-31
1,14,4,10,0,Stokes,2022-06-02
1,9,3,6,0,Stokes,2022-06-03
1,7,1,6,0,Stokes,2022-06-11
2,24,1,23,0,Stokes,2021-12-23
2,17,1,16,0,Stokes,2022-02-05
2,4,1,3,0,Stokes,2022-04-27
2,12,4,8,0,Stokes,2022-05-13
2,16,3,13,0,Stokes,2022-05-20
2,16,5,11,0,Stokes,2022-06-06
3,70,16,54,0,Stokes,2021-12-27
3,13,6,7,0,Stokes,2022-01-01
3,33,8,25,0,Stokes,2022-01-09
3,33,7,26,0,Stokes,2022-01-23
3,46,6,40,0,Stokes,2022-02-02
3,32,4,28,0,Stokes,2022-02-09
3,3,0,3,0,Stokes,2022-04-24
3,23,8,15,0,Stokes,2022-05-09
3,17,5,12,0,Stokes,2022-05-11
3,21,6,15,0,Stokes,2022-05-16
3,18,5,13,0,Stokes,2022-05-24
3,10,1,9,0,Stokes,2022-06-04
4,91,13,78,0,Stokes,2021-12-29
4,74,12,62,0,Stokes,2021-12-30
4,45,9,36,0,Stokes,2022-02-01
4,29,5,24,0,Stokes,2022-02-08
4,25,4,21,0,Stokes,2022-05-18
4,17,2,15,0,Stokes,2022-05-27
6,80,12,68,0,Stokes,2022-01-27
6,26,8,18,0,Stokes,2022-05-23
6,17,5,12,0,Stokes,2022-06-01
8,112,37,75,0,Stokes,2022-01-03
8,16,2,14,0,Stokes,2022-06-09
10,90,16,74,0,Stokes,2022-01-31
12,65,30,35,0,Stokes,2021-12-31
13,166,43,123,0,Stokes,2022-01-24
14,140,33,107,0,Stokes,2022-01-13
19,138,21,117,0,Stokes,2022-01-19
20,187,31,156,0,Stokes,2022-01-11
,0,0,0,0,Surry,2022-03-25
,0,0,0,0,Surry,2022-04-01
0,15,1,14,0,Surry,2022-02-13
0,20,5,15,0,Surry,2022-02-24
0,4,2,2,0,Surry,2022-02-27
0,16,6,10,0,Surry,2022-02-28
0,9,3,6,0,Surry,2022-03-01
0,6,2,4,0,Surry,2022-03-04
0,2,1,1,0,Surry,2022-03-06
0,6,3,3,0,Surry,2022-03-07
0,10,2,8,0,Surry,2022-03-09
0,4,2,2,0,Surry,2022-03-10
0,1,0,1,0,Surry,2022-03-15
0,2,0,2,0,Surry,2022-03-17
0,2,1,1,0,Surry,2022-03-18
0,1,1,0,0,Surry,2022-03-23
0,2,1,1,0,Surry,2022-03-27
0,1,0,1,0,Surry,2022-03-28
0,1,0,1,0,Surry,2022-03-29
0,1,0,1,0,Surry,2022-03-31
0,1,1,0,0,Surry,2022-04-02
0,1,0,1,0,Surry,2022-04-03
0,4,1,3,0,Surry,2022-04-04
0,3,1,2,0,Surry,2022-04-06
0,1,0,1,0,Surry,2022-04-08
0,4,1,3,0,Surry,2022-04-09
0,1,0,1,0,Surry,2022-04-10
0,4,0,4,0,Surry,2022-04-11
0,2,1,1,0,Surry,2022-04-12
0,4,0,4,0,Surry,2022-04-13
0,2,0,2,0,Surry,2022-04-14
0,1,1,0,0,Surry,2022-04-15
0,3,1,2,0,Surry,2022-04-16
0,5,0,5,0,Surry,2022-04-22
0,1,1,0,0,Surry,2022-04-24
0,12,4,8,0,Surry,2022-04-26
0,2,0,2,0,Surry,2022-04-29
0,2,0,2,0,Surry,2022-04-30
0,16,4,12,0,Surry,2022-05-03
0,7,3,4,0,Surry,2022-05-08
0,10,1,9,0,Surry,2022-05-21
0,17,4,13,0,Surry,2022-05-30
1,20,5,15,0,Surry,2021-12-18
1,47,23,24,0,Surry,2021-12-24
1,8,5,3,0,Surry,2021-12-25
1,30,12,18,0,Surry,2022-02-21
1,7,3,4,0,Surry,2022-02-26
1,3,1,2,0,Surry,2022-03-05
1,6,2,4,0,Surry,2022-03-12
1,2,1,1,0,Surry,2022-03-13
1,2,0,2,0,Surry,2022-03-16
1,4,0,4,0,Surry,2022-03-21
1,1,1,0,0,Surry,2022-03-26
1,1,0,1,0,Surry,2022-03-30
1,3,1,2,0,Surry,2022-04-17
1,7,1,6,0,Surry,2022-04-18
1,7,0,7,0,Surry,2022-04-19
1,11,3,8,0,Surry,2022-04-21
1,9,3,6,0,Surry,2022-04-27
1,7,5,2,0,Surry,2022-05-01
1,9,3,6,0,Surry,2022-05-04
1,9,3,6,0,Surry,2022-05-06
1,13,1,12,0,Surry,2022-05-13
1,4,0,4,0,Surry,2022-05-14
1,20,3,17,0,Surry,2022-05-26
1,11,3,8,0,Surry,2022-05-29
1,15,7,8,0,Surry,2022-06-05
1,16,7,9,0,Surry,2022-06-08
1,26,11,15,0,Surry,2022-06-09
2,13,4,9,0,Surry,2022-02-25
2,4,2,2,0,Surry,2022-04-20
2,9,4,5,0,Surry,2022-04-28
2,8,4,4,0,Surry,2022-05-07
2,18,5,13,0,Surry,2022-05-15
2,22,9,13,0,Surry,2022-05-20
2,17,4,13,0,Surry,2022-05-22
2,17,6,11,0,Surry,2022-05-25
2,18,3,15,0,Surry,2022-05-28
2,22,6,16,0,Surry,2022-06-03
3,61,21,40,0,Surry,2021-12-23
3,37,10,27,0,Surry,2022-02-16
3,20,10,10,0,Surry,2022-02-19
3,16,6,10,0,Surry,2022-05-02
3,17,4,13,0,Surry,2022-05-10
3,16,9,7,0,Surry,2022-05-11
3,18,10,8,0,Surry,2022-05-12
3,17,5,12,0,Surry,2022-05-16
3,30,11,19,0,Surry,2022-05-19
3,15,4,11,0,Surry,2022-05-27
3,25,10,15,0,Surry,2022-06-04
3,23,11,12,0,Surry,2022-06-06
3,17,5,12,0,Surry,2022-06-11
4,21,7,14,0,Surry,2022-02-23
4,15,4,11,0,Surry,2022-05-18
4,37,9,28,0,Surry,2022-06-01
4,13,5,8,0,Surry,2022-06-10
5,69,30,39,0,Surry,2021-12-31
5,58,27,31,0,Surry,2022-02-14
5,40,12,28,0,Surry,2022-05-31
5,23,10,13,0,Surry,2022-06-02
6,118,42,76,0,Surry,2021-12-27
6,126,42,84,0,Surry,2021-12-29
7,25,10,15,0,Surry,2022-05-09
8,64,29,35,0,Surry,2022-02-10
8,36,15,21,0,Surry,2022-05-23
8,37,9,28,0,Surry,2022-06-07
9,154,49,105,0,Surry,2022-01-04
9,62,20,42,0,Surry,2022-02-09
9,35,12,23,0,Surry,2022-05-17
10,80,27,53,0,Surry,2022-02-03
13,180,78,102,0,Surry,2022-01-03
13,149,51,98,0,Surry,2022-01-31
14,72,36,36,0,Surry,2022-02-07
15,126,45,81,0,Surry,2022-01-15
17,154,58,96,0,Surry,2022-01-07
20,233,86,147,0,Surry,2022-01-24
20,142,81,61,0,Surry,2022-02-02
25,292,105,187,0,Surry,2022-01-11
26,219,75,144,0,Surry,2022-01-20
,0,0,0,0,Swain,2022-03-09
,0,0,0,0,Swain,2022-03-14
,0,0,0,0,Swain,2022-03-16
,0,0,0,0,Swain,2022-03-18
,0,0,0,0,Swain,2022-03-19
,0,0,0,0,Swain,2022-03-20
,0,0,0,0,Swain,2022-03-21
,0,0,0,0,Swain,2022-03-25
,0,0,0,0,Swain,2022-03-26
,0,0,0,0,Swain,2022-03-28
,0,0,0,0,Swain,2022-04-01
,0,0,0,0,Swain,2022-04-03
,0,0,0,0,Swain,2022-04-04
,0,0,0,0,Swain,2022-04-05
,0,0,0,0,Swain,2022-04-08
,0,0,0,0,Swain,2022-04-10
,0,0,0,0,Swain,2022-04-11
,0,0,0,0,Swain,2022-04-13
,0,0,0,0,Swain,2022-04-16
,0,0,0,0,Swain,2022-04-17
,0,0,0,0,Swain,2022-06-10
0,12,4,8,0,Swain,2021-12-14
0,7,1,6,0,Swain,2021-12-15
0,4,3,1,0,Swain,2021-12-17
0,1,1,0,0,Swain,2021-12-18
0,4,2,2,0,Swain,2021-12-20
0,6,2,4,0,Swain,2021-12-22
0,5,5,0,0,Swain,2021-12-23
0,4,2,2,0,Swain,2021-12-24
0,5,4,1,0,Swain,2021-12-25
0,7,3,4,0,Swain,2021-12-26
0,8,5,3,0,Swain,2022-01-15
0,14,10,4,0,Swain,2022-01-17
0,14,13,1,0,Swain,2022-02-03
0,12,3,9,0,Swain,2022-02-04
0,4,3,1,0,Swain,2022-02-05
0,6,2,4,0,Swain,2022-02-10
0,3,3,0,0,Swain,2022-02-12
0,2,2,0,0,Swain,2022-02-13
0,9,8,1,0,Swain,2022-02-15
0,7,4,3,0,Swain,2022-02-19
0,3,3,0,0,Swain,2022-02-23
0,6,3,3,0,Swain,2022-02-25
0,1,1,0,0,Swain,2022-02-26
0,2,2,0,0,Swain,2022-02-27
0,4,3,1,0,Swain,2022-02-28
0,2,0,2,0,Swain,2022-03-01
0,3,0,3,0,Swain,2022-03-03
0,1,0,1,0,Swain,2022-03-04
0,2,0,2,0,Swain,2022-03-05
0,2,0,2,0,Swain,2022-03-06
0,3,3,0,0,Swain,2022-03-10
0,1,1,0,0,Swain,2022-03-11
0,1,1,0,0,Swain,2022-03-12
0,1,0,1,0,Swain,2022-03-13
0,1,1,0,0,Swain,2022-03-15
0,1,1,0,0,Swain,2022-03-17
0,1,0,1,0,Swain,2022-03-22
0,1,0,1,0,Swain,2022-03-23
0,2,1,1,0,Swain,2022-03-24
0,1,1,0,0,Swain,2022-03-27
0,3,1,2,0,Swain,2022-03-29
0,2,2,0,0,Swain,2022-03-30
0,1,1,0,0,Swain,2022-04-02
0,1,1,0,0,Swain,2022-04-06
0,2,0,2,0,Swain,2022-04-07
0,1,0,1,0,Swain,2022-04-15
0,2,2,0,0,Swain,2022-04-19
0,1,1,0,0,Swain,2022-04-20
0,1,0,1,0,Swain,2022-04-21
0,2,1,1,0,Swain,2022-04-25
0,2,1,1,0,Swain,2022-04-26
0,4,0,4,0,Swain,2022-04-27
0,1,0,1,0,Swain,2022-04-28
0,2,1,1,0,Swain,2022-04-29
0,2,2,0,0,Swain,2022-04-30
0,2,1,1,0,Swain,2022-05-01
0,3,3,0,0,Swain,2022-05-02
0,2,0,2,0,Swain,2022-05-03
0,4,3,1,0,Swain,2022-05-04
0,3,2,1,0,Swain,2022-05-05
0,4,4,0,0,Swain,2022-05-06
0,2,1,1,0,Swain,2022-05-08
0,3,1,2,0,Swain,2022-05-09
0,6,4,2,0,Swain,2022-05-10
0,5,2,3,0,Swain,2022-05-11
0,2,1,1,0,Swain,2022-05-12
0,1,1,0,0,Swain,2022-05-13
0,3,0,3,0,Swain,2022-05-14
0,3,1,2,0,Swain,2022-05-15
0,6,4,2,0,Swain,2022-05-18
0,10,2,8,0,Swain,2022-05-19
0,1,0,1,0,Swain,2022-05-21
0,4,0,4,0,Swain,2022-05-22
0,4,2,2,0,Swain,2022-05-23
0,5,1,4,0,Swain,2022-05-24
0,4,0,4,0,Swain,2022-05-25
0,2,0,2,0,Swain,2022-05-26
0,1,1,0,0,Swain,2022-05-30
0,2,2,0,0,Swain,2022-06-01
0,7,2,5,0,Swain,2022-06-02
0,10,3,7,0,Swain,2022-06-03
0,3,0,3,0,Swain,2022-06-05
0,10,3,7,0,Swain,2022-06-07
0,4,2,2,0,Swain,2022-06-08
0,1,0,1,0,Swain,2022-06-11
1,28,15,13,0,Swain,2021-12-28
1,32,29,3,0,Swain,2021-12-30
1,24,16,8,0,Swain,2021-12-31
1,20,12,8,0,Swain,2022-01-09
1,8,2,6,0,Swain,2022-01-16
1,15,8,7,0,Swain,2022-01-22
1,19,10,9,0,Swain,2022-01-23
1,11,8,3,0,Swain,2022-01-29
1,24,10,14,0,Swain,2022-02-02
1,16,7,9,0,Swain,2022-02-08
1,5,3,2,0,Swain,2022-02-16
1,17,15,2,0,Swain,2022-02-17
1,6,4,2,0,Swain,2022-02-18
1,5,5,0,0,Swain,2022-02-20
1,10,6,4,0,Swain,2022-02-21
1,12,5,7,0,Swain,2022-02-22
1,4,3,1,0,Swain,2022-03-02
1,1,1,0,0,Swain,2022-03-31
1,2,2,0,0,Swain,2022-04-09
1,3,1,2,0,Swain,2022-04-14
1,1,1,0,0,Swain,2022-04-18
1,4,2,2,0,Swain,2022-04-22
1,2,0,2,0,Swain,2022-05-07
1,3,2,1,0,Swain,2022-05-16
1,11,3,8,0,Swain,2022-05-27
1,2,1,1,0,Swain,2022-05-28
1,3,0,3,0,Swain,2022-05-29
1,10,0,10,0,Swain,2022-05-31
1,7,3,4,0,Swain,2022-06-04
1,7,0,7,0,Swain,2022-06-06
1,8,6,2,0,Swain,2022-06-09
2,22,13,9,0,Swain,2022-01-02
2,60,23,37,0,Swain,2022-01-04
2,43,15,28,0,Swain,2022-01-06
2,42,15,27,0,Swain,2022-01-07
2,54,25,29,0,Swain,2022-01-19
2,38,15,23,0,Swain,2022-01-25
2,34,21,13,0,Swain,2022-01-31
2,30,10,20,0,Swain,2022-02-01
2,12,5,7,0,Swain,2022-02-07
2,13,7,6,0,Swain,2022-02-11
2,7,2,5,0,Swain,2022-02-24
2,3,2,1,0,Swain,2022-04-24
3,24,14,10,0,Swain,2021-12-29
3,47,24,23,0,Swain,2022-01-10
3,30,16,14,0,Swain,2022-01-26
4,45,16,29,0,Swain,2022-01-03
4,43,9,34,0,Swain,2022-01-11
4,23,9,14,0,Swain,2022-01-12
4,44,23,21,0,Swain,2022-01-21
4,46,23,23,0,Swain,2022-01-24
5,40,27,13,0,Swain,2022-01-18
5,29,16,13,0,Swain,2022-01-27
7,64,36,28,0,Swain,2022-01-20
,0,0,0,0,Transylvania,2022-02-19
,0,0,0,0,Transylvania,2022-03-04
,0,0,0,0,Transylvania,2022-03-09
,0,0,0,0,Transylvania,2022-03-10
,0,0,0,0,Transylvania,2022-03-11
,0,0,0,0,Transylvania,2022-03-12
,0,0,0,0,Transylvania,2022-03-13
,0,0,0,0,Transylvania,2022-03-15
,0,0,0,0,Transylvania,2022-03-17
,0,0,0,0,Transylvania,2022-03-19
,0,0,0,0,Transylvania,2022-03-20
,0,0,0,0,Transylvania,2022-03-24
,0,0,0,0,Transylvania,2022-03-25
,0,0,0,0,Transylvania,2022-03-26
,0,0,0,0,Transylvania,2022-03-27
,0,0,0,0,Transylvania,2022-03-29
,0,0,0,0,Transylvania,2022-03-31
,0,0,0,0,Transylvania,2022-04-02
,0,0,0,0,Transylvania,2022-04-03
,0,0,0,0,Transylvania,2022-04-05
,0,0,0,0,Transylvania,2022-04-10
,0,0,0,0,Transylvania,2022-04-13
,0,0,0,0,Transylvania,2022-04-14
,0,0,0,0,Transylvania,2022-04-15
,0,0,0,0,Transylvania,2022-04-17
,0,0,0,0,Transylvania,2022-04-28
0,9,5,4,0,Transylvania,2021-12-18
0,29,19,10,0,Transylvania,2021-12-21
0,28,18,10,0,Transylvania,2021-12-23
0,5,2,3,0,Transylvania,2021-12-25
0,30,16,14,0,Transylvania,2021-12-31
0,14,9,5,0,Transylvania,2022-01-01
0,23,14,9,0,Transylvania,2022-01-08
0,22,14,8,0,Transylvania,2022-01-09
0,25,8,17,0,Transylvania,2022-01-15
0,12,5,7,0,Transylvania,2022-01-29
0,7,5,2,0,Transylvania,2022-02-12
0,5,5,0,0,Transylvania,2022-02-13
0,17,11,6,0,Transylvania,2022-02-14
0,11,5,6,0,Transylvania,2022-02-15
0,5,3,2,0,Transylvania,2022-02-18
0,3,2,1,0,Transylvania,2022-02-20
0,1,1,0,0,Transylvania,2022-02-21
0,5,3,2,0,Transylvania,2022-02-22
0,1,1,0,0,Transylvania,2022-02-25
0,1,1,0,0,Transylvania,2022-02-26
0,1,1,0,0,Transylvania,2022-02-28
0,3,1,2,0,Transylvania,2022-03-01
0,1,1,0,0,Transylvania,2022-03-05
0,1,1,0,0,Transylvania,2022-03-06
0,3,2,1,0,Transylvania,2022-03-07
0,2,2,0,0,Transylvania,2022-03-08
0,4,1,3,0,Transylvania,2022-03-14
0,1,1,0,0,Transylvania,2022-03-16
0,1,1,0,0,Transylvania,2022-03-18
0,1,1,0,0,Transylvania,2022-03-22
0,1,0,1,0,Transylvania,2022-03-23
0,1,0,1,0,Transylvania,2022-03-28
0,3,2,1,0,Transylvania,2022-03-30
0,1,0,1,0,Transylvania,2022-04-01
0,1,0,1,0,Transylvania,2022-04-04
0,5,2,3,0,Transylvania,2022-04-06
0,2,2,0,0,Transylvania,2022-04-07
0,2,1,1,0,Transylvania,2022-04-09
0,4,4,0,0,Transylvania,2022-04-11
0,2,0,2,0,Transylvania,2022-04-12
0,1,0,1,0,Transylvania,2022-04-16
0,5,2,3,0,Transylvania,2022-04-19
0,2,2,0,0,Transylvania,2022-04-21
0,1,0,1,0,Transylvania,2022-04-22
0,2,1,1,0,Transylvania,2022-04-23
0,2,1,1,0,Transylvania,2022-04-24
0,8,5,3,0,Transylvania,2022-04-26
0,3,1,2,0,Transylvania,2022-04-27
0,1,1,0,0,Transylvania,2022-04-29
0,2,1,1,0,Transylvania,2022-04-30
0,5,2,3,0,Transylvania,2022-05-01
0,3,2,1,0,Transylvania,2022-05-03
0,1,1,0,0,Transylvania,2022-05-04
0,4,1,3,0,Transylvania,2022-05-05
0,3,3,0,0,Transylvania,2022-05-07
0,3,0,3,0,Transylvania,2022-05-08
0,2,1,1,0,Transylvania,2022-05-09
0,7,3,4,0,Transylvania,2022-05-10
0,11,7,4,0,Transylvania,2022-05-12
0,6,3,3,0,Transylvania,2022-05-13
0,5,2,3,0,Transylvania,2022-05-14
0,3,2,1,0,Transylvania,2022-05-15
0,9,5,4,0,Transylvania,2022-05-16
0,9,6,3,0,Transylvania,2022-05-17
0,2,2,0,0,Transylvania,2022-05-18
0,6,3,3,0,Transylvania,2022-05-21
0,6,3,3,0,Transylvania,2022-05-22
0,10,1,9,0,Transylvania,2022-05-23
0,5,2,3,0,Transylvania,2022-05-24
0,6,2,4,0,Transylvania,2022-05-27
0,7,3,4,0,Transylvania,2022-06-01
0,3,2,1,0,Transylvania,2022-06-04
0,1,0,1,0,Transylvania,2022-06-05
0,4,3,1,0,Transylvania,2022-06-06
0,9,3,6,0,Transylvania,2022-06-08
0,7,2,5,0,Transylvania,2022-06-10
0,3,1,2,0,Transylvania,2022-06-11
1,12,6,6,0,Transylvania,2021-12-19
1,28,16,12,0,Transylvania,2021-12-20
1,11,7,4,0,Transylvania,2021-12-24
1,18,15,3,0,Transylvania,2021-12-26
1,33,12,21,0,Transylvania,2021-12-28
1,53,25,28,0,Transylvania,2022-01-03
1,7,6,1,0,Transylvania,2022-01-16
1,23,4,19,0,Transylvania,2022-01-25
1,24,6,18,0,Transylvania,2022-01-28
1,14,4,10,0,Transylvania,2022-01-30
1,28,17,11,0,Transylvania,2022-02-02
1,13,8,5,0,Transylvania,2022-02-03
1,14,5,9,0,Transylvania,2022-02-05
1,17,7,10,0,Transylvania,2022-02-06
1,14,5,9,0,Transylvania,2022-02-10
1,11,6,5,0,Transylvania,2022-02-11
1,2,1,1,0,Transylvania,2022-04-08
1,3,1,2,0,Transylvania,2022-04-18
1,3,1,2,0,Transylvania,2022-04-20
1,1,0,1,0,Transylvania,2022-04-25
1,4,3,1,0,Transylvania,2022-05-06
1,5,2,3,0,Transylvania,2022-05-11
1,12,2,10,0,Transylvania,2022-05-19
1,7,3,4,0,Transylvania,2022-05-20
1,6,1,5,0,Transylvania,2022-05-25
1,9,3,6,0,Transylvania,2022-05-28
1,8,4,4,0,Transylvania,2022-05-29
1,5,3,2,0,Transylvania,2022-05-30
1,11,7,4,0,Transylvania,2022-06-02
1,11,9,2,0,Transylvania,2022-06-03
1,10,3,7,0,Transylvania,2022-06-07
1,7,3,4,0,Transylvania,2022-06-09
2,24,13,11,0,Transylvania,2021-12-15
2,32,18,14,0,Transylvania,2021-12-22
2,51,22,29,0,Transylvania,2021-12-29
2,70,33,37,0,Transylvania,2022-01-14
2,48,18,30,0,Transylvania,2022-01-21
2,22,14,8,0,Transylvania,2022-01-23
2,43,15,28,0,Transylvania,2022-01-26
2,12,4,8,0,Transylvania,2022-02-16
2,6,0,6,0,Transylvania,2022-02-24
2,8,4,4,0,Transylvania,2022-05-26
2,9,1,8,0,Transylvania,2022-05-31
3,43,13,30,0,Transylvania,2021-12-14
3,35,15,20,0,Transylvania,2022-01-31
3,32,9,23,0,Transylvania,2022-02-01
4,31,12,19,0,Transylvania,2022-01-27
5,84,32,52,0,Transylvania,2022-01-20
6,83,32,51,0,Transylvania,2022-01-10
7,60,24,36,0,Transylvania,2022-01-04
7,69,34,35,0,Transylvania,2022-01-11
8,41,15,26,0,Transylvania,2022-01-24
,0,0,0,0,Tyrrell,2021-12-17
,0,0,0,0,Tyrrell,2021-12-18
,0,0,0,0,Tyrrell,2021-12-24
,0,0,0,0,Tyrrell,2021-12-25
,0,0,0,0,Tyrrell,2022-01-01
,0,0,0,0,Tyrrell,2022-01-02
,0,0,0,0,Tyrrell,2022-01-22
,0,0,0,0,Tyrrell,2022-02-05
,0,0,0,0,Tyrrell,2022-02-06
,0,0,0,0,Tyrrell,2022-02-13
,0,0,0,0,Tyrrell,2022-02-17
,0,0,0,0,Tyrrell,2022-02-19
,0,0,0,0,Tyrrell,2022-02-20
,0,0,0,0,Tyrrell,2022-02-21
,0,0,0,0,Tyrrell,2022-02-23
,0,0,0,0,Tyrrell,2022-02-24
,0,0,0,0,Tyrrell,2022-02-25
,0,0,0,0,Tyrrell,2022-02-26
,0,0,0,0,Tyrrell,2022-02-27
,0,0,0,0,Tyrrell,2022-02-28
,0,0,0,0,Tyrrell,2022-03-04
,0,0,0,0,Tyrrell,2022-03-05
,0,0,0,0,Tyrrell,2022-03-06
,0,0,0,0,Tyrrell,2022-03-07
,0,0,0,0,Tyrrell,2022-03-09
,0,0,0,0,Tyrrell,2022-03-10
,0,0,0,0,Tyrrell,2022-03-12
,0,0,0,0,Tyrrell,2022-03-13
,0,0,0,0,Tyrrell,2022-03-14
,0,0,0,0,Tyrrell,2022-03-15
,0,0,0,0,Tyrrell,2022-03-16
,0,0,0,0,Tyrrell,2022-03-17
,0,0,0,0,Tyrrell,2022-03-18
,0,0,0,0,Tyrrell,2022-03-19
,0,0,0,0,Tyrrell,2022-03-20
,0,0,0,0,Tyrrell,2022-03-21
,0,0,0,0,Tyrrell,2022-03-22
,0,0,0,0,Tyrrell,2022-03-23
,0,0,0,0,Tyrrell,2022-03-24
,0,0,0,0,Tyrrell,2022-03-25
,0,0,0,0,Tyrrell,2022-03-26
,0,0,0,0,Tyrrell,2022-03-27
,0,0,0,0,Tyrrell,2022-03-28
,0,0,0,0,Tyrrell,2022-03-29
,0,0,0,0,Tyrrell,2022-03-30
,0,0,0,0,Tyrrell,2022-03-31
,0,0,0,0,Tyrrell,2022-04-01
,0,0,0,0,Tyrrell,2022-04-02
,0,0,0,0,Tyrrell,2022-04-03
,0,0,0,0,Tyrrell,2022-04-04
,0,0,0,0,Tyrrell,2022-04-05
,0,0,0,0,Tyrrell,2022-04-06
,0,0,0,0,Tyrrell,2022-04-07
,0,0,0,0,Tyrrell,2022-04-08
,0,0,0,0,Tyrrell,2022-04-09
,0,0,0,0,Tyrrell,2022-04-10
,0,0,0,0,Tyrrell,2022-04-11
,0,0,0,0,Tyrrell,2022-04-13
,0,0,0,0,Tyrrell,2022-04-14
,0,0,0,0,Tyrrell,2022-04-15
,0,0,0,0,Tyrrell,2022-04-16
,0,0,0,0,Tyrrell,2022-04-17
,0,0,0,0,Tyrrell,2022-04-18
,0,0,0,0,Tyrrell,2022-04-19
,0,0,0,0,Tyrrell,2022-04-20
,0,0,0,0,Tyrrell,2022-04-21
,0,0,0,0,Tyrrell,2022-04-22
,0,0,0,0,Tyrrell,2022-04-23
,0,0,0,0,Tyrrell,2022-04-24
,0,0,0,0,Tyrrell,2022-04-26
,0,0,0,0,Tyrrell,2022-04-28
,0,0,0,0,Tyrrell,2022-05-01
,0,0,0,0,Tyrrell,2022-05-02
,0,0,0,0,Tyrrell,2022-05-03
,0,0,0,0,Tyrrell,2022-05-04
,0,0,0,0,Tyrrell,2022-05-05
,0,0,0,0,Tyrrell,2022-05-06
,0,0,0,0,Tyrrell,2022-05-07
,0,0,0,0,Tyrrell,2022-05-08
,0,0,0,0,Tyrrell,2022-05-13
,0,0,0,0,Tyrrell,2022-05-16
,0,0,0,0,Tyrrell,2022-05-18
,0,0,0,0,Tyrrell,2022-05-21
,0,0,0,0,Tyrrell,2022-05-22
,0,0,0,0,Tyrrell,2022-05-24
,0,0,0,0,Tyrrell,2022-05-25
,0,0,0,0,Tyrrell,2022-05-28
,0,0,0,0,Tyrrell,2022-05-29
,0,0,0,0,Tyrrell,2022-06-02
,0,0,0,0,Tyrrell,2022-06-04
,0,0,0,0,Tyrrell,2022-06-05
,0,0,0,0,Tyrrell,2022-06-06
,0,0,0,0,Tyrrell,2022-06-09
0,1,0,1,0,Tyrrell,2021-12-14
0,1,0,1,0,Tyrrell,2021-12-15
0,1,0,1,0,Tyrrell,2021-12-16
0,1,1,0,0,Tyrrell,2021-12-19
0,2,0,2,0,Tyrrell,2021-12-20
0,2,0,2,0,Tyrrell,2021-12-21
0,1,0,1,0,Tyrrell,2021-12-23
0,1,0,1,0,Tyrrell,2021-12-26
0,2,0,2,0,Tyrrell,2021-12-27
0,5,1,4,0,Tyrrell,2021-12-28
0,4,0,4,0,Tyrrell,2021-12-29
0,7,0,7,0,Tyrrell,2021-12-30
0,2,0,2,0,Tyrrell,2021-12-31
0,8,4,4,0,Tyrrell,2022-01-03
0,11,4,7,0,Tyrrell,2022-01-04
0,8,2,6,0,Tyrrell,2022-01-06
0,9,0,9,0,Tyrrell,2022-01-08
0,1,0,1,0,Tyrrell,2022-01-09
0,1,0,1,0,Tyrrell,2022-01-15
0,4,0,4,0,Tyrrell,2022-01-16
0,28,4,24,0,Tyrrell,2022-01-18
0,1,0,1,0,Tyrrell,2022-01-21
0,13,3,10,0,Tyrrell,2022-01-24
0,12,1,11,0,Tyrrell,2022-01-25
0,8,2,6,0,Tyrrell,2022-01-26
0,3,1,2,0,Tyrrell,2022-01-27
0,5,1,4,0,Tyrrell,2022-01-28
0,3,0,3,0,Tyrrell,2022-01-29
0,3,0,3,0,Tyrrell,2022-01-31
0,6,0,6,0,Tyrrell,2022-02-01
0,5,4,1,0,Tyrrell,2022-02-03
0,3,0,3,0,Tyrrell,2022-02-04
0,4,1,3,0,Tyrrell,2022-02-07
0,8,0,8,0,Tyrrell,2022-02-11
0,4,0,4,0,Tyrrell,2022-02-12
0,3,1,2,0,Tyrrell,2022-02-14
0,2,1,1,0,Tyrrell,2022-02-15
0,2,0,2,0,Tyrrell,2022-02-18
0,1,0,1,0,Tyrrell,2022-02-22
0,3,0,3,0,Tyrrell,2022-03-01
0,2,0,2,0,Tyrrell,2022-03-02
0,1,0,1,0,Tyrrell,2022-03-11
0,2,0,2,0,Tyrrell,2022-04-12
0,1,1,0,0,Tyrrell,2022-04-27
0,1,0,1,0,Tyrrell,2022-04-29
0,1,0,1,0,Tyrrell,2022-04-30
0,2,1,1,0,Tyrrell,2022-05-09
0,1,0,1,0,Tyrrell,2022-05-10
0,1,1,0,0,Tyrrell,2022-05-11
0,4,2,2,0,Tyrrell,2022-05-12
0,1,0,1,0,Tyrrell,2022-05-14
0,1,1,0,0,Tyrrell,2022-05-15
0,2,0,2,0,Tyrrell,2022-05-20
0,1,0,1,0,Tyrrell,2022-05-23
0,2,0,2,0,Tyrrell,2022-05-27
0,1,0,1,0,Tyrrell,2022-05-30
0,1,0,1,0,Tyrrell,2022-06-03
0,1,0,1,0,Tyrrell,2022-06-07
0,2,0,2,0,Tyrrell,2022-06-08
0,3,2,1,0,Tyrrell,2022-06-10
1,2,1,1,0,Tyrrell,2021-12-22
1,4,0,4,0,Tyrrell,2022-01-05
1,11,4,7,0,Tyrrell,2022-01-10
1,24,8,16,0,Tyrrell,2022-01-12
1,9,0,9,0,Tyrrell,2022-01-17
1,23,3,20,0,Tyrrell,2022-01-19
1,2,0,2,0,Tyrrell,2022-01-23
1,1,0,1,0,Tyrrell,2022-01-30
1,5,3,2,0,Tyrrell,2022-02-02
1,4,0,4,0,Tyrrell,2022-02-08
1,2,1,1,0,Tyrrell,2022-02-10
1,2,0,2,0,Tyrrell,2022-02-16
1,1,1,0,0,Tyrrell,2022-03-08
1,1,0,1,0,Tyrrell,2022-04-25
1,2,1,1,0,Tyrrell,2022-05-17
1,4,3,1,0,Tyrrell,2022-05-19
1,1,1,0,0,Tyrrell,2022-05-26
1,4,0,4,0,Tyrrell,2022-05-31
1,1,0,1,0,Tyrrell,2022-06-01
1,1,0,1,0,Tyrrell,2022-06-11
2,30,6,24,0,Tyrrell,2022-01-11
2,14,1,13,0,Tyrrell,2022-01-20
3,23,7,16,0,Tyrrell,2022-01-13
3,16,0,16,0,Tyrrell,2022-01-14
,0,0,0,0,Union,2022-03-20
0,31,13,18,0,Union,2022-02-20
0,27,8,19,0,Union,2022-02-28
0,18,3,15,0,Union,2022-03-01
0,15,2,13,0,Union,2022-03-04
0,6,3,3,0,Union,2022-03-06
0,6,0,6,0,Union,2022-03-10
0,7,1,6,0,Union,2022-03-11
0,8,0,8,0,Union,2022-03-14
0,8,0,8,0,Union,2022-03-16
0,2,0,2,0,Union,2022-03-18
0,9,0,9,0,Union,2022-03-22
0,12,2,10,0,Union,2022-03-23
0,8,1,7,0,Union,2022-03-24
0,9,1,8,0,Union,2022-03-25
0,4,1,3,0,Union,2022-03-26
0,11,3,8,0,Union,2022-03-27
0,7,3,4,0,Union,2022-03-29
0,4,1,3,0,Union,2022-04-01
0,10,1,9,0,Union,2022-04-05
0,15,2,13,0,Union,2022-04-06
0,3,1,2,0,Union,2022-04-09
0,8,1,7,0,Union,2022-04-10
0,52,18,34,0,Union,2022-04-25
1,34,1,33,0,Union,2021-12-25
1,14,6,8,0,Union,2022-03-03
1,7,0,7,0,Union,2022-03-09
1,9,3,6,0,Union,2022-03-12
1,5,1,4,0,Union,2022-03-15
1,8,1,7,0,Union,2022-03-17
1,3,1,2,0,Union,2022-03-19
1,9,2,7,0,Union,2022-04-02
1,6,2,4,0,Union,2022-04-03
1,14,1,13,0,Union,2022-04-04
1,13,2,11,0,Union,2022-04-08
1,23,4,19,0,Union,2022-04-12
1,13,1,12,0,Union,2022-04-16
1,48,6,42,0,Union,2022-04-26
1,38,5,33,0,Union,2022-05-07
2,38,15,23,0,Union,2022-02-23
2,8,2,6,0,Union,2022-03-30
2,18,4,14,0,Union,2022-04-11
2,30,6,24,0,Union,2022-04-18
2,20,8,12,0,Union,2022-04-23
2,52,5,47,0,Union,2022-04-28
2,40,6,34,0,Union,2022-05-08
2,53,7,46,0,Union,2022-05-14
3,83,19,64,0,Union,2021-12-18
3,41,8,33,0,Union,2022-02-13
3,18,5,13,0,Union,2022-02-25
3,27,3,24,0,Union,2022-04-22
3,48,9,39,0,Union,2022-04-29
3,33,8,25,0,Union,2022-04-30
3,63,12,51,0,Union,2022-05-11
4,103,5,98,0,Union,2021-12-17
4,68,20,48,0,Union,2022-02-16
4,30,10,20,0,Union,2022-04-14
4,51,8,43,0,Union,2022-05-28
5,30,4,26,0,Union,2022-04-13
5,35,10,25,0,Union,2022-04-19
5,38,8,30,0,Union,2022-04-24
5,50,5,45,0,Union,2022-05-02
5,53,4,49,0,Union,2022-05-15
5,34,6,28,0,Union,2022-06-11
6,38,7,31,0,Union,2022-04-20
6,58,8,50,0,Union,2022-04-27
6,36,0,36,0,Union,2022-05-01
6,39,3,36,0,Union,2022-05-30
6,67,13,54,0,Union,2022-06-03
6,48,5,43,0,Union,2022-06-04
6,73,10,63,0,Union,2022-06-07
7,150,27,123,0,Union,2021-12-20
7,87,17,70,0,Union,2022-01-16
7,87,22,65,0,Union,2022-02-10
7,39,9,30,0,Union,2022-04-21
7,61,13,48,0,Union,2022-05-06
7,62,8,54,0,Union,2022-05-29
7,66,6,60,0,Union,2022-06-10
8,71,8,63,0,Union,2022-05-12
8,86,13,73,0,Union,2022-05-20
8,67,15,52,0,Union,2022-05-21
8,79,12,67,0,Union,2022-05-27
9,85,12,73,0,Union,2022-05-09
9,85,10,75,0,Union,2022-05-13
9,102,12,90,0,Union,2022-05-16
9,56,10,46,0,Union,2022-05-22
9,108,12,96,0,Union,2022-05-31
9,58,9,49,0,Union,2022-06-05
10,204,31,173,0,Union,2021-12-23
10,98,17,81,0,Union,2022-05-10
10,95,17,78,0,Union,2022-05-25
11,86,9,77,0,Union,2022-06-02
11,101,16,85,0,Union,2022-06-06
12,120,19,101,0,Union,2022-05-23
12,83,10,73,0,Union,2022-05-26
12,85,15,70,0,Union,2022-06-09
13,85,13,72,0,Union,2022-05-24
15,205,47,158,0,Union,2022-01-01
15,131,29,102,0,Union,2022-01-30
16,234,53,181,0,Union,2022-01-02
16,127,22,105,0,Union,2022-05-18
25,314,104,210,0,Union,2021-12-31
29,311,83,228,0,Union,2022-01-31
36,435,84,351,0,Union,2021-12-29
40,380,86,294,0,Union,2022-01-09
69,764,133,631,0,Union,2022-01-14
77,892,167,725,0,Union,2022-01-13
79,824,193,631,0,Union,2022-01-19
,0,0,0,0,Vance,2022-02-26
,0,0,0,0,Vance,2022-03-06
,0,0,0,0,Vance,2022-03-12
,0,0,0,0,Vance,2022-03-16
,0,0,0,0,Vance,2022-03-17
,0,0,0,0,Vance,2022-03-19
,0,0,0,0,Vance,2022-03-27
,0,0,0,0,Vance,2022-03-29
,0,0,0,0,Vance,2022-03-30
,0,0,0,0,Vance,2022-04-15
,0,0,0,0,Vance,2022-04-17
0,32,10,22,0,Vance,2021-12-14
0,10,3,7,0,Vance,2022-01-16
0,22,3,19,0,Vance,2022-01-22
0,9,1,8,0,Vance,2022-02-06
0,20,5,15,0,Vance,2022-02-11
0,2,0,2,0,Vance,2022-02-20
0,6,1,5,0,Vance,2022-02-22
0,6,0,6,0,Vance,2022-02-23
0,4,1,3,0,Vance,2022-02-24
0,4,0,4,0,Vance,2022-02-27
0,3,3,0,0,Vance,2022-02-28
0,4,1,3,0,Vance,2022-03-01
0,2,0,2,0,Vance,2022-03-04
0,7,4,3,0,Vance,2022-03-08
0,4,0,4,0,Vance,2022-03-09
0,1,0,1,0,Vance,2022-03-10
0,3,1,2,0,Vance,2022-03-11
0,1,1,0,0,Vance,2022-03-13
0,1,1,0,0,Vance,2022-03-15
0,2,0,2,0,Vance,2022-03-20
0,1,1,0,0,Vance,2022-03-21
0,2,1,1,0,Vance,2022-03-22
0,2,0,2,0,Vance,2022-03-23
0,3,1,2,0,Vance,2022-03-24
0,2,0,2,0,Vance,2022-03-25
0,2,1,1,0,Vance,2022-03-26
0,1,0,1,0,Vance,2022-03-28
0,2,1,1,0,Vance,2022-03-31
0,1,0,1,0,Vance,2022-04-02
0,1,1,0,0,Vance,2022-04-03
0,1,1,0,0,Vance,2022-04-04
0,2,0,2,0,Vance,2022-04-07
0,5,2,3,0,Vance,2022-04-08
0,3,0,3,0,Vance,2022-04-09
0,2,1,1,0,Vance,2022-04-10
0,2,1,1,0,Vance,2022-04-13
0,2,1,1,0,Vance,2022-04-16
0,1,0,1,0,Vance,2022-04-18
0,2,1,1,0,Vance,2022-04-20
0,1,0,1,0,Vance,2022-04-21
0,5,2,3,0,Vance,2022-04-22
0,2,0,2,0,Vance,2022-04-23
0,2,1,1,0,Vance,2022-04-24
0,4,0,4,0,Vance,2022-04-26
0,2,1,1,0,Vance,2022-04-27
0,5,3,2,0,Vance,2022-04-29
0,3,2,1,0,Vance,2022-04-30
0,5,0,5,0,Vance,2022-05-02
0,9,1,8,0,Vance,2022-05-04
0,8,3,5,0,Vance,2022-05-05
0,7,1,6,0,Vance,2022-05-06
0,7,4,3,0,Vance,2022-05-07
0,4,1,3,0,Vance,2022-05-08
0,8,3,5,0,Vance,2022-05-11
0,9,3,6,0,Vance,2022-05-14
0,20,5,15,0,Vance,2022-05-19
0,8,5,3,0,Vance,2022-05-22
0,11,2,9,0,Vance,2022-05-26
0,12,3,9,0,Vance,2022-05-28
0,7,6,1,0,Vance,2022-05-30
0,7,4,3,0,Vance,2022-06-10
1,28,2,26,0,Vance,2021-12-15
1,11,0,11,0,Vance,2021-12-18
1,22,9,13,0,Vance,2021-12-25
1,18,1,17,0,Vance,2022-01-29
1,34,8,26,0,Vance,2022-02-02
1,18,1,17,0,Vance,2022-02-10
1,7,1,6,0,Vance,2022-02-12
1,4,2,2,0,Vance,2022-02-13
1,13,3,10,0,Vance,2022-02-17
1,9,1,8,0,Vance,2022-02-18
1,10,5,5,0,Vance,2022-02-21
1,5,0,5,0,Vance,2022-02-25
1,6,1,5,0,Vance,2022-03-03
1,3,2,1,0,Vance,2022-03-05
1,4,0,4,0,Vance,2022-03-18
1,2,0,2,0,Vance,2022-04-01
1,5,0,5,0,Vance,2022-04-06
1,5,2,3,0,Vance,2022-04-14
1,3,2,1,0,Vance,2022-04-19
1,8,3,5,0,Vance,2022-04-25
1,4,1,3,0,Vance,2022-04-28
1,4,1,3,0,Vance,2022-05-01
1,8,2,6,0,Vance,2022-05-03
1,17,4,13,0,Vance,2022-05-09
1,9,2,7,0,Vance,2022-05-13
1,12,3,9,0,Vance,2022-05-21
1,14,4,10,0,Vance,2022-05-24
1,16,6,10,0,Vance,2022-05-25
1,10,5,5,0,Vance,2022-05-27
1,14,3,11,0,Vance,2022-06-02
1,13,2,11,0,Vance,2022-06-04
2,35,2,33,0,Vance,2021-12-20
2,28,18,10,0,Vance,2022-01-01
2,10,0,10,0,Vance,2022-02-05
2,15,4,11,0,Vance,2022-05-12
2,3,0,3,0,Vance,2022-05-15
2,5,0,5,0,Vance,2022-05-29
2,23,7,16,0,Vance,2022-05-31
2,8,1,7,0,Vance,2022-06-11
3,22,5,17,0,Vance,2021-12-24
3,52,10,42,0,Vance,2022-01-02
3,45,18,27,0,Vance,2022-01-09
3,48,3,45,0,Vance,2022-01-28
3,41,11,30,0,Vance,2022-02-08
3,23,4,19,0,Vance,2022-02-09
3,22,1,21,0,Vance,2022-02-14
3,12,1,11,0,Vance,2022-02-16
3,18,3,15,0,Vance,2022-05-10
3,16,5,11,0,Vance,2022-05-16
3,22,7,15,0,Vance,2022-05-18
3,23,7,16,0,Vance,2022-06-01
3,30,9,21,0,Vance,2022-06-06
4,35,5,30,0,Vance,2021-12-23
4,28,15,13,0,Vance,2022-05-23
4,16,5,11,0,Vance,2022-06-03
4,32,6,26,0,Vance,2022-06-07
4,20,1,19,0,Vance,2022-06-08
5,40,18,22,0,Vance,2021-12-22
5,61,4,57,0,Vance,2022-02-01
5,22,8,14,0,Vance,2022-05-20
6,63,15,48,0,Vance,2022-01-08
6,59,5,54,0,Vance,2022-01-21
7,160,14,146,0,Vance,2022-01-12
7,74,10,64,0,Vance,2022-01-15
7,35,12,23,0,Vance,2022-02-07
7,23,4,19,0,Vance,2022-06-09
8,91,35,56,0,Vance,2021-12-31
9,95,16,79,0,Vance,2022-01-07
10,118,26,92,0,Vance,2021-12-27
10,146,36,110,0,Vance,2021-12-28
10,184,38,146,0,Vance,2022-01-10
12,130,14,116,0,Vance,2022-01-11
14,114,21,93,0,Vance,2022-01-14
14,117,11,106,0,Vance,2022-01-17
14,172,27,145,0,Vance,2022-01-18
14,138,7,131,0,Vance,2022-01-24
15,91,5,86,0,Vance,2022-01-26
16,158,15,143,0,Vance,2022-01-19
18,180,46,134,0,Vance,2021-12-29
20,231,68,163,0,Vance,2021-12-30
1,60,4,56,0,Wake,2022-03-26
2,76,15,61,0,Wake,2022-02-27
2,73,16,57,0,Wake,2022-03-22
2,40,2,38,0,Wake,2022-04-03
3,107,6,101,0,Wake,2022-04-01
3,83,13,70,0,Wake,2022-04-10
4,88,9,79,0,Wake,2022-03-17
4,120,13,107,0,Wake,2022-03-23
5,101,14,87,0,Wake,2022-03-28
6,139,25,114,0,Wake,2022-02-20
6,204,21,183,0,Wake,2022-02-28
7,154,14,140,0,Wake,2022-03-01
8,102,6,96,0,Wake,2022-03-29
10,96,8,88,0,Wake,2022-03-14
11,248,24,224,0,Wake,2022-04-11
11,182,31,151,0,Wake,2022-04-16
11,106,17,89,0,Wake,2022-04-17
12,220,19,201,0,Wake,2021-12-25
12,146,20,126,0,Wake,2022-04-07
12,228,23,205,0,Wake,2022-04-12
14,344,57,287,0,Wake,2022-02-06
14,176,15,161,0,Wake,2022-04-06
15,182,14,168,0,Wake,2022-04-08
16,462,32,430,0,Wake,2021-12-18
16,241,23,218,0,Wake,2022-04-23
18,319,38,281,0,Wake,2022-04-30
20,315,34,281,0,Wake,2022-04-21
23,372,53,319,0,Wake,2022-05-29
24,305,37,268,0,Wake,2022-04-13
24,314,40,274,0,Wake,2022-04-19
24,444,64,380,0,Wake,2022-04-26
25,456,42,414,0,Wake,2022-02-16
26,483,38,445,0,Wake,2022-04-27
26,257,60,197,0,Wake,2022-05-30
27,439,41,398,0,Wake,2022-04-18
28,403,46,357,0,Wake,2022-04-29
28,288,34,254,0,Wake,2022-06-11
29,360,51,309,0,Wake,2022-04-20
30,477,67,410,0,Wake,2022-04-25
31,624,81,543,0,Wake,2022-05-04
33,625,67,558,0,Wake,2022-05-03
37,515,44,471,0,Wake,2022-05-06
39,465,59,406,0,Wake,2022-06-04
40,627,53,574,0,Wake,2022-05-21
41,476,53,423,0,Wake,2022-06-10
45,589,60,529,0,Wake,2022-06-08
45,447,56,391,0,Wake,2022-06-09
56,876,108,768,0,Wake,2022-05-26
57,853,91,762,0,Wake,2022-05-13
58,859,99,760,0,Wake,2022-05-12
59,845,108,737,0,Wake,2022-05-10
64,717,94,623,0,Wake,2022-05-27
64,670,57,613,0,Wake,2022-06-07
65,755,65,690,0,Wake,2022-06-06
67,821,75,746,0,Wake,2022-05-20
67,689,70,619,0,Wake,2022-06-03
69,771,69,702,0,Wake,2022-06-02
76,1221,121,1100,0,Wake,2021-12-22
80,889,79,810,0,Wake,2022-05-25
82,1117,127,990,0,Wake,2022-05-18
82,1054,92,962,0,Wake,2022-05-23
86,1029,118,911,0,Wake,2022-05-24
86,1208,112,1096,0,Wake,2022-05-31
87,891,89,802,0,Wake,2022-06-01
114,2118,143,1975,0,Wake,2022-01-31
136,2622,150,2472,0,Wake,2021-12-31
256,3899,234,3665,0,Wake,2021-12-30
288,3998,242,3756,0,Wake,2021-12-29
,0,0,0,0,Warren,2022-02-26
,0,0,0,0,Warren,2022-03-03
,0,0,0,0,Warren,2022-03-06
,0,0,0,0,Warren,2022-03-10
,0,0,0,0,Warren,2022-03-11
,0,0,0,0,Warren,2022-03-12
,0,0,0,0,Warren,2022-03-13
,0,0,0,0,Warren,2022-03-15
,0,0,0,0,Warren,2022-03-17
,0,0,0,0,Warren,2022-03-18
,0,0,0,0,Warren,2022-03-19
,0,0,0,0,Warren,2022-03-20
,0,0,0,0,Warren,2022-03-21
,0,0,0,0,Warren,2022-03-24
,0,0,0,0,Warren,2022-03-26
,0,0,0,0,Warren,2022-03-27
,0,0,0,0,Warren,2022-03-28
,0,0,0,0,Warren,2022-03-29
,0,0,0,0,Warren,2022-03-30
,0,0,0,0,Warren,2022-03-31
,0,0,0,0,Warren,2022-04-01
,0,0,0,0,Warren,2022-04-02
,0,0,0,0,Warren,2022-04-03
,0,0,0,0,Warren,2022-04-07
,0,0,0,0,Warren,2022-04-09
,0,0,0,0,Warren,2022-04-10
,0,0,0,0,Warren,2022-04-15
,0,0,0,0,Warren,2022-04-17
,0,0,0,0,Warren,2022-04-20
,0,0,0,0,Warren,2022-04-24
,0,0,0,0,Warren,2022-04-29
,0,0,0,0,Warren,2022-05-20
0,9,2,7,0,Warren,2021-12-14
0,10,2,8,0,Warren,2021-12-15
0,10,3,7,0,Warren,2021-12-18
0,4,0,4,0,Warren,2021-12-19
0,9,1,8,0,Warren,2021-12-20
0,5,3,2,0,Warren,2021-12-24
0,5,1,4,0,Warren,2021-12-25
0,6,1,5,0,Warren,2021-12-26
0,4,1,3,0,Warren,2022-01-16
0,25,5,20,0,Warren,2022-01-31
0,23,2,21,0,Warren,2022-02-01
0,6,0,6,0,Warren,2022-02-08
0,6,1,5,0,Warren,2022-02-09
0,7,3,4,0,Warren,2022-02-10
0,12,1,11,0,Warren,2022-02-14
0,6,3,3,0,Warren,2022-02-15
0,4,0,4,0,Warren,2022-02-16
0,1,0,1,0,Warren,2022-02-18
0,1,0,1,0,Warren,2022-02-19
0,4,1,3,0,Warren,2022-02-21
0,3,1,2,0,Warren,2022-02-22
0,2,0,2,0,Warren,2022-02-23
0,4,1,3,0,Warren,2022-02-24
0,1,0,1,0,Warren,2022-02-25
0,1,0,1,0,Warren,2022-02-27
0,2,0,2,0,Warren,2022-03-02
0,1,0,1,0,Warren,2022-03-04
0,2,1,1,0,Warren,2022-03-08
0,1,1,0,0,Warren,2022-03-09
0,1,0,1,0,Warren,2022-03-16
0,1,0,1,0,Warren,2022-03-22
0,1,1,0,0,Warren,2022-03-23
0,3,0,3,0,Warren,2022-03-25
0,2,0,2,0,Warren,2022-04-04
0,3,0,3,0,Warren,2022-04-05
0,2,0,2,0,Warren,2022-04-06
0,2,0,2,0,Warren,2022-04-11
0,1,1,0,0,Warren,2022-04-13
0,2,0,2,0,Warren,2022-04-14
0,1,0,1,0,Warren,2022-04-16
0,1,0,1,0,Warren,2022-04-18
0,3,2,1,0,Warren,2022-04-21
0,2,0,2,0,Warren,2022-04-23
0,5,0,5,0,Warren,2022-04-25
0,3,0,3,0,Warren,2022-04-26
0,3,0,3,0,Warren,2022-04-27
0,1,0,1,0,Warren,2022-04-28
0,2,0,2,0,Warren,2022-04-30
0,1,0,1,0,Warren,2022-05-01
0,5,3,2,0,Warren,2022-05-03
0,5,1,4,0,Warren,2022-05-04
0,3,1,2,0,Warren,2022-05-07
0,2,1,1,0,Warren,2022-05-11
0,2,0,2,0,Warren,2022-05-14
0,1,0,1,0,Warren,2022-05-15
0,13,4,9,0,Warren,2022-05-16
0,7,4,3,0,Warren,2022-05-19
0,2,0,2,0,Warren,2022-05-24
0,7,2,5,0,Warren,2022-05-25
0,10,2,8,0,Warren,2022-05-28
0,4,3,1,0,Warren,2022-05-30
0,12,3,9,0,Warren,2022-06-02
0,4,1,3,0,Warren,2022-06-05
0,6,2,4,0,Warren,2022-06-06
0,4,1,3,0,Warren,2022-06-09
0,3,0,3,0,Warren,2022-06-10
0,3,0,3,0,Warren,2022-06-11
1,10,1,9,0,Warren,2021-12-22
1,14,7,7,0,Warren,2021-12-23
1,32,16,16,0,Warren,2021-12-31
1,4,2,2,0,Warren,2022-01-01
1,10,3,7,0,Warren,2022-01-21
1,16,2,14,0,Warren,2022-02-02
1,14,3,11,0,Warren,2022-02-03
1,12,3,9,0,Warren,2022-02-04
1,4,1,3,0,Warren,2022-02-05
1,6,0,6,0,Warren,2022-02-06
1,11,3,8,0,Warren,2022-02-07
1,6,0,6,0,Warren,2022-02-11
1,2,1,1,0,Warren,2022-02-20
1,1,0,1,0,Warren,2022-02-28
1,1,0,1,0,Warren,2022-03-01
1,1,1,0,0,Warren,2022-03-05
1,2,0,2,0,Warren,2022-04-19
1,4,3,1,0,Warren,2022-04-22
1,6,1,5,0,Warren,2022-05-05
1,9,1,8,0,Warren,2022-05-06
1,2,0,2,0,Warren,2022-05-08
1,9,1,8,0,Warren,2022-05-09
1,4,0,4,0,Warren,2022-05-10
1,7,2,5,0,Warren,2022-05-17
1,7,2,5,0,Warren,2022-05-18
1,5,2,3,0,Warren,2022-05-21
1,3,0,3,0,Warren,2022-05-22
1,11,0,11,0,Warren,2022-05-23
1,5,1,4,0,Warren,2022-05-27
1,1,0,1,0,Warren,2022-05-29
1,7,1,6,0,Warren,2022-05-31
1,7,3,4,0,Warren,2022-06-03
1,3,1,2,0,Warren,2022-06-04
2,24,11,13,0,Warren,2022-01-02
2,72,14,58,0,Warren,2022-01-03
2,16,4,12,0,Warren,2022-01-15
2,59,8,51,0,Warren,2022-01-19
2,11,2,9,0,Warren,2022-01-25
2,10,0,10,0,Warren,2022-01-29
2,17,5,12,0,Warren,2022-01-30
2,5,0,5,0,Warren,2022-02-17
2,2,0,2,0,Warren,2022-03-14
2,7,0,7,0,Warren,2022-05-12
2,6,3,3,0,Warren,2022-05-13
2,15,2,13,0,Warren,2022-05-26
2,6,1,5,0,Warren,2022-06-07
3,59,13,46,0,Warren,2021-12-29
3,67,5,62,0,Warren,2022-01-11
3,38,8,30,0,Warren,2022-01-13
3,50,4,46,0,Warren,2022-01-14
3,7,2,5,0,Warren,2022-01-22
3,19,2,17,0,Warren,2022-01-26
3,15,1,14,0,Warren,2022-06-01
4,56,5,51,0,Warren,2021-12-28
4,24,7,17,0,Warren,2022-01-17
4,47,15,32,0,Warren,2022-01-20
4,66,7,59,0,Warren,2022-01-24
5,25,5,20,0,Warren,2021-12-27
5,67,11,56,0,Warren,2022-01-05
5,77,14,63,0,Warren,2022-01-06
5,81,7,74,0,Warren,2022-01-12
5,15,1,14,0,Warren,2022-06-08
6,97,19,78,0,Warren,2022-01-04
6,72,12,60,0,Warren,2022-01-18
9,78,23,55,0,Warren,2021-12-30
,0,0,0,0,Washington,2021-12-15
,0,0,0,0,Washington,2021-12-16
,0,0,0,0,Washington,2021-12-18
,0,0,0,0,Washington,2021-12-19
,0,0,0,0,Washington,2021-12-24
,0,0,0,0,Washington,2022-02-23
,0,0,0,0,Washington,2022-02-26
,0,0,0,0,Washington,2022-03-03
,0,0,0,0,Washington,2022-03-05
,0,0,0,0,Washington,2022-03-10
,0,0,0,0,Washington,2022-03-11
,0,0,0,0,Washington,2022-03-12
,0,0,0,0,Washington,2022-03-13
,0,0,0,0,Washington,2022-03-16
,0,0,0,0,Washington,2022-03-17
,0,0,0,0,Washington,2022-03-18
,0,0,0,0,Washington,2022-03-19
,0,0,0,0,Washington,2022-03-20
,0,0,0,0,Washington,2022-03-21
,0,0,0,0,Washington,2022-03-22
,0,0,0,0,Washington,2022-03-24
,0,0,0,0,Washington,2022-03-25
,0,0,0,0,Washington,2022-03-26
,0,0,0,0,Washington,2022-03-28
,0,0,0,0,Washington,2022-03-30
,0,0,0,0,Washington,2022-03-31
,0,0,0,0,Washington,2022-04-02
,0,0,0,0,Washington,2022-04-04
,0,0,0,0,Washington,2022-04-06
,0,0,0,0,Washington,2022-04-07
,0,0,0,0,Washington,2022-04-09
,0,0,0,0,Washington,2022-04-10
,0,0,0,0,Washington,2022-04-11
,0,0,0,0,Washington,2022-04-12
,0,0,0,0,Washington,2022-04-13
,0,0,0,0,Washington,2022-04-14
,0,0,0,0,Washington,2022-04-15
,0,0,0,0,Washington,2022-04-16
,0,0,0,0,Washington,2022-04-21
,0,0,0,0,Washington,2022-04-22
,0,0,0,0,Washington,2022-04-23
,0,0,0,0,Washington,2022-04-24
,0,0,0,0,Washington,2022-04-29
,0,0,0,0,Washington,2022-05-01
,0,0,0,0,Washington,2022-05-03
,0,0,0,0,Washington,2022-05-04
,0,0,0,0,Washington,2022-05-05
,0,0,0,0,Washington,2022-05-06
,0,0,0,0,Washington,2022-05-07
,0,0,0,0,Washington,2022-05-08
,0,0,0,0,Washington,2022-05-11
,0,0,0,0,Washington,2022-05-18
,0,0,0,0,Washington,2022-05-21
,0,0,0,0,Washington,2022-05-22
,0,0,0,0,Washington,2022-05-27
,0,0,0,0,Washington,2022-06-04
,0,0,0,0,Washington,2022-06-05
0,2,0,2,0,Washington,2021-12-14
0,4,1,3,0,Washington,2021-12-17
0,6,1,5,0,Washington,2021-12-20
0,2,1,1,0,Washington,2021-12-21
0,5,0,5,0,Washington,2021-12-23
0,1,0,1,0,Washington,2021-12-25
0,25,1,24,0,Washington,2021-12-31
0,22,4,18,0,Washington,2022-01-08
0,17,1,16,0,Washington,2022-01-15
0,4,3,1,0,Washington,2022-01-21
0,2,2,0,0,Washington,2022-01-22
0,9,3,6,0,Washington,2022-01-23
0,29,12,17,0,Washington,2022-01-26
0,15,4,11,0,Washington,2022-01-27
0,5,2,3,0,Washington,2022-01-29
0,6,2,4,0,Washington,2022-01-30
0,17,5,12,0,Washington,2022-02-04
0,3,1,2,0,Washington,2022-02-09
0,2,0,2,0,Washington,2022-02-10
0,4,0,4,0,Washington,2022-02-12
0,1,0,1,0,Washington,2022-02-13
0,7,2,5,0,Washington,2022-02-14
0,6,4,2,0,Washington,2022-02-16
0,2,1,1,0,Washington,2022-02-17
0,2,1,1,0,Washington,2022-02-18
0,1,0,1,0,Washington,2022-02-20
0,3,0,3,0,Washington,2022-02-22
0,2,0,2,0,Washington,2022-02-24
0,1,1,0,0,Washington,2022-02-25
0,1,0,1,0,Washington,2022-02-27
0,2,0,2,0,Washington,2022-02-28
0,3,2,1,0,Washington,2022-03-02
0,1,0,1,0,Washington,2022-03-06
0,2,0,2,0,Washington,2022-03-08
0,1,0,1,0,Washington,2022-03-14
0,2,2,0,0,Washington,2022-03-15
0,1,0,1,0,Washington,2022-03-23
0,1,1,0,0,Washington,2022-03-29
0,3,1,2,0,Washington,2022-04-03
0,1,1,0,0,Washington,2022-04-08
0,1,0,1,0,Washington,2022-04-17
0,1,0,1,0,Washington,2022-04-18
0,1,1,0,0,Washington,2022-04-19
0,2,1,1,0,Washington,2022-04-20
0,2,1,1,0,Washington,2022-04-25
0,3,0,3,0,Washington,2022-04-26
0,1,0,1,0,Washington,2022-04-27
0,3,1,2,0,Washington,2022-04-28
0,1,0,1,0,Washington,2022-04-30
0,1,1,0,0,Washington,2022-05-02
0,2,1,1,0,Washington,2022-05-09
0,4,1,3,0,Washington,2022-05-10
0,1,1,0,0,Washington,2022-05-12
0,3,1,2,0,Washington,2022-05-13
0,3,1,2,0,Washington,2022-05-15
0,4,2,2,0,Washington,2022-05-19
0,1,0,1,0,Washington,2022-05-20
0,1,0,1,0,Washington,2022-05-24
0,1,0,1,0,Washington,2022-05-25
0,2,0,2,0,Washington,2022-05-26
0,1,0,1,0,Washington,2022-05-29
0,1,0,1,0,Washington,2022-05-30
0,1,0,1,0,Washington,2022-05-31
0,3,0,3,0,Washington,2022-06-01
0,4,2,2,0,Washington,2022-06-02
0,4,1,3,0,Washington,2022-06-03
0,6,1,5,0,Washington,2022-06-09
0,2,1,1,0,Washington,2022-06-10
0,1,0,1,0,Washington,2022-06-11
1,24,13,11,0,Washington,2021-12-28
1,12,2,10,0,Washington,2022-01-09
1,47,8,39,0,Washington,2022-01-25
1,13,4,9,0,Washington,2022-02-01
1,12,2,10,0,Washington,2022-02-08
1,2,0,2,0,Washington,2022-03-04
1,1,0,1,0,Washington,2022-03-07
1,1,0,1,0,Washington,2022-03-09
1,1,0,1,0,Washington,2022-03-27
1,1,0,1,0,Washington,2022-04-01
1,4,1,3,0,Washington,2022-05-14
1,3,1,2,0,Washington,2022-05-23
1,1,0,1,0,Washington,2022-05-28
1,4,0,4,0,Washington,2022-06-06
1,4,3,1,0,Washington,2022-06-07
2,5,3,2,0,Washington,2021-12-22
2,5,3,2,0,Washington,2022-01-01
2,12,2,10,0,Washington,2022-01-02
2,42,7,35,0,Washington,2022-01-03
2,38,2,36,0,Washington,2022-01-07
2,43,9,34,0,Washington,2022-01-11
2,10,4,6,0,Washington,2022-01-16
2,32,7,25,0,Washington,2022-01-20
2,48,26,22,0,Washington,2022-01-24
2,7,0,7,0,Washington,2022-02-03
2,13,4,9,0,Washington,2022-02-07
2,9,6,3,0,Washington,2022-02-15
2,6,0,6,0,Washington,2022-06-08
3,23,18,5,0,Washington,2021-12-27
3,62,11,51,0,Washington,2022-01-04
3,55,7,48,0,Washington,2022-01-14
4,30,19,11,0,Washington,2021-12-29
4,62,2,60,0,Washington,2022-01-10
5,68,9,59,0,Washington,2022-01-19
6,48,2,46,0,Washington,2022-01-06
6,61,7,54,0,Washington,2022-01-12
6,49,11,38,0,Washington,2022-01-13
8,53,32,21,0,Washington,2021-12-30
8,69,6,63,0,Washington,2022-01-18
0,44,26,18,0,Watauga,2022-01-15
0,21,19,2,0,Watauga,2022-01-16
0,32,14,18,0,Watauga,2022-02-11
0,7,1,6,0,Watauga,2022-02-19
0,4,1,3,0,Watauga,2022-02-20
0,31,15,16,0,Watauga,2022-02-21
0,16,2,14,0,Watauga,2022-02-24
0,6,1,5,0,Watauga,2022-02-26
0,4,2,2,0,Watauga,2022-03-05
0,3,1,2,0,Watauga,2022-03-07
0,3,2,1,0,Watauga,2022-03-08
0,5,3,2,0,Watauga,2022-03-09
0,1,1,0,0,Watauga,2022-03-12
0,1,0,1,0,Watauga,2022-03-16
0,2,0,2,0,Watauga,2022-03-17
0,1,0,1,0,Watauga,2022-03-19
0,3,3,0,0,Watauga,2022-03-20
0,5,4,1,0,Watauga,2022-03-21
0,3,1,2,0,Watauga,2022-03-24
0,2,0,2,0,Watauga,2022-03-26
0,2,2,0,0,Watauga,2022-03-27
0,1,1,0,0,Watauga,2022-03-31
0,1,0,1,0,Watauga,2022-04-01
0,4,2,2,0,Watauga,2022-04-03
0,6,4,2,0,Watauga,2022-04-06
0,10,5,5,0,Watauga,2022-04-09
0,6,4,2,0,Watauga,2022-04-10
0,16,7,9,0,Watauga,2022-04-14
0,8,8,0,0,Watauga,2022-04-15
0,14,5,9,0,Watauga,2022-04-19
0,9,3,6,0,Watauga,2022-04-20
0,12,10,2,0,Watauga,2022-04-24
0,11,1,10,0,Watauga,2022-04-28
0,9,5,4,0,Watauga,2022-05-01
0,11,8,3,0,Watauga,2022-05-07
0,11,4,7,0,Watauga,2022-05-10
0,9,3,6,0,Watauga,2022-05-11
0,18,7,11,0,Watauga,2022-05-12
0,17,9,8,0,Watauga,2022-05-26
0,8,2,6,0,Watauga,2022-05-29
0,12,6,6,0,Watauga,2022-05-30
0,13,6,7,0,Watauga,2022-06-06
1,21,12,9,0,Watauga,2021-12-14
1,19,4,15,0,Watauga,2021-12-17
1,11,3,8,0,Watauga,2021-12-18
1,44,6,38,0,Watauga,2021-12-20
1,30,4,26,0,Watauga,2021-12-22
1,12,6,6,0,Watauga,2021-12-24
1,6,0,6,0,Watauga,2021-12-25
1,25,5,20,0,Watauga,2021-12-26
1,48,13,35,0,Watauga,2021-12-27
1,33,14,19,0,Watauga,2021-12-31
1,20,10,10,0,Watauga,2022-02-05
1,3,3,0,0,Watauga,2022-02-27
1,12,7,5,0,Watauga,2022-02-28
1,15,4,11,0,Watauga,2022-03-03
1,5,1,4,0,Watauga,2022-03-10
1,4,1,3,0,Watauga,2022-03-11
1,6,2,4,0,Watauga,2022-03-14
1,4,3,1,0,Watauga,2022-03-15
1,4,2,2,0,Watauga,2022-03-18
1,3,0,3,0,Watauga,2022-03-22
1,1,0,1,0,Watauga,2022-03-29
1,8,3,5,0,Watauga,2022-04-04
1,13,7,6,0,Watauga,2022-04-05
1,10,7,3,0,Watauga,2022-04-08
1,27,16,11,0,Watauga,2022-04-12
1,18,11,7,0,Watauga,2022-04-13
1,12,7,5,0,Watauga,2022-04-16
1,4,2,2,0,Watauga,2022-04-17
1,19,11,8,0,Watauga,2022-04-22
1,5,3,2,0,Watauga,2022-04-23
1,15,5,10,0,Watauga,2022-04-27
1,22,8,14,0,Watauga,2022-04-29
1,22,11,11,0,Watauga,2022-05-03
1,17,3,14,0,Watauga,2022-05-04
1,18,10,8,0,Watauga,2022-05-09
1,31,21,10,0,Watauga,2022-05-16
1,22,13,9,0,Watauga,2022-05-20
1,17,5,12,0,Watauga,2022-05-23
1,23,11,12,0,Watauga,2022-05-27
1,22,8,14,0,Watauga,2022-06-01
1,8,3,5,0,Watauga,2022-06-04
1,15,5,10,0,Watauga,2022-06-08
1,15,2,13,0,Watauga,2022-06-09
1,10,1,9,0,Watauga,2022-06-10
1,6,1,5,0,Watauga,2022-06-11
2,28,15,13,0,Watauga,2021-12-15
2,20,5,15,0,Watauga,2021-12-19
2,17,13,4,0,Watauga,2022-01-01
2,26,16,10,0,Watauga,2022-01-02
2,33,23,10,0,Watauga,2022-01-29
2,23,13,10,0,Watauga,2022-02-06
2,14,10,4,0,Watauga,2022-02-12
2,14,9,5,0,Watauga,2022-02-13
2,19,8,11,0,Watauga,2022-02-18
2,26,13,13,0,Watauga,2022-02-22
2,3,0,3,0,Watauga,2022-03-30
2,13,11,2,0,Watauga,2022-04-07
2,18,9,9,0,Watauga,2022-04-18
2,12,3,9,0,Watauga,2022-04-21
2,17,6,11,0,Watauga,2022-04-26
2,10,5,5,0,Watauga,2022-04-30
2,11,0,11,0,Watauga,2022-05-05
2,10,5,5,0,Watauga,2022-05-06
2,19,9,10,0,Watauga,2022-05-21
2,20,13,7,0,Watauga,2022-05-25
2,15,9,6,0,Watauga,2022-05-28
3,69,22,47,0,Watauga,2021-12-29
3,39,11,28,0,Watauga,2022-01-08
3,39,11,28,0,Watauga,2022-01-09
3,25,9,16,0,Watauga,2022-02-16
3,23,8,15,0,Watauga,2022-02-17
3,9,3,6,0,Watauga,2022-03-23
3,20,9,11,0,Watauga,2022-04-25
3,11,4,7,0,Watauga,2022-05-13
3,20,14,6,0,Watauga,2022-05-17
3,18,11,7,0,Watauga,2022-05-18
3,12,5,7,0,Watauga,2022-05-22
3,15,13,2,0,Watauga,2022-05-24
3,19,11,8,0,Watauga,2022-06-03
4,92,22,70,0,Watauga,2021-12-30
4,52,24,28,0,Watauga,2022-01-03
4,25,16,9,0,Watauga,2022-04-11
4,18,14,4,0,Watauga,2022-05-15
4,22,7,15,0,Watauga,2022-06-07
5,46,15,31,0,Watauga,2021-12-21
5,89,24,65,0,Watauga,2021-12-28
5,42,22,20,0,Watauga,2022-01-30
5,20,9,11,0,Watauga,2022-05-19
6,53,46,7,0,Watauga,2022-01-17
7,128,55,73,0,Watauga,2022-01-14
7,54,29,25,0,Watauga,2022-02-04
8,55,29,26,0,Watauga,2022-02-08
10,179,81,98,0,Watauga,2022-01-24
10,124,69,55,0,Watauga,2022-01-26
11,171,48,123,0,Watauga,2022-01-12
11,121,62,59,0,Watauga,2022-01-31
12,122,89,33,0,Watauga,2022-01-18
12,122,56,66,0,Watauga,2022-02-01
13,136,36,100,0,Watauga,2022-01-06
13,218,80,138,0,Watauga,2022-01-25
14,128,48,80,0,Watauga,2022-01-27
15,208,87,121,0,Watauga,2022-01-10
17,201,64,137,0,Watauga,2022-01-04
27,272,100,172,0,Watauga,2022-01-19
33,228,82,146,0,Watauga,2022-01-20
,0,0,0,0,Wayne,2022-03-26
0,28,13,15,0,Wayne,2021-12-15
0,18,3,15,0,Wayne,2021-12-18
0,57,32,25,0,Wayne,2021-12-23
0,16,5,11,0,Wayne,2022-02-23
0,15,6,9,0,Wayne,2022-02-25
0,3,0,3,0,Wayne,2022-02-26
0,3,0,3,0,Wayne,2022-02-27
0,11,5,6,0,Wayne,2022-03-01
0,5,0,5,0,Wayne,2022-03-05
0,12,3,9,0,Wayne,2022-03-08
0,4,3,1,0,Wayne,2022-03-11
0,1,1,0,0,Wayne,2022-03-13
0,1,0,1,0,Wayne,2022-03-20
0,5,0,5,0,Wayne,2022-03-22
0,4,3,1,0,Wayne,2022-03-23
0,9,5,4,0,Wayne,2022-03-28
0,2,1,1,0,Wayne,2022-03-29
0,3,1,2,0,Wayne,2022-03-31
0,2,0,2,0,Wayne,2022-04-01
0,1,0,1,0,Wayne,2022-04-05
0,3,2,1,0,Wayne,2022-04-06
0,1,1,0,0,Wayne,2022-04-09
0,9,6,3,0,Wayne,2022-04-14
0,4,0,4,0,Wayne,2022-04-15
0,1,0,1,0,Wayne,2022-04-17
0,9,4,5,0,Wayne,2022-04-19
0,6,1,5,0,Wayne,2022-05-01
0,21,11,10,0,Wayne,2022-05-12
0,29,18,11,0,Wayne,2022-05-16
0,25,13,12,0,Wayne,2022-05-17
0,12,5,7,0,Wayne,2022-05-29
0,18,9,9,0,Wayne,2022-05-30
0,11,7,4,0,Wayne,2022-06-04
1,20,9,11,0,Wayne,2021-12-14
1,38,20,18,0,Wayne,2021-12-20
1,28,13,15,0,Wayne,2022-02-18
1,10,2,8,0,Wayne,2022-02-19
1,8,7,1,0,Wayne,2022-03-16
1,3,1,2,0,Wayne,2022-03-18
1,9,3,6,0,Wayne,2022-03-30
1,6,2,4,0,Wayne,2022-04-02
1,3,0,3,0,Wayne,2022-04-03
1,7,4,3,0,Wayne,2022-04-04
1,4,1,3,0,Wayne,2022-04-07
1,7,4,3,0,Wayne,2022-04-08
1,13,8,5,0,Wayne,2022-04-11
1,5,2,3,0,Wayne,2022-04-13
1,5,2,3,0,Wayne,2022-04-16
1,12,2,10,0,Wayne,2022-04-21
1,7,3,4,0,Wayne,2022-04-29
1,5,3,2,0,Wayne,2022-04-30
1,13,9,4,0,Wayne,2022-05-06
1,13,4,9,0,Wayne,2022-05-14
1,11,2,9,0,Wayne,2022-05-15
1,23,10,13,0,Wayne,2022-05-20
1,11,5,6,0,Wayne,2022-05-21
1,13,3,10,0,Wayne,2022-05-28
1,17,6,11,0,Wayne,2022-06-05
1,14,6,8,0,Wayne,2022-06-11
2,12,5,7,0,Wayne,2021-12-19
2,11,3,8,0,Wayne,2021-12-25
2,24,10,14,0,Wayne,2021-12-26
2,40,4,36,0,Wayne,2022-01-22
2,13,2,11,0,Wayne,2022-02-12
2,23,15,8,0,Wayne,2022-02-21
2,10,6,4,0,Wayne,2022-04-23
2,6,4,2,0,Wayne,2022-04-28
2,11,5,6,0,Wayne,2022-05-07
2,19,12,7,0,Wayne,2022-05-09
2,17,12,5,0,Wayne,2022-05-11
2,27,16,11,0,Wayne,2022-05-18
2,33,23,10,0,Wayne,2022-05-26
2,40,13,27,0,Wayne,2022-06-09
3,14,4,10,0,Wayne,2022-02-13
3,22,6,16,0,Wayne,2022-02-22
3,9,7,2,0,Wayne,2022-03-14
3,9,3,6,0,Wayne,2022-04-18
3,7,3,4,0,Wayne,2022-04-22
3,16,11,5,0,Wayne,2022-04-26
3,14,8,6,0,Wayne,2022-05-03
3,22,13,9,0,Wayne,2022-05-04
3,29,21,8,0,Wayne,2022-06-03
4,44,20,24,0,Wayne,2022-02-17
4,14,4,10,0,Wayne,2022-04-20
4,19,10,9,0,Wayne,2022-05-13
4,39,24,15,0,Wayne,2022-05-19
4,16,8,8,0,Wayne,2022-05-22
4,32,20,12,0,Wayne,2022-06-02
4,35,25,10,0,Wayne,2022-06-06
4,27,14,13,0,Wayne,2022-06-10
5,88,19,69,0,Wayne,2022-01-02
5,24,15,9,0,Wayne,2022-05-10
5,40,22,18,0,Wayne,2022-05-23
5,45,30,15,0,Wayne,2022-05-24
5,33,16,17,0,Wayne,2022-06-07
7,108,17,91,0,Wayne,2022-01-16
7,78,43,35,0,Wayne,2022-02-08
7,31,20,11,0,Wayne,2022-05-02
7,28,19,9,0,Wayne,2022-05-25
7,38,24,14,0,Wayne,2022-05-27
8,49,28,21,0,Wayne,2022-06-08
9,77,15,62,0,Wayne,2022-01-01
9,44,28,16,0,Wayne,2022-06-01
11,52,39,13,0,Wayne,2022-05-31
12,185,71,114,0,Wayne,2022-01-27
13,49,28,21,0,Wayne,2022-05-05
14,191,75,116,0,Wayne,2022-01-08
16,269,90,179,0,Wayne,2022-01-15
20,254,141,113,0,Wayne,2021-12-30
23,164,76,88,0,Wayne,2021-12-28
23,201,91,110,0,Wayne,2021-12-29
29,217,106,111,0,Wayne,2022-01-26
31,428,232,196,0,Wayne,2022-01-06
32,355,192,163,0,Wayne,2022-01-07
37,424,210,214,0,Wayne,2022-01-04
49,703,323,380,0,Wayne,2022-01-10
53,458,211,247,0,Wayne,2022-01-20
61,550,223,327,0,Wayne,2022-01-19
,0,0,0,0,Wilkes,2022-03-19
,0,0,0,0,Wilkes,2022-03-26
,0,0,0,0,Wilkes,2022-03-27
,0,0,0,0,Wilkes,2022-03-29
,0,0,0,0,Wilkes,2022-04-05
,0,0,0,0,Wilkes,2022-04-16
,0,0,0,0,Wilkes,2022-04-17
0,33,19,14,0,Wilkes,2021-12-15
0,18,10,8,0,Wilkes,2021-12-19
0,21,16,5,0,Wilkes,2021-12-24
0,12,5,7,0,Wilkes,2021-12-25
0,16,8,8,0,Wilkes,2022-02-24
0,8,3,5,0,Wilkes,2022-03-03
0,11,5,6,0,Wilkes,2022-03-04
0,4,0,4,0,Wilkes,2022-03-05
0,2,1,1,0,Wilkes,2022-03-06
0,6,1,5,0,Wilkes,2022-03-08
0,10,3,7,0,Wilkes,2022-03-09
0,3,1,2,0,Wilkes,2022-03-11
0,4,3,1,0,Wilkes,2022-03-12
0,2,0,2,0,Wilkes,2022-03-17
0,2,1,1,0,Wilkes,2022-03-18
0,1,0,1,0,Wilkes,2022-03-20
0,2,2,0,0,Wilkes,2022-03-21
0,1,0,1,0,Wilkes,2022-03-22
0,2,0,2,0,Wilkes,2022-03-24
0,1,0,1,0,Wilkes,2022-03-30
0,1,0,1,0,Wilkes,2022-03-31
0,1,0,1,0,Wilkes,2022-04-01
0,1,0,1,0,Wilkes,2022-04-02
0,1,0,1,0,Wilkes,2022-04-03
0,3,1,2,0,Wilkes,2022-04-04
0,2,1,1,0,Wilkes,2022-04-06
0,2,0,2,0,Wilkes,2022-04-07
0,5,1,4,0,Wilkes,2022-04-08
0,1,0,1,0,Wilkes,2022-04-09
0,1,1,0,0,Wilkes,2022-04-10
0,1,0,1,0,Wilkes,2022-04-11
0,5,2,3,0,Wilkes,2022-04-12
0,5,1,4,0,Wilkes,2022-04-18
0,2,0,2,0,Wilkes,2022-04-19
0,4,0,4,0,Wilkes,2022-04-20
0,6,3,3,0,Wilkes,2022-04-21
0,5,2,3,0,Wilkes,2022-04-22
0,4,2,2,0,Wilkes,2022-04-24
0,2,2,0,0,Wilkes,2022-04-28
0,9,6,3,0,Wilkes,2022-04-29
0,4,1,3,0,Wilkes,2022-04-30
0,9,3,6,0,Wilkes,2022-05-07
0,4,1,3,0,Wilkes,2022-05-08
0,18,9,9,0,Wilkes,2022-05-09
0,10,4,6,0,Wilkes,2022-05-24
0,7,2,5,0,Wilkes,2022-06-11
1,17,3,14,0,Wilkes,2021-12-18
1,15,9,6,0,Wilkes,2022-02-20
1,4,2,2,0,Wilkes,2022-02-26
1,3,0,3,0,Wilkes,2022-03-13
1,8,2,6,0,Wilkes,2022-03-14
1,1,0,1,0,Wilkes,2022-03-23
1,2,1,1,0,Wilkes,2022-03-28
1,1,1,0,0,Wilkes,2022-04-14
1,4,2,2,0,Wilkes,2022-04-23
1,5,4,1,0,Wilkes,2022-04-26
1,2,2,0,0,Wilkes,2022-04-27
1,4,4,0,0,Wilkes,2022-05-01
1,8,3,5,0,Wilkes,2022-05-02
1,16,5,11,0,Wilkes,2022-05-04
1,12,2,10,0,Wilkes,2022-05-05
1,15,11,4,0,Wilkes,2022-05-06
1,8,4,4,0,Wilkes,2022-05-10
1,17,8,9,0,Wilkes,2022-05-14
1,14,6,8,0,Wilkes,2022-05-15
1,18,7,11,0,Wilkes,2022-05-16
1,24,16,8,0,Wilkes,2022-05-25
2,38,15,23,0,Wilkes,2022-02-05
2,22,10,12,0,Wilkes,2022-02-13
2,31,13,18,0,Wilkes,2022-02-18
2,21,9,12,0,Wilkes,2022-02-19
2,24,9,15,0,Wilkes,2022-02-21
2,30,10,20,0,Wilkes,2022-02-25
2,8,5,3,0,Wilkes,2022-02-27
2,9,2,7,0,Wilkes,2022-05-12
2,14,7,7,0,Wilkes,2022-05-13
2,17,5,12,0,Wilkes,2022-05-19
2,19,13,6,0,Wilkes,2022-05-20
2,11,8,3,0,Wilkes,2022-05-21
2,19,15,4,0,Wilkes,2022-05-22
2,29,8,21,0,Wilkes,2022-05-26
2,23,8,15,0,Wilkes,2022-05-28
2,18,8,10,0,Wilkes,2022-06-03
3,49,18,31,0,Wilkes,2021-12-20
3,55,25,30,0,Wilkes,2021-12-31
3,56,10,46,0,Wilkes,2022-01-23
3,9,1,8,0,Wilkes,2022-03-01
3,15,8,7,0,Wilkes,2022-05-11
3,21,15,6,0,Wilkes,2022-05-27
4,25,9,16,0,Wilkes,2022-02-15
4,24,13,11,0,Wilkes,2022-05-18
4,21,14,7,0,Wilkes,2022-05-29
4,20,13,7,0,Wilkes,2022-05-30
4,23,16,7,0,Wilkes,2022-06-01
4,20,16,4,0,Wilkes,2022-06-04
4,13,5,8,0,Wilkes,2022-06-09
5,97,29,68,0,Wilkes,2021-12-29
5,100,32,68,0,Wilkes,2021-12-30
5,44,24,20,0,Wilkes,2022-01-01
5,41,16,25,0,Wilkes,2022-02-22
5,25,13,12,0,Wilkes,2022-06-08
6,79,25,54,0,Wilkes,2022-02-02
6,54,23,31,0,Wilkes,2022-02-10
6,51,26,25,0,Wilkes,2022-05-23
6,34,20,14,0,Wilkes,2022-06-02
8,97,47,50,0,Wilkes,2021-12-28
8,116,53,63,0,Wilkes,2022-01-15
8,66,26,40,0,Wilkes,2022-02-14
9,29,14,15,0,Wilkes,2022-06-07
10,131,48,83,0,Wilkes,2022-01-03
10,182,72,110,0,Wilkes,2022-01-13
12,157,44,113,0,Wilkes,2022-01-06
12,110,45,65,0,Wilkes,2022-01-07
20,252,67,185,0,Wilkes,2022-01-19
22,245,98,147,0,Wilkes,2022-01-10
25,174,73,101,0,Wilkes,2022-01-14
,0,0,0,0,Wilson,2022-03-22
,0,0,0,0,Wilson,2022-03-24
,0,0,0,0,Wilson,2022-03-26
,0,0,0,0,Wilson,2022-03-27
,0,0,0,0,Wilson,2022-04-03
,0,0,0,0,Wilson,2022-04-04
0,18,8,10,0,Wilson,2021-12-15
0,11,2,9,0,Wilson,2021-12-19
0,26,5,21,0,Wilson,2021-12-20
0,9,4,5,0,Wilson,2021-12-25
0,23,0,23,0,Wilson,2022-01-22
0,9,0,9,0,Wilson,2022-02-23
0,3,1,2,0,Wilson,2022-02-27
0,8,2,6,0,Wilson,2022-02-28
0,2,0,2,0,Wilson,2022-03-03
0,3,1,2,0,Wilson,2022-03-06
0,3,0,3,0,Wilson,2022-03-08
0,3,0,3,0,Wilson,2022-03-11
0,3,0,3,0,Wilson,2022-03-12
0,5,0,5,0,Wilson,2022-03-14
0,1,0,1,0,Wilson,2022-03-15
0,1,1,0,0,Wilson,2022-03-18
0,2,1,1,0,Wilson,2022-03-21
0,5,1,4,0,Wilson,2022-03-23
0,1,0,1,0,Wilson,2022-03-25
0,3,3,0,0,Wilson,2022-03-30
0,4,2,2,0,Wilson,2022-03-31
0,2,0,2,0,Wilson,2022-04-01
0,2,0,2,0,Wilson,2022-04-02
0,1,0,1,0,Wilson,2022-04-06
0,5,2,3,0,Wilson,2022-04-07
0,5,0,5,0,Wilson,2022-04-08
0,2,0,2,0,Wilson,2022-04-09
0,5,2,3,0,Wilson,2022-04-15
0,1,0,1,0,Wilson,2022-04-16
0,1,1,0,0,Wilson,2022-04-17
0,4,4,0,0,Wilson,2022-04-18
0,4,0,4,0,Wilson,2022-04-22
0,3,2,1,0,Wilson,2022-04-24
0,10,3,7,0,Wilson,2022-04-25
0,4,3,1,0,Wilson,2022-04-28
0,3,2,1,0,Wilson,2022-04-30
0,14,5,9,0,Wilson,2022-05-04
0,11,4,7,0,Wilson,2022-05-06
0,7,1,6,0,Wilson,2022-05-07
0,16,10,6,0,Wilson,2022-05-13
0,15,5,10,0,Wilson,2022-05-24
0,7,4,3,0,Wilson,2022-05-28
0,20,6,14,0,Wilson,2022-06-03
0,8,3,5,0,Wilson,2022-06-04
1,16,10,6,0,Wilson,2021-12-16
1,21,4,17,0,Wilson,2021-12-17
1,12,4,8,0,Wilson,2021-12-18
1,22,6,16,0,Wilson,2021-12-24
1,35,6,29,0,Wilson,2022-01-29
1,43,10,33,0,Wilson,2022-02-04
1,8,0,8,0,Wilson,2022-02-12
1,15,6,9,0,Wilson,2022-02-16
1,20,7,13,0,Wilson,2022-02-17
1,10,3,7,0,Wilson,2022-02-20
1,16,4,12,0,Wilson,2022-02-22
1,6,2,4,0,Wilson,2022-03-01
1,8,2,6,0,Wilson,2022-03-02
1,4,2,2,0,Wilson,2022-03-09
1,6,3,3,0,Wilson,2022-03-10
1,1,0,1,0,Wilson,2022-03-16
1,7,3,4,0,Wilson,2022-03-29
1,6,2,4,0,Wilson,2022-04-10
1,6,1,5,0,Wilson,2022-04-11
1,7,6,1,0,Wilson,2022-04-13
1,4,3,1,0,Wilson,2022-04-14
1,7,1,6,0,Wilson,2022-04-19
1,10,3,7,0,Wilson,2022-04-20
1,4,1,3,0,Wilson,2022-04-23
1,14,4,10,0,Wilson,2022-04-27
1,7,4,3,0,Wilson,2022-04-29
1,14,5,9,0,Wilson,2022-05-02
1,6,2,4,0,Wilson,2022-05-08
1,20,11,9,0,Wilson,2022-05-10
1,18,8,10,0,Wilson,2022-05-12
1,14,4,10,0,Wilson,2022-05-14
1,21,9,12,0,Wilson,2022-05-19
1,13,5,8,0,Wilson,2022-05-22
1,16,5,11,0,Wilson,2022-05-27
1,24,8,16,0,Wilson,2022-06-06
1,12,7,5,0,Wilson,2022-06-08
1,15,3,12,0,Wilson,2022-06-10
2,7,2,5,0,Wilson,2022-03-17
2,9,5,4,0,Wilson,2022-04-12
2,7,3,4,0,Wilson,2022-05-01
2,23,12,11,0,Wilson,2022-05-09
2,22,9,13,0,Wilson,2022-05-26
2,10,5,5,0,Wilson,2022-05-30
2,6,2,4,0,Wilson,2022-06-11
3,30,7,23,0,Wilson,2021-12-14
3,21,5,16,0,Wilson,2022-01-30
3,28,12,16,0,Wilson,2022-02-09
3,8,3,5,0,Wilson,2022-04-21
3,10,6,4,0,Wilson,2022-04-26
3,10,4,6,0,Wilson,2022-05-05
3,30,13,17,0,Wilson,2022-05-16
3,31,13,18,0,Wilson,2022-05-17
3,31,5,26,0,Wilson,2022-05-18
3,27,10,17,0,Wilson,2022-05-20
3,28,11,17,0,Wilson,2022-05-25
3,38,15,23,0,Wilson,2022-05-31
3,23,10,13,0,Wilson,2022-06-09
4,62,7,55,0,Wilson,2022-01-08
4,12,4,8,0,Wilson,2022-05-03
4,26,14,12,0,Wilson,2022-05-11
4,23,6,17,0,Wilson,2022-06-02
6,36,14,22,0,Wilson,2022-02-08
6,26,14,12,0,Wilson,2022-06-01
10,82,11,71,0,Wilson,2022-02-01
11,125,41,84,0,Wilson,2021-12-27
13,132,24,108,0,Wilson,2021-12-31
14,272,50,222,0,Wilson,2022-01-20
19,273,63,210,0,Wilson,2022-01-19
28,241,87,154,0,Wilson,2022-01-17
29,218,45,173,0,Wilson,2021-12-29
32,336,61,275,0,Wilson,2022-01-04
40,335,80,255,0,Wilson,2022-01-03
,0,0,0,0,Yadkin,2022-03-11
,0,0,0,0,Yadkin,2022-03-12
,0,0,0,0,Yadkin,2022-03-18
,0,0,0,0,Yadkin,2022-03-19
,0,0,0,0,Yadkin,2022-03-20
,0,0,0,0,Yadkin,2022-03-24
,0,0,0,0,Yadkin,2022-03-26
,0,0,0,0,Yadkin,2022-03-27
,0,0,0,0,Yadkin,2022-04-02
,0,0,0,0,Yadkin,2022-04-03
,0,0,0,0,Yadkin,2022-04-11
,0,0,0,0,Yadkin,2022-04-12
0,32,14,18,0,Yadkin,2021-12-14
0,39,15,24,0,Yadkin,2021-12-15
0,30,11,19,0,Yadkin,2021-12-17
0,18,7,11,0,Yadkin,2021-12-18
0,17,6,11,0,Yadkin,2021-12-24
0,23,6,17,0,Yadkin,2022-01-29
0,14,4,10,0,Yadkin,2022-02-12
0,27,11,16,0,Yadkin,2022-02-16
0,7,4,3,0,Yadkin,2022-02-19
0,10,3,7,0,Yadkin,2022-02-23
0,6,1,5,0,Yadkin,2022-02-24
0,6,3,3,0,Yadkin,2022-02-25
0,6,0,6,0,Yadkin,2022-02-28
0,7,2,5,0,Yadkin,2022-03-01
0,4,2,2,0,Yadkin,2022-03-04
0,1,0,1,0,Yadkin,2022-03-05
0,2,0,2,0,Yadkin,2022-03-06
0,1,1,0,0,Yadkin,2022-03-17
0,4,3,1,0,Yadkin,2022-03-21
0,4,0,4,0,Yadkin,2022-03-23
0,1,1,0,0,Yadkin,2022-03-25
0,2,1,1,0,Yadkin,2022-03-28
0,2,0,2,0,Yadkin,2022-03-29
0,3,1,2,0,Yadkin,2022-03-30
0,1,1,0,0,Yadkin,2022-04-05
0,1,0,1,0,Yadkin,2022-04-07
0,2,1,1,0,Yadkin,2022-04-08
0,3,1,2,0,Yadkin,2022-04-09
0,1,0,1,0,Yadkin,2022-04-10
0,3,1,2,0,Yadkin,2022-04-13
0,3,0,3,0,Yadkin,2022-04-14
0,3,0,3,0,Yadkin,2022-04-16
0,3,2,1,0,Yadkin,2022-04-17
0,4,3,1,0,Yadkin,2022-04-18
0,1,0,1,0,Yadkin,2022-04-19
0,7,5,2,0,Yadkin,2022-04-20
0,4,2,2,0,Yadkin,2022-04-21
0,2,0,2,0,Yadkin,2022-04-22
0,1,0,1,0,Yadkin,2022-04-23
0,2,0,2,0,Yadkin,2022-04-27
0,5,5,0,0,Yadkin,2022-04-29
0,2,0,2,0,Yadkin,2022-04-30
0,1,0,1,0,Yadkin,2022-05-01
0,5,1,4,0,Yadkin,2022-05-07
0,9,2,7,0,Yadkin,2022-05-11
0,9,0,9,0,Yadkin,2022-05-22
0,6,3,3,0,Yadkin,2022-05-26
0,11,3,8,0,Yadkin,2022-06-03
1,39,7,32,0,Yadkin,2021-12-22
1,10,0,10,0,Yadkin,2022-01-16
1,7,2,5,0,Yadkin,2022-02-20
1,11,5,6,0,Yadkin,2022-02-22
1,7,1,6,0,Yadkin,2022-02-26
1,4,2,2,0,Yadkin,2022-03-02
1,2,0,2,0,Yadkin,2022-03-03
1,1,1,0,0,Yadkin,2022-03-09
1,2,0,2,0,Yadkin,2022-03-13
1,1,0,1,0,Yadkin,2022-03-15
1,2,1,1,0,Yadkin,2022-03-31
1,2,1,1,0,Yadkin,2022-04-04
1,4,1,3,0,Yadkin,2022-04-06
1,4,1,3,0,Yadkin,2022-04-24
1,3,1,2,0,Yadkin,2022-04-26
1,3,1,2,0,Yadkin,2022-04-28
1,13,7,6,0,Yadkin,2022-05-02
1,4,1,3,0,Yadkin,2022-05-03
1,8,2,6,0,Yadkin,2022-05-04
1,6,2,4,0,Yadkin,2022-05-05
1,8,3,5,0,Yadkin,2022-05-06
1,5,0,5,0,Yadkin,2022-05-08
1,11,2,9,0,Yadkin,2022-05-10
1,6,3,3,0,Yadkin,2022-05-12
1,13,4,9,0,Yadkin,2022-05-13
1,9,3,6,0,Yadkin,2022-05-14
1,10,2,8,0,Yadkin,2022-05-20
1,13,8,5,0,Yadkin,2022-05-28
1,13,6,7,0,Yadkin,2022-06-04
1,12,2,10,0,Yadkin,2022-06-09
1,22,5,17,0,Yadkin,2022-06-10
2,28,5,23,0,Yadkin,2022-01-30
2,16,5,11,0,Yadkin,2022-02-05
2,28,8,20,0,Yadkin,2022-02-09
2,10,3,7,0,Yadkin,2022-02-13
2,7,5,2,0,Yadkin,2022-02-18
2,5,3,2,0,Yadkin,2022-04-25
2,12,3,9,0,Yadkin,2022-05-09
2,9,1,8,0,Yadkin,2022-05-21
2,18,8,10,0,Yadkin,2022-05-24
2,12,3,9,0,Yadkin,2022-06-05
3,36,14,22,0,Yadkin,2022-01-01
3,46,9,37,0,Yadkin,2022-01-02
3,82,25,57,0,Yadkin,2022-01-24
3,41,11,30,0,Yadkin,2022-02-03
3,18,7,11,0,Yadkin,2022-02-06
3,29,5,24,0,Yadkin,2022-02-07
3,18,4,14,0,Yadkin,2022-02-10
3,16,6,10,0,Yadkin,2022-05-18
3,18,7,11,0,Yadkin,2022-05-19
3,18,3,15,0,Yadkin,2022-05-23
3,22,11,11,0,Yadkin,2022-05-27
3,8,3,5,0,Yadkin,2022-05-29
3,20,9,11,0,Yadkin,2022-06-06
3,14,5,9,0,Yadkin,2022-06-08
4,59,33,26,0,Yadkin,2021-12-31
4,96,16,80,0,Yadkin,2022-01-06
4,41,10,31,0,Yadkin,2022-02-04
4,12,6,6,0,Yadkin,2022-05-15
4,16,6,10,0,Yadkin,2022-05-16
4,16,10,6,0,Yadkin,2022-05-30
4,22,10,12,0,Yadkin,2022-06-01
4,24,7,17,0,Yadkin,2022-06-07
5,68,20,48,0,Yadkin,2022-01-09
5,59,15,44,0,Yadkin,2022-01-22
5,29,7,22,0,Yadkin,2022-02-11
6,53,11,42,0,Yadkin,2022-02-01
6,25,7,18,0,Yadkin,2022-05-31
6,13,3,10,0,Yadkin,2022-06-11
7,104,23,81,0,Yadkin,2021-12-29
7,24,11,13,0,Yadkin,2022-06-02
8,106,25,81,0,Yadkin,2022-01-21
8,89,17,72,0,Yadkin,2022-01-26
9,130,39,91,0,Yadkin,2022-01-10
9,102,19,83,0,Yadkin,2022-01-14
9,73,10,63,0,Yadkin,2022-01-15
9,40,11,29,0,Yadkin,2022-02-08
10,125,30,95,0,Yadkin,2021-12-28
11,109,39,70,0,Yadkin,2022-01-03
12,144,26,118,0,Yadkin,2022-01-04
15,103,18,85,0,Yadkin,2022-01-18
20,199,35,164,0,Yadkin,2022-01-11
20,153,29,124,0,Yadkin,2022-01-19
,0,0,0,0,Yancey,2022-03-11
,0,0,0,0,Yancey,2022-03-13
,0,0,0,0,Yancey,2022-03-17
,0,0,0,0,Yancey,2022-03-19
,0,0,0,0,Yancey,2022-03-20
,0,0,0,0,Yancey,2022-03-22
,0,0,0,0,Yancey,2022-03-23
,0,0,0,0,Yancey,2022-03-26
,0,0,0,0,Yancey,2022-03-27
,0,0,0,0,Yancey,2022-03-30
,0,0,0,0,Yancey,2022-04-01
,0,0,0,0,Yancey,2022-04-03
,0,0,0,0,Yancey,2022-04-06
,0,0,0,0,Yancey,2022-04-07
,0,0,0,0,Yancey,2022-04-09
,0,0,0,0,Yancey,2022-04-10
,0,0,0,0,Yancey,2022-04-11
,0,0,0,0,Yancey,2022-04-15
,0,0,0,0,Yancey,2022-04-17
,0,0,0,0,Yancey,2022-04-24
0,16,14,2,0,Yancey,2021-12-14
0,58,37,21,0,Yancey,2021-12-20
0,22,16,6,0,Yancey,2021-12-21
0,14,7,7,0,Yancey,2021-12-23
0,2,0,2,0,Yancey,2021-12-25
0,52,42,10,0,Yancey,2021-12-27
0,6,5,1,0,Yancey,2022-01-02
0,14,7,7,0,Yancey,2022-01-17
0,25,11,14,0,Yancey,2022-01-22
0,7,3,4,0,Yancey,2022-01-29
0,2,1,1,0,Yancey,2022-01-30
0,6,3,3,0,Yancey,2022-02-05
0,9,6,3,0,Yancey,2022-02-15
0,8,1,7,0,Yancey,2022-02-18
0,7,4,3,0,Yancey,2022-02-23
0,4,2,2,0,Yancey,2022-02-26
0,1,0,1,0,Yancey,2022-02-27
0,4,2,2,0,Yancey,2022-03-03
0,2,0,2,0,Yancey,2022-03-04
0,1,0,1,0,Yancey,2022-03-05
0,2,2,0,0,Yancey,2022-03-06
0,2,2,0,0,Yancey,2022-03-07
0,3,0,3,0,Yancey,2022-03-08
0,1,1,0,0,Yancey,2022-03-09
0,2,1,1,0,Yancey,2022-03-10
0,1,1,0,0,Yancey,2022-03-12
0,1,0,1,0,Yancey,2022-03-14
0,2,0,2,0,Yancey,2022-03-21
0,1,1,0,0,Yancey,2022-03-25
0,2,0,2,0,Yancey,2022-03-28
0,3,0,3,0,Yancey,2022-03-29
0,1,0,1,0,Yancey,2022-04-02
0,1,0,1,0,Yancey,2022-04-05
0,2,1,1,0,Yancey,2022-04-12
0,2,2,0,0,Yancey,2022-04-13
0,1,1,0,0,Yancey,2022-04-14
0,2,2,0,0,Yancey,2022-04-16
0,1,1,0,0,Yancey,2022-04-18
0,1,1,0,0,Yancey,2022-04-19
0,1,0,1,0,Yancey,2022-04-20
0,2,1,1,0,Yancey,2022-04-21
0,1,1,0,0,Yancey,2022-04-23
0,3,2,1,0,Yancey,2022-04-27
0,1,0,1,0,Yancey,2022-04-28
0,1,0,1,0,Yancey,2022-04-30
0,1,0,1,0,Yancey,2022-05-01
0,2,1,1,0,Yancey,2022-05-02
0,2,2,0,0,Yancey,2022-05-04
0,2,0,2,0,Yancey,2022-05-06
0,1,0,1,0,Yancey,2022-05-07
0,5,2,3,0,Yancey,2022-05-11
0,1,1,0,0,Yancey,2022-05-12
0,7,4,3,0,Yancey,2022-05-13
0,1,1,0,0,Yancey,2022-05-15
0,5,2,3,0,Yancey,2022-05-21
0,2,1,1,0,Yancey,2022-05-28
0,2,2,0,0,Yancey,2022-05-29
0,1,0,1,0,Yancey,2022-05-30
0,12,5,7,0,Yancey,2022-06-01
0,2,1,1,0,Yancey,2022-06-07
0,7,5,2,0,Yancey,2022-06-11
1,14,11,3,0,Yancey,2021-12-18
1,28,21,7,0,Yancey,2021-12-28
1,18,11,7,0,Yancey,2022-01-07
1,23,11,12,0,Yancey,2022-02-03
1,7,6,1,0,Yancey,2022-02-13
1,12,5,7,0,Yancey,2022-02-17
1,3,3,0,0,Yancey,2022-02-20
1,11,1,10,0,Yancey,2022-02-21
1,8,4,4,0,Yancey,2022-02-24
1,4,1,3,0,Yancey,2022-02-28
1,4,2,2,0,Yancey,2022-03-02
1,2,1,1,0,Yancey,2022-03-16
1,2,0,2,0,Yancey,2022-03-18
1,1,0,1,0,Yancey,2022-03-24
1,2,1,1,0,Yancey,2022-04-08
1,3,2,1,0,Yancey,2022-04-22
1,6,2,4,0,Yancey,2022-04-26
1,4,4,0,0,Yancey,2022-04-29
1,3,2,1,0,Yancey,2022-05-03
1,5,2,3,0,Yancey,2022-05-08
1,7,4,3,0,Yancey,2022-05-09
1,6,4,2,0,Yancey,2022-05-10
1,9,6,3,0,Yancey,2022-05-16
1,6,3,3,0,Yancey,2022-05-17
1,7,4,3,0,Yancey,2022-05-19
1,6,4,2,0,Yancey,2022-05-22
1,7,5,2,0,Yancey,2022-05-23
1,3,1,2,0,Yancey,2022-05-24
1,11,7,4,0,Yancey,2022-05-31
1,7,5,2,0,Yancey,2022-06-02
1,7,7,0,0,Yancey,2022-06-03
1,5,4,1,0,Yancey,2022-06-04
1,8,5,3,0,Yancey,2022-06-08
1,2,1,1,0,Yancey,2022-06-10
2,26,14,12,0,Yancey,2021-12-15
2,34,6,28,0,Yancey,2022-01-15
2,33,14,19,0,Yancey,2022-01-28
2,25,20,5,0,Yancey,2022-02-01
2,36,10,26,0,Yancey,2022-02-07
2,17,5,12,0,Yancey,2022-02-11
2,20,6,14,0,Yancey,2022-02-14
2,6,3,3,0,Yancey,2022-02-22
2,5,4,1,0,Yancey,2022-03-15
2,6,1,5,0,Yancey,2022-03-31
2,10,8,2,0,Yancey,2022-05-18
2,10,8,2,0,Yancey,2022-05-20
2,7,5,2,0,Yancey,2022-06-09
3,30,9,21,0,Yancey,2021-12-30
3,26,20,6,0,Yancey,2022-01-03
3,30,9,21,0,Yancey,2022-01-08
3,51,17,34,0,Yancey,2022-01-20
3,35,14,21,0,Yancey,2022-02-02
3,20,9,11,0,Yancey,2022-02-04
3,5,2,3,0,Yancey,2022-02-25
3,10,9,1,0,Yancey,2022-05-26
3,10,5,5,0,Yancey,2022-05-27
4,44,21,23,0,Yancey,2022-01-06
4,42,27,15,0,Yancey,2022-01-11
4,73,27,46,0,Yancey,2022-01-12
4,13,13,0,0,Yancey,2022-02-06
4,18,4,14,0,Yancey,2022-02-16
4,8,4,4,0,Yancey,2022-06-05
5,45,18,27,0,Yancey,2021-12-29
5,52,20,32,0,Yancey,2022-01-26
5,19,13,6,0,Yancey,2022-02-08
5,31,14,17,0,Yancey,2022-02-09
5,15,8,7,0,Yancey,2022-02-10
8,64,23,41,0,Yancey,2022-01-13
9,47,19,28,0,Yancey,2022-01-31
9,27,18,9,0,Yancey,2022-06-06
0,14,2,12,1,Alamance,2022-02-27
0,4,1,3,1,Alamance,2022-03-06
0,15,3,12,1,Alamance,2022-03-09
0,4,0,4,1,Alamance,2022-03-13
0,5,1,4,1,Alamance,2022-03-17
0,1,0,1,1,Alamance,2022-03-20
0,12,4,8,1,Alamance,2022-03-31
0,14,6,8,1,Alamance,2022-04-01
1,29,7,22,1,Alamance,2022-02-12
1,23,8,15,1,Alamance,2022-02-20
1,8,4,4,1,Alamance,2022-03-24
1,9,2,7,1,Alamance,2022-03-28
1,24,4,20,1,Alamance,2022-04-23
2,69,11,58,1,Alamance,2022-02-21
2,34,3,31,1,Alamance,2022-02-23
2,9,0,9,1,Alamance,2022-03-14
3,38,7,31,1,Alamance,2022-04-11
3,42,10,32,1,Alamance,2022-05-22
3,65,10,55,1,Alamance,2022-06-02
4,81,6,75,1,Alamance,2021-12-14
5,57,8,49,1,Alamance,2021-12-24
6,105,7,98,1,Alamance,2021-12-20
6,66,7,59,1,Alamance,2022-02-15
6,38,5,33,1,Alamance,2022-04-26
7,70,5,65,1,Alamance,2022-05-27
9,73,19,54,1,Alamance,2022-05-09
10,124,9,115,1,Alamance,2022-01-23
13,101,14,87,1,Alamance,2022-02-08
14,92,22,70,1,Alamance,2022-05-17
15,139,21,118,1,Alamance,2022-02-07
15,111,17,94,1,Alamance,2022-05-18
17,127,14,113,1,Alamance,2022-05-31
19,192,52,140,1,Alamance,2022-01-02
19,279,21,258,1,Alamance,2022-01-08
24,307,12,295,1,Alamance,2022-01-15
26,244,53,191,1,Alamance,2021-12-31
37,504,53,451,1,Alamance,2022-01-24
53,588,54,534,1,Alamance,2022-01-14
69,742,89,653,1,Alamance,2022-01-04
71,673,90,583,1,Alamance,2022-01-03
,0,0,0,1,Alexander,2022-04-16
0,17,7,10,1,Alexander,2021-12-24
0,7,3,4,1,Alexander,2022-01-16
0,6,0,6,1,Alexander,2022-02-24
0,5,2,3,1,Alexander,2022-03-01
0,5,0,5,1,Alexander,2022-06-01
1,13,6,7,1,Alexander,2022-02-06
1,20,12,8,1,Alexander,2022-02-21
2,28,2,26,1,Alexander,2022-02-09
2,28,6,22,1,Alexander,2022-02-10
2,20,7,13,1,Alexander,2022-02-16
2,14,6,8,1,Alexander,2022-02-18
3,8,3,5,1,Alexander,2022-05-18
4,43,12,31,1,Alexander,2022-02-03
8,50,26,24,1,Alexander,2022-01-23
10,88,23,65,1,Alexander,2022-01-26
16,122,47,75,1,Alexander,2022-01-18
,0,0,0,1,Alleghany,2022-03-18
0,20,6,14,1,Alleghany,2021-12-28
0,14,4,10,1,Alleghany,2021-12-29
0,12,6,6,1,Alleghany,2021-12-31
0,6,2,4,1,Alleghany,2022-01-03
2,34,7,27,1,Alleghany,2022-01-13
7,38,10,28,1,Alleghany,2022-01-04
,0,0,0,1,Anson,2022-03-05
0,4,1,3,1,Anson,2021-12-14
0,9,1,8,1,Anson,2021-12-23
0,13,4,9,1,Anson,2022-02-03
0,5,2,3,1,Anson,2022-02-13
0,12,3,9,1,Anson,2022-02-16
0,1,1,0,1,Anson,2022-03-21
1,19,5,14,1,Anson,2022-02-10
1,6,0,6,1,Anson,2022-02-23
2,15,2,13,1,Anson,2022-02-06
2,28,6,22,1,Anson,2022-02-08
3,25,6,19,1,Anson,2022-01-02
3,18,8,10,1,Anson,2022-01-30
3,13,2,11,1,Anson,2022-02-09
3,7,2,5,1,Anson,2022-02-20
6,24,4,20,1,Anson,2022-01-09
8,68,16,52,1,Anson,2022-01-20
9,110,31,79,1,Anson,2022-01-19
,0,0,0,1,Ashe,2022-02-26
,0,0,0,1,Ashe,2022-04-23
,0,0,0,1,Ashe,2022-05-01
0,15,7,8,1,Ashe,2021-12-16
0,9,4,5,1,Ashe,2022-02-24
0,6,2,4,1,Ashe,2022-03-04
0,2,1,1,1,Ashe,2022-05-16
1,2,1,1,1,Ashe,2022-01-01
1,70,31,39,1,Ashe,2022-01-21
1,13,6,7,1,Ashe,2022-01-22
1,18,9,9,1,Ashe,2022-02-16
1,2,2,0,1,Ashe,2022-04-22
1,5,3,2,1,Ashe,2022-04-25
2,3,1,2,1,Ashe,2022-03-10
3,56,17,39,1,Ashe,2022-01-06
3,39,12,27,1,Ashe,2022-02-01
3,10,7,3,1,Ashe,2022-02-06
4,25,8,17,1,Ashe,2022-02-11
4,31,12,19,1,Ashe,2022-02-21
6,74,30,44,1,Ashe,2022-01-12
7,87,29,58,1,Ashe,2022-01-20
7,82,38,44,1,Ashe,2022-01-31
8,58,22,36,1,Ashe,2022-01-11
10,112,32,80,1,Ashe,2022-01-19
14,92,50,42,1,Ashe,2022-01-14
0,6,0,6,1,Avery,2022-02-06
0,6,2,4,1,Avery,2022-02-20
0,5,1,4,1,Avery,2022-03-04
0,2,0,2,1,Avery,2022-04-26
0,5,0,5,1,Avery,2022-04-29
1,4,4,0,1,Avery,2022-03-22
,0,0,0,1,Beaufort,2022-03-31
0,7,0,7,1,Beaufort,2022-02-13
0,5,1,4,1,Beaufort,2022-02-20
0,2,0,2,1,Beaufort,2022-02-27
0,6,0,6,1,Beaufort,2022-03-01
0,2,0,2,1,Beaufort,2022-03-04
0,3,1,2,1,Beaufort,2022-04-11
1,17,2,15,1,Beaufort,2021-12-22
1,50,7,43,1,Beaufort,2022-02-04
1,12,0,12,1,Beaufort,2022-02-06
1,15,2,13,1,Beaufort,2022-02-23
1,10,1,9,1,Beaufort,2022-02-25
1,5,0,5,1,Beaufort,2022-02-26
1,3,0,3,1,Beaufort,2022-03-08
2,17,4,13,1,Beaufort,2021-12-17
2,18,1,17,1,Beaufort,2022-01-30
4,19,5,14,1,Beaufort,2022-02-18
5,20,5,15,1,Beaufort,2022-01-21
5,41,8,33,1,Beaufort,2022-02-08
5,27,1,26,1,Beaufort,2022-02-17
6,43,2,41,1,Beaufort,2022-01-09
6,82,14,68,1,Beaufort,2022-01-27
7,65,12,53,1,Beaufort,2022-01-28
7,32,4,28,1,Beaufort,2022-02-10
13,132,11,121,1,Beaufort,2022-01-06
20,212,40,172,1,Beaufort,2022-01-19
33,339,34,305,1,Beaufort,2022-01-18
0,11,0,11,1,Bertie,2022-01-21
0,1,0,1,1,Bertie,2022-03-11
1,19,4,15,1,Bertie,2022-01-26
1,2,1,1,1,Bertie,2022-02-06
1,7,2,5,1,Bertie,2022-06-01
2,7,0,7,1,Bertie,2022-01-23
3,20,2,18,1,Bertie,2022-01-28
5,78,4,74,1,Bertie,2022-01-10
5,41,5,36,1,Bertie,2022-01-14
7,26,1,25,1,Bertie,2022-01-31
0,8,1,7,1,Bladen,2021-12-14
0,3,0,3,1,Bladen,2021-12-25
0,11,3,8,1,Bladen,2021-12-26
0,17,6,11,1,Bladen,2022-01-30
0,3,0,3,1,Bladen,2022-02-05
0,3,0,3,1,Bladen,2022-02-25
0,4,0,4,1,Bladen,2022-02-28
0,3,1,2,1,Bladen,2022-03-08
0,3,0,3,1,Bladen,2022-03-10
0,4,1,3,1,Bladen,2022-03-12
1,15,3,12,1,Bladen,2022-01-01
1,25,4,21,1,Bladen,2022-02-04
1,10,1,9,1,Bladen,2022-02-06
1,15,2,13,1,Bladen,2022-02-09
1,18,5,13,1,Bladen,2022-02-11
2,33,3,30,1,Bladen,2022-01-08
2,30,7,23,1,Bladen,2022-02-03
2,23,10,13,1,Bladen,2022-02-07
2,6,2,4,1,Bladen,2022-04-25
3,88,18,70,1,Bladen,2022-01-25
3,47,10,37,1,Bladen,2022-01-28
5,18,2,16,1,Bladen,2022-05-27
6,116,14,102,1,Bladen,2022-01-14
17,162,31,131,1,Bladen,2022-01-24
18,171,37,134,1,Bladen,2022-01-19
0,41,3,38,1,Brunswick,2021-12-18
0,28,4,24,1,Brunswick,2022-02-13
0,37,5,32,1,Brunswick,2022-02-18
0,7,0,7,1,Brunswick,2022-03-03
0,3,1,2,1,Brunswick,2022-03-10
0,5,2,3,1,Brunswick,2022-03-13
0,4,2,2,1,Brunswick,2022-03-25
0,9,0,9,1,Brunswick,2022-04-08
1,33,4,29,1,Brunswick,2022-02-12
1,21,4,17,1,Brunswick,2022-02-24
1,26,4,22,1,Brunswick,2022-02-25
1,6,1,5,1,Brunswick,2022-03-05
1,14,3,11,1,Brunswick,2022-03-17
1,10,0,10,1,Brunswick,2022-03-18
1,17,3,14,1,Brunswick,2022-04-12
1,50,11,39,1,Brunswick,2022-05-26
2,76,19,57,1,Brunswick,2021-12-20
3,51,7,44,1,Brunswick,2021-12-26
4,48,5,43,1,Brunswick,2022-02-16
5,109,20,89,1,Brunswick,2022-02-09
6,60,9,51,1,Brunswick,2022-05-09
8,159,18,141,1,Brunswick,2022-01-16
8,49,6,43,1,Brunswick,2022-05-12
10,131,20,111,1,Brunswick,2022-01-02
11,182,25,157,1,Brunswick,2022-01-09
12,240,58,182,1,Brunswick,2022-01-27
13,165,16,149,1,Brunswick,2022-01-08
14,169,26,143,1,Brunswick,2022-01-28
14,253,34,219,1,Brunswick,2022-01-31
19,340,71,269,1,Brunswick,2022-01-04
20,216,47,169,1,Brunswick,2021-12-30
20,331,43,288,1,Brunswick,2022-01-03
22,487,61,426,1,Brunswick,2022-01-18
33,456,60,396,1,Brunswick,2022-01-11
0,49,16,33,1,Buncombe,2022-02-28
0,9,4,5,1,Buncombe,2022-03-13
0,11,0,11,1,Buncombe,2022-03-15
0,7,1,6,1,Buncombe,2022-03-25
0,21,7,14,1,Buncombe,2022-03-29
0,8,1,7,1,Buncombe,2022-04-03
1,38,9,29,1,Buncombe,2022-03-03
1,26,6,20,1,Buncombe,2022-03-14
1,15,8,7,1,Buncombe,2022-03-30
1,32,6,26,1,Buncombe,2022-04-06
1,45,12,33,1,Buncombe,2022-04-22
2,60,22,38,1,Buncombe,2021-12-19
2,20,4,16,1,Buncombe,2022-02-26
2,21,10,11,1,Buncombe,2022-03-08
2,16,7,9,1,Buncombe,2022-03-16
2,11,2,9,1,Buncombe,2022-03-26
3,19,10,9,1,Buncombe,2022-03-10
4,112,56,56,1,Buncombe,2021-12-14
4,106,29,77,1,Buncombe,2022-02-06
4,76,26,50,1,Buncombe,2022-02-12
4,25,12,13,1,Buncombe,2022-04-07
5,205,61,144,1,Buncombe,2021-12-23
5,82,34,48,1,Buncombe,2022-05-06
6,134,24,110,1,Buncombe,2022-01-01
6,69,19,50,1,Buncombe,2022-02-24
6,62,28,34,1,Buncombe,2022-04-19
6,67,20,47,1,Buncombe,2022-05-21
7,96,42,54,1,Buncombe,2022-02-17
8,123,40,83,1,Buncombe,2022-02-11
11,213,48,165,1,Buncombe,2022-01-23
11,155,56,99,1,Buncombe,2022-02-10
12,147,57,90,1,Buncombe,2022-05-12
14,148,58,90,1,Buncombe,2022-05-18
16,132,54,78,1,Buncombe,2022-05-24
18,429,88,341,1,Buncombe,2021-12-29
19,278,91,187,1,Buncombe,2022-02-01
20,182,51,131,1,Buncombe,2022-01-17
22,374,112,262,1,Buncombe,2022-01-27
29,447,110,337,1,Buncombe,2021-12-30
30,440,85,355,1,Buncombe,2021-12-28
30,560,151,409,1,Buncombe,2022-01-03
33,584,150,434,1,Buncombe,2022-01-07
37,610,164,446,1,Buncombe,2022-01-19
42,735,223,512,1,Buncombe,2022-01-12
44,576,163,413,1,Buncombe,2022-01-18
50,630,180,450,1,Buncombe,2022-01-14
,0,0,0,1,Burke,2022-03-12
0,3,0,3,1,Burke,2021-12-25
0,13,1,12,1,Burke,2022-02-19
0,8,0,8,1,Burke,2022-02-20
0,8,1,7,1,Burke,2022-02-26
0,12,4,8,1,Burke,2022-03-09
0,4,1,3,1,Burke,2022-03-14
0,1,0,1,1,Burke,2022-03-19
0,4,1,3,1,Burke,2022-04-05
0,8,2,6,1,Burke,2022-04-14
0,1,1,0,1,Burke,2022-04-30
1,21,2,19,1,Burke,2022-02-23
1,17,7,10,1,Burke,2022-02-28
1,3,2,1,1,Burke,2022-03-22
2,8,3,5,1,Burke,2022-04-18
2,17,8,9,1,Burke,2022-05-10
3,35,10,25,1,Burke,2022-01-30
3,25,4,21,1,Burke,2022-02-13
3,47,17,30,1,Burke,2022-02-16
4,134,19,115,1,Burke,2021-12-28
4,75,35,40,1,Burke,2022-01-22
4,35,10,25,1,Burke,2022-02-05
5,63,21,42,1,Burke,2022-01-23
5,57,16,41,1,Burke,2022-02-15
5,39,12,27,1,Burke,2022-02-21
7,92,31,61,1,Burke,2022-02-10
8,92,36,56,1,Burke,2022-02-09
10,148,56,92,1,Burke,2022-01-15
11,120,42,78,1,Burke,2022-01-08
12,114,44,70,1,Burke,2022-02-01
12,127,36,91,1,Burke,2022-02-02
13,239,113,126,1,Burke,2022-01-25
15,181,79,102,1,Burke,2022-01-31
16,213,60,153,1,Burke,2022-01-26
17,224,71,153,1,Burke,2022-01-03
20,231,69,162,1,Burke,2022-01-18
26,242,53,189,1,Burke,2022-01-05
29,324,97,227,1,Burke,2022-01-19
33,371,117,254,1,Burke,2022-01-13
36,425,144,281,1,Burke,2022-01-11
45,470,164,306,1,Burke,2022-01-10
0,2,0,2,1,Cabarrus,2022-03-06
0,7,1,6,1,Cabarrus,2022-03-17
0,13,4,9,1,Cabarrus,2022-04-07
0,25,7,18,1,Cabarrus,2022-04-30
1,106,25,81,1,Cabarrus,2021-12-15
1,22,5,17,1,Cabarrus,2022-02-24
1,16,10,6,1,Cabarrus,2022-02-27
1,20,3,17,1,Cabarrus,2022-02-28
1,4,1,3,1,Cabarrus,2022-04-02
2,47,15,32,1,Cabarrus,2022-02-21
2,9,3,6,1,Cabarrus,2022-03-07
2,13,5,8,1,Cabarrus,2022-03-10
2,35,7,28,1,Cabarrus,2022-04-26
3,65,15,50,1,Cabarrus,2022-02-18
4,46,13,33,1,Cabarrus,2022-01-16
4,68,15,53,1,Cabarrus,2022-02-06
4,89,25,64,1,Cabarrus,2022-02-14
7,102,22,80,1,Cabarrus,2022-01-30
8,136,33,103,1,Cabarrus,2022-02-08
10,163,58,105,1,Cabarrus,2021-12-26
10,132,44,88,1,Cabarrus,2022-01-01
11,94,17,77,1,Cabarrus,2022-05-17
16,138,27,111,1,Cabarrus,2022-02-07
20,286,87,199,1,Cabarrus,2022-01-08
27,346,90,256,1,Cabarrus,2022-01-26
39,537,95,442,1,Cabarrus,2021-12-28
41,552,150,402,1,Cabarrus,2022-01-07
56,694,257,437,1,Cabarrus,2022-01-18
57,669,152,517,1,Cabarrus,2022-01-13
,0,0,0,1,Caldwell,2022-03-31
0,35,8,27,1,Caldwell,2021-12-16
0,3,0,3,1,Caldwell,2022-03-18
0,2,0,2,1,Caldwell,2022-03-23
1,34,5,29,1,Caldwell,2021-12-15
1,3,0,3,1,Caldwell,2022-03-05
2,22,4,18,1,Caldwell,2021-12-24
2,27,4,23,1,Caldwell,2022-02-13
2,8,2,6,1,Caldwell,2022-02-19
2,26,5,21,1,Caldwell,2022-02-21
2,13,2,11,1,Caldwell,2022-03-01
3,52,12,40,1,Caldwell,2022-02-09
3,38,8,30,1,Caldwell,2022-02-22
3,9,0,9,1,Caldwell,2022-02-27
4,94,20,74,1,Caldwell,2022-01-09
4,57,12,45,1,Caldwell,2022-01-30
5,69,5,64,1,Caldwell,2022-01-29
7,46,7,39,1,Caldwell,2022-02-15
8,44,11,33,1,Caldwell,2022-02-10
10,151,26,125,1,Caldwell,2022-01-25
11,108,19,89,1,Caldwell,2021-12-27
11,60,23,37,1,Caldwell,2022-01-17
12,139,22,117,1,Caldwell,2021-12-29
12,182,17,165,1,Caldwell,2022-01-18
12,96,22,74,1,Caldwell,2022-02-03
14,118,14,104,1,Caldwell,2022-01-26
15,205,48,157,1,Caldwell,2022-01-06
17,157,48,109,1,Caldwell,2022-01-24
22,214,36,178,1,Caldwell,2022-01-03
33,266,46,220,1,Caldwell,2022-01-21
37,315,65,250,1,Caldwell,2022-01-19
43,349,89,260,1,Caldwell,2022-01-12
,0,0,0,1,Carteret,2022-03-31
0,20,6,14,1,Carteret,2021-12-14
0,51,11,40,1,Carteret,2022-01-23
0,30,6,24,1,Carteret,2022-01-29
0,3,0,3,1,Carteret,2022-02-25
0,9,5,4,1,Carteret,2022-04-28
1,34,9,25,1,Carteret,2021-12-23
1,59,22,37,1,Carteret,2022-02-03
1,30,15,15,1,Carteret,2022-02-11
1,17,4,13,1,Carteret,2022-02-12
1,27,10,17,1,Carteret,2022-02-14
1,6,2,4,1,Carteret,2022-02-26
1,6,3,3,1,Carteret,2022-03-03
1,7,3,4,1,Carteret,2022-03-09
1,2,0,2,1,Carteret,2022-04-18
2,106,37,69,1,Carteret,2022-01-03
2,18,1,17,1,Carteret,2022-02-13
2,11,3,8,1,Carteret,2022-02-17
2,20,11,9,1,Carteret,2022-02-21
3,78,23,55,1,Carteret,2022-02-02
4,63,22,41,1,Carteret,2022-02-04
7,202,82,120,1,Carteret,2022-01-11
15,233,107,126,1,Carteret,2022-01-17
17,198,78,120,1,Carteret,2022-01-12
,0,0,0,1,Caswell,2022-02-20
0,13,1,12,1,Caswell,2022-01-22
0,2,2,0,1,Caswell,2022-02-12
0,12,0,12,1,Caswell,2022-02-14
0,6,1,5,1,Caswell,2022-02-18
0,2,0,2,1,Caswell,2022-02-22
0,3,0,3,1,Caswell,2022-03-02
1,3,0,3,1,Caswell,2022-02-16
2,22,1,21,1,Caswell,2022-02-01
4,84,12,72,1,Caswell,2022-01-20
0,8,2,6,1,Catawba,2022-03-15
0,3,1,2,1,Catawba,2022-03-22
0,3,1,2,1,Catawba,2022-03-29
0,5,1,4,1,Catawba,2022-03-30
0,5,0,5,1,Catawba,2022-04-01
1,2,0,2,1,Catawba,2022-03-26
2,62,17,45,1,Catawba,2021-12-17
2,12,5,7,1,Catawba,2022-04-13
2,19,5,14,1,Catawba,2022-04-20
3,56,22,34,1,Catawba,2022-02-06
3,38,14,24,1,Catawba,2022-02-13
3,43,20,23,1,Catawba,2022-02-28
3,26,5,21,1,Catawba,2022-06-05
4,26,9,17,1,Catawba,2021-12-25
4,79,34,45,1,Catawba,2022-02-11
4,25,9,16,1,Catawba,2022-02-20
7,90,43,47,1,Catawba,2022-01-01
8,46,15,31,1,Catawba,2022-02-22
10,60,26,34,1,Catawba,2022-05-25
12,168,41,127,1,Catawba,2022-01-09
12,125,38,87,1,Catawba,2022-01-29
14,105,49,56,1,Catawba,2022-02-15
18,179,65,114,1,Catawba,2022-02-07
22,180,68,112,1,Catawba,2022-02-03
24,176,76,100,1,Catawba,2022-02-04
34,315,78,237,1,Catawba,2021-12-28
34,326,137,189,1,Catawba,2022-01-31
42,330,107,223,1,Catawba,2021-12-30
48,490,182,308,1,Catawba,2022-01-06
50,687,263,424,1,Catawba,2022-01-11
0,19,5,14,1,Chatham,2022-02-05
0,20,2,18,1,Chatham,2022-06-10
1,28,3,25,1,Chatham,2022-01-29
1,65,18,47,1,Chatham,2022-02-01
1,32,5,27,1,Chatham,2022-02-09
1,18,0,18,1,Chatham,2022-02-15
1,17,7,10,1,Chatham,2022-02-16
1,2,0,2,1,Chatham,2022-03-29
1,5,0,5,1,Chatham,2022-03-30
1,29,5,24,1,Chatham,2022-06-02
2,59,0,59,1,Chatham,2021-12-22
2,70,13,57,1,Chatham,2022-01-28
2,15,2,13,1,Chatham,2022-02-18
4,71,11,60,1,Chatham,2022-01-21
7,213,17,196,1,Chatham,2022-01-13
8,167,26,141,1,Chatham,2022-01-14
,0,0,0,1,Cherokee,2022-03-06
,0,0,0,1,Cherokee,2022-03-12
,0,0,0,1,Cherokee,2022-03-16
,0,0,0,1,Cherokee,2022-03-30
0,25,1,24,1,Cherokee,2022-01-15
0,7,0,7,1,Cherokee,2022-02-12
0,10,4,6,1,Cherokee,2022-02-17
0,3,1,2,1,Cherokee,2022-02-25
0,2,0,2,1,Cherokee,2022-03-04
0,1,0,1,1,Cherokee,2022-03-18
1,5,0,5,1,Cherokee,2022-02-06
1,6,2,4,1,Cherokee,2022-02-20
2,35,4,31,1,Cherokee,2021-12-28
2,48,9,39,1,Cherokee,2022-01-21
2,23,2,21,1,Cherokee,2022-02-03
3,62,15,47,1,Cherokee,2022-01-13
3,29,8,21,1,Cherokee,2022-01-23
4,74,19,55,1,Cherokee,2022-01-31
6,49,12,37,1,Cherokee,2022-01-07
6,33,10,23,1,Cherokee,2022-01-17
7,108,29,79,1,Cherokee,2022-01-20
,0,0,0,1,Chowan,2022-02-15
,0,0,0,1,Chowan,2022-03-03
0,5,0,5,1,Chowan,2022-01-29
0,2,0,2,1,Chowan,2022-02-24
0,2,1,1,1,Chowan,2022-03-10
1,4,0,4,1,Chowan,2022-02-06
2,49,0,49,1,Chowan,2022-01-25
2,13,0,13,1,Chowan,2022-02-02
2,12,0,12,1,Chowan,2022-02-07
3,22,0,22,1,Chowan,2022-01-08
4,32,2,30,1,Chowan,2021-12-28
5,18,0,18,1,Chowan,2022-01-28
10,73,6,67,1,Chowan,2022-01-14
11,96,6,90,1,Chowan,2022-01-10
14,67,6,61,1,Chowan,2022-01-20
,0,0,0,1,Clay,2022-04-02
,0,0,0,1,Clay,2022-05-04
0,6,2,4,1,Clay,2022-01-23
0,15,1,14,1,Clay,2022-02-02
0,7,1,6,1,Clay,2022-02-21
2,16,0,16,1,Clay,2022-01-09
2,6,2,4,1,Clay,2022-02-05
3,16,5,11,1,Clay,2022-02-03
0,12,0,12,1,Cleveland,2021-12-25
0,3,0,3,1,Cleveland,2022-03-12
0,1,0,1,1,Cleveland,2022-03-15
0,1,0,1,1,Cleveland,2022-03-18
0,2,0,2,1,Cleveland,2022-03-26
1,14,2,12,1,Cleveland,2022-02-19
1,7,3,4,1,Cleveland,2022-02-27
1,2,0,2,1,Cleveland,2022-03-06
1,2,1,1,1,Cleveland,2022-03-17
2,36,1,35,1,Cleveland,2021-12-26
2,24,3,21,1,Cleveland,2022-02-13
3,14,2,12,1,Cleveland,2022-01-16
3,36,3,33,1,Cleveland,2022-02-12
3,10,5,5,1,Cleveland,2022-02-20
4,37,8,29,1,Cleveland,2022-02-17
4,16,5,11,1,Cleveland,2022-05-24
5,30,8,22,1,Cleveland,2022-06-10
6,46,3,43,1,Cleveland,2022-02-06
8,97,27,70,1,Cleveland,2022-01-22
9,81,14,67,1,Cleveland,2022-02-04
16,144,20,124,1,Cleveland,2022-02-01
17,233,45,188,1,Cleveland,2022-01-15
18,241,35,206,1,Cleveland,2022-01-25
20,157,19,138,1,Cleveland,2022-01-31
28,307,62,245,1,Cleveland,2022-01-07
36,353,67,286,1,Cleveland,2022-01-06
42,399,56,343,1,Cleveland,2022-01-11
43,304,73,231,1,Cleveland,2022-01-04
45,329,82,247,1,Cleveland,2022-01-18
,0,0,0,1,Columbus,2022-02-19
,0,0,0,1,Columbus,2022-03-12
0,14,4,10,1,Columbus,2021-12-14
0,2,1,1,1,Columbus,2022-03-31
0,3,1,2,1,Columbus,2022-04-20
1,61,8,53,1,Columbus,2021-12-27
1,25,8,17,1,Columbus,2022-01-23
1,8,4,4,1,Columbus,2022-02-06
2,20,10,10,1,Columbus,2022-02-11
2,14,3,11,1,Columbus,2022-02-15
2,10,3,7,1,Columbus,2022-02-17
3,56,15,41,1,Columbus,2022-02-04
4,25,13,12,1,Columbus,2022-01-22
4,93,37,56,1,Columbus,2022-01-27
4,59,23,36,1,Columbus,2022-02-02
5,21,9,12,1,Columbus,2022-02-10
8,104,29,75,1,Columbus,2022-01-28
9,217,42,175,1,Columbus,2022-01-14
12,136,49,87,1,Columbus,2022-01-25
21,129,60,69,1,Columbus,2022-01-31
30,341,196,145,1,Columbus,2022-01-10
57,205,81,124,1,Columbus,2022-01-06
0,2,0,2,1,Craven,2022-03-12
0,6,1,5,1,Craven,2022-03-14
0,2,2,0,1,Craven,2022-03-20
1,18,5,13,1,Craven,2021-12-19
1,13,6,7,1,Craven,2022-03-02
1,9,3,6,1,Craven,2022-03-09
1,5,4,1,1,Craven,2022-03-21
1,10,3,7,1,Craven,2022-04-23
1,36,12,24,1,Craven,2022-06-10
2,41,13,28,1,Craven,2022-02-06
2,19,6,13,1,Craven,2022-02-12
3,35,8,27,1,Craven,2022-01-01
3,19,5,14,1,Craven,2022-02-13
3,16,5,11,1,Craven,2022-02-19
4,86,24,62,1,Craven,2022-01-23
4,38,10,28,1,Craven,2022-02-18
5,68,19,49,1,Craven,2022-01-29
7,109,27,82,1,Craven,2022-02-04
9,169,47,122,1,Craven,2022-01-27
9,140,47,93,1,Craven,2022-02-07
10,72,33,39,1,Craven,2022-01-30
13,255,66,189,1,Craven,2022-01-26
15,132,63,69,1,Craven,2022-01-16
23,266,71,195,1,Craven,2022-01-04
0,25,8,17,1,Cumberland,2022-02-26
0,32,8,24,1,Cumberland,2022-03-16
0,7,2,5,1,Cumberland,2022-03-19
0,17,5,12,1,Cumberland,2022-03-21
0,16,3,13,1,Cumberland,2022-03-28
1,11,3,8,1,Cumberland,2022-02-27
1,25,3,22,1,Cumberland,2022-03-15
2,36,7,29,1,Cumberland,2022-03-02
3,26,12,14,1,Cumberland,2022-04-11
6,58,12,46,1,Cumberland,2022-02-24
6,80,11,69,1,Cumberland,2022-02-28
10,176,17,159,1,Cumberland,2021-12-24
12,65,11,54,1,Cumberland,2022-04-28
16,354,36,318,1,Cumberland,2022-01-02
16,292,72,220,1,Cumberland,2022-02-08
18,229,57,172,1,Cumberland,2022-02-09
21,182,45,137,1,Cumberland,2022-05-16
24,461,26,435,1,Cumberland,2022-01-09
53,682,98,584,1,Cumberland,2022-01-31
68,944,123,821,1,Cumberland,2021-12-30
99,1187,191,996,1,Cumberland,2022-01-12
109,1427,129,1298,1,Cumberland,2022-01-03
,0,0,0,1,Currituck,2022-02-24
,0,0,0,1,Currituck,2022-03-04
0,34,5,29,1,Currituck,2021-12-30
0,30,7,23,1,Currituck,2022-02-02
0,10,2,8,1,Currituck,2022-02-16
0,1,0,1,1,Currituck,2022-03-22
1,19,4,15,1,Currituck,2021-12-22
1,7,0,7,1,Currituck,2021-12-24
5,73,5,68,1,Currituck,2022-01-11
1,20,0,20,1,Dare,2022-02-03
0,7,1,6,1,Davidson,2022-02-27
0,10,3,7,1,Davidson,2022-03-04
1,84,9,75,1,Davidson,2021-12-15
1,13,0,13,1,Davidson,2022-02-26
1,12,4,8,1,Davidson,2022-03-08
1,6,0,6,1,Davidson,2022-03-16
2,50,2,48,1,Davidson,2022-02-05
2,15,1,14,1,Davidson,2022-02-19
3,81,7,74,1,Davidson,2021-12-17
3,27,7,20,1,Davidson,2022-05-04
4,45,8,37,1,Davidson,2022-02-22
5,129,12,117,1,Davidson,2022-01-01
5,75,10,65,1,Davidson,2022-02-10
6,85,5,80,1,Davidson,2022-01-30
6,66,22,44,1,Davidson,2022-05-25
7,57,11,46,1,Davidson,2022-02-11
9,55,9,46,1,Davidson,2022-02-15
10,48,15,33,1,Davidson,2022-06-10
14,187,25,162,1,Davidson,2021-12-31
18,235,36,199,1,Davidson,2022-01-27
23,310,39,271,1,Davidson,2022-01-26
26,315,36,279,1,Davidson,2021-12-28
28,300,58,242,1,Davidson,2021-12-30
34,413,40,373,1,Davidson,2022-01-21
43,463,70,393,1,Davidson,2022-01-06
49,573,112,461,1,Davidson,2022-01-10
51,539,56,483,1,Davidson,2022-01-24
58,470,56,414,1,Davidson,2022-01-04
59,543,73,470,1,Davidson,2022-01-20
69,662,79,583,1,Davidson,2022-01-11
0,37,4,33,1,Davie,2022-01-02
0,4,1,3,1,Davie,2022-03-17
0,1,0,1,1,Davie,2022-03-19
1,22,4,18,1,Davie,2022-02-15
1,12,2,10,1,Davie,2022-02-25
1,8,5,3,1,Davie,2022-04-28
2,6,3,3,1,Davie,2022-02-13
2,12,4,8,1,Davie,2022-02-21
2,5,2,3,1,Davie,2022-03-07
2,9,5,4,1,Davie,2022-04-21
2,4,1,3,1,Davie,2022-04-23
2,4,2,2,1,Davie,2022-04-24
3,39,12,27,1,Davie,2022-02-04
4,64,16,48,1,Davie,2022-02-02
5,35,0,35,1,Davie,2022-01-08
5,19,1,18,1,Davie,2022-02-05
5,34,5,29,1,Davie,2022-02-08
7,69,13,56,1,Davie,2022-01-28
8,113,11,102,1,Davie,2022-01-06
,0,0,0,1,Duplin,2022-02-26
,0,0,0,1,Duplin,2022-03-11
0,2,0,2,1,Duplin,2021-12-25
0,9,0,9,1,Duplin,2022-02-13
0,5,1,4,1,Duplin,2022-02-20
0,10,5,5,1,Duplin,2022-02-25
0,2,0,2,1,Duplin,2022-03-04
0,3,0,3,1,Duplin,2022-03-15
0,2,0,2,1,Duplin,2022-03-16
0,2,2,0,1,Duplin,2022-03-18
0,2,2,0,1,Duplin,2022-03-28
0,3,2,1,1,Duplin,2022-05-09
0,9,3,6,1,Duplin,2022-05-17
1,22,8,14,1,Duplin,2021-12-23
1,16,4,12,1,Duplin,2022-01-22
1,38,13,25,1,Duplin,2022-02-04
1,11,3,8,1,Duplin,2022-02-12
1,5,1,4,1,Duplin,2022-03-05
2,49,19,30,1,Duplin,2022-01-16
2,8,3,5,1,Duplin,2022-02-19
3,22,13,9,1,Duplin,2022-02-10
3,13,4,9,1,Duplin,2022-05-25
4,68,20,48,1,Duplin,2022-02-02
5,42,8,34,1,Duplin,2022-01-23
6,54,28,26,1,Duplin,2022-02-07
7,86,31,55,1,Duplin,2022-01-09
10,110,42,68,1,Duplin,2022-01-27
21,226,114,112,1,Duplin,2022-01-17
32,415,165,250,1,Duplin,2022-01-10
33,255,117,138,1,Duplin,2022-01-20
40,322,132,190,1,Duplin,2022-01-12
0,8,1,7,1,Durham,2022-03-05
0,15,1,14,1,Durham,2022-03-18
0,12,1,11,1,Durham,2022-03-26
1,73,6,67,1,Durham,2021-12-14
1,50,2,48,1,Durham,2022-02-19
1,10,1,9,1,Durham,2022-03-19
2,45,0,45,1,Durham,2022-03-03
2,33,2,31,1,Durham,2022-03-09
2,24,2,22,1,Durham,2022-03-17
2,44,9,35,1,Durham,2022-03-29
3,72,6,66,1,Durham,2022-02-12
3,62,2,60,1,Durham,2022-04-06
4,123,6,117,1,Durham,2022-02-06
4,79,7,72,1,Durham,2022-02-21
5,122,5,117,1,Durham,2022-02-16
5,69,4,65,1,Durham,2022-02-22
5,70,3,67,1,Durham,2022-04-07
6,138,7,131,1,Durham,2022-02-05
6,99,4,95,1,Durham,2022-02-15
7,138,8,130,1,Durham,2022-04-18
8,115,7,108,1,Durham,2022-01-16
9,191,14,177,1,Durham,2022-01-30
9,115,15,100,1,Durham,2022-04-14
10,227,29,198,1,Durham,2022-02-07
11,197,3,194,1,Durham,2022-02-04
17,299,19,280,1,Durham,2022-02-02
17,278,32,246,1,Durham,2022-02-03
23,347,19,328,1,Durham,2022-02-01
38,485,47,438,1,Durham,2022-01-31
47,773,37,736,1,Durham,2022-01-24
66,1038,52,986,1,Durham,2022-01-19
70,1304,93,1211,1,Durham,2022-01-18
75,1203,74,1129,1,Durham,2022-01-03
96,1392,77,1315,1,Durham,2022-01-10
,0,0,0,1,Edgecombe,2022-04-15
0,20,1,19,1,Edgecombe,2022-02-03
0,6,1,5,1,Edgecombe,2022-02-25
2,39,2,37,1,Edgecombe,2022-02-01
2,21,1,20,1,Edgecombe,2022-02-08
2,18,4,14,1,Edgecombe,2022-02-21
2,4,0,4,1,Edgecombe,2022-04-27
3,46,1,45,1,Edgecombe,2022-01-09
3,27,2,25,1,Edgecombe,2022-02-07
7,66,3,63,1,Edgecombe,2022-01-25
12,167,10,157,1,Edgecombe,2022-01-14
18,208,4,204,1,Edgecombe,2022-01-11
18,197,15,182,1,Edgecombe,2022-01-13
33,258,5,253,1,Edgecombe,2021-12-30
0,11,3,8,1,Forsyth,2022-03-08
0,23,2,21,1,Forsyth,2022-03-21
1,20,2,18,1,Forsyth,2022-02-27
1,25,9,16,1,Forsyth,2022-03-09
1,15,3,12,1,Forsyth,2022-03-11
2,32,4,28,1,Forsyth,2022-03-02
2,32,5,27,1,Forsyth,2022-03-07
2,24,7,17,1,Forsyth,2022-03-17
2,22,7,15,1,Forsyth,2022-03-23
3,43,13,30,1,Forsyth,2022-02-28
3,19,6,13,1,Forsyth,2022-03-12
3,19,2,17,1,Forsyth,2022-03-15
3,30,7,23,1,Forsyth,2022-03-30
5,34,12,22,1,Forsyth,2022-04-04
6,93,3,90,1,Forsyth,2021-12-25
7,219,18,201,1,Forsyth,2021-12-20
7,62,9,53,1,Forsyth,2022-02-13
7,56,7,49,1,Forsyth,2022-02-23
8,85,16,69,1,Forsyth,2022-02-21
9,106,16,90,1,Forsyth,2022-05-28
10,164,17,147,1,Forsyth,2021-12-24
13,280,24,256,1,Forsyth,2022-01-01
13,94,25,69,1,Forsyth,2022-02-17
14,236,46,190,1,Forsyth,2022-02-08
17,163,26,137,1,Forsyth,2022-06-07
18,304,34,270,1,Forsyth,2021-12-22
19,182,35,147,1,Forsyth,2022-05-16
22,202,45,157,1,Forsyth,2022-05-19
29,423,22,401,1,Forsyth,2022-01-02
61,802,72,730,1,Forsyth,2021-12-28
75,1049,99,950,1,Forsyth,2021-12-29
118,1498,135,1363,1,Forsyth,2022-01-12
,0,0,0,1,Franklin,2022-03-27
0,5,1,4,1,Franklin,2022-03-06
0,4,0,4,1,Franklin,2022-03-14
1,29,7,22,1,Franklin,2022-01-30
1,8,3,5,1,Franklin,2022-02-24
1,3,0,3,1,Franklin,2022-02-27
3,41,6,35,1,Franklin,2022-01-16
3,16,0,16,1,Franklin,2022-02-17
5,88,7,81,1,Franklin,2022-01-01
6,99,30,69,1,Franklin,2022-02-07
6,45,8,37,1,Franklin,2022-02-09
7,70,8,62,1,Franklin,2022-02-10
8,66,2,64,1,Franklin,2022-02-04
8,42,1,41,1,Franklin,2022-05-09
24,422,21,401,1,Franklin,2022-01-19
31,313,19,294,1,Franklin,2022-01-14
0,12,2,10,1,Gaston,2022-02-27
0,22,9,13,1,Gaston,2022-03-03
0,2,1,1,1,Gaston,2022-03-11
0,4,1,3,1,Gaston,2022-03-13
0,5,2,3,1,Gaston,2022-03-17
0,4,0,4,1,Gaston,2022-03-25
0,6,2,4,1,Gaston,2022-03-30
0,6,2,4,1,Gaston,2022-04-09
1,42,1,41,1,Gaston,2021-12-25
1,13,9,4,1,Gaston,2022-03-06
1,8,1,7,1,Gaston,2022-03-15
1,11,1,10,1,Gaston,2022-03-16
1,8,4,4,1,Gaston,2022-03-28
1,9,3,6,1,Gaston,2022-04-07
2,108,34,74,1,Gaston,2021-12-14
2,14,3,11,1,Gaston,2022-02-25
2,10,3,7,1,Gaston,2022-03-08
4,36,8,28,1,Gaston,2022-02-24
4,52,9,43,1,Gaston,2022-05-29
5,58,11,47,1,Gaston,2022-05-11
6,165,28,137,1,Gaston,2021-12-20
6,48,13,35,1,Gaston,2022-02-22
6,69,8,61,1,Gaston,2022-06-06
7,58,10,48,1,Gaston,2022-02-21
8,64,9,55,1,Gaston,2022-06-03
13,67,10,57,1,Gaston,2022-06-01
14,196,46,150,1,Gaston,2021-12-23
18,281,81,200,1,Gaston,2021-12-31
25,261,62,199,1,Gaston,2022-01-02
64,712,118,594,1,Gaston,2022-01-12
0,23,8,15,1,Gates,2022-01-14
,0,0,0,1,Graham,2022-03-24
1,13,9,4,1,Graham,2022-01-15
5,34,29,5,1,Graham,2022-01-10
0,11,4,7,1,Granville,2022-04-29
0,13,0,13,1,Granville,2022-05-15
1,27,8,19,1,Granville,2022-01-16
1,14,6,8,1,Granville,2022-05-03
2,34,1,33,1,Granville,2022-01-30
3,38,5,33,1,Granville,2022-02-14
11,59,1,58,1,Granville,2022-02-03
17,264,19,245,1,Granville,2022-01-18
0,14,5,9,1,Greene,2022-01-23
0,2,0,2,1,Greene,2022-02-13
0,5,2,3,1,Greene,2022-02-17
0,1,0,1,1,Greene,2022-02-25
0,4,1,3,1,Greene,2022-03-07
0,9,0,9,1,Greene,2022-06-07
1,48,17,31,1,Greene,2022-01-26
1,31,8,23,1,Greene,2022-02-07
1,6,0,6,1,Greene,2022-02-12
1,1,0,1,1,Greene,2022-02-23
12,97,41,56,1,Greene,2022-01-19
0,23,7,16,1,Guilford,2022-03-11
0,12,4,8,1,Guilford,2022-03-20
1,192,27,165,1,Guilford,2021-12-15
1,27,5,22,1,Guilford,2022-03-30
2,21,8,13,1,Guilford,2022-02-27
2,24,2,22,1,Guilford,2022-03-29
3,174,30,144,1,Guilford,2021-12-14
3,31,10,21,1,Guilford,2022-03-10
3,9,0,9,1,Guilford,2022-03-19
4,115,32,83,1,Guilford,2022-04-29
5,42,9,33,1,Guilford,2022-03-03
5,34,7,27,1,Guilford,2022-03-08
5,38,11,27,1,Guilford,2022-03-22
5,64,7,57,1,Guilford,2022-04-16
5,73,23,50,1,Guilford,2022-04-30
8,67,10,57,1,Guilford,2022-02-28
8,90,21,69,1,Guilford,2022-04-12
10,127,18,109,1,Guilford,2022-05-28
10,181,24,157,1,Guilford,2022-06-07
11,122,29,93,1,Guilford,2022-04-26
11,89,25,64,1,Guilford,2022-05-30
12,94,12,82,1,Guilford,2022-06-11
13,120,22,98,1,Guilford,2022-02-17
14,87,10,77,1,Guilford,2022-06-04
17,247,47,200,1,Guilford,2022-05-10
21,324,69,255,1,Guilford,2022-01-01
23,208,22,186,1,Guilford,2022-06-01
28,572,122,450,1,Guilford,2022-01-31
29,170,70,100,1,Guilford,2022-04-18
30,287,63,224,1,Guilford,2022-05-09
33,247,46,201,1,Guilford,2022-05-12
34,416,70,346,1,Guilford,2021-12-23
61,926,122,804,1,Guilford,2022-01-21
63,982,150,832,1,Guilford,2021-12-27
64,1157,153,1004,1,Guilford,2021-12-28
70,1141,74,1067,1,Guilford,2022-01-08
74,1250,265,985,1,Guilford,2021-12-30
74,812,209,603,1,Guilford,2021-12-31
79,1456,186,1270,1,Guilford,2022-01-19
,0,0,0,1,Halifax,2022-02-24
0,25,1,24,1,Halifax,2022-01-16
0,8,0,8,1,Halifax,2022-02-06
0,5,0,5,1,Halifax,2022-02-26
0,2,0,2,1,Halifax,2022-03-26
1,23,3,20,1,Halifax,2022-01-21
1,12,1,11,1,Halifax,2022-01-22
1,9,4,5,1,Halifax,2022-02-05
1,8,1,7,1,Halifax,2022-02-12
2,27,2,25,1,Halifax,2021-12-23
2,18,5,13,1,Halifax,2022-01-29
2,2,2,0,1,Halifax,2022-04-10
3,28,7,21,1,Halifax,2022-02-09
4,66,17,49,1,Halifax,2022-01-27
4,20,3,17,1,Halifax,2022-06-08
7,58,4,54,1,Halifax,2022-01-02
7,95,16,79,1,Halifax,2022-01-25
21,233,26,207,1,Halifax,2022-01-12
21,147,20,127,1,Halifax,2022-01-20
27,223,22,201,1,Halifax,2021-12-29
39,304,29,275,1,Halifax,2022-01-04
0,31,1,30,1,Harnett,2021-12-18
0,31,5,26,1,Harnett,2022-02-18
0,17,4,13,1,Harnett,2022-02-19
0,27,1,26,1,Harnett,2022-02-22
0,6,1,5,1,Harnett,2022-02-27
0,21,5,16,1,Harnett,2022-02-28
0,16,5,11,1,Harnett,2022-03-07
0,9,1,8,1,Harnett,2022-03-18
0,9,2,7,1,Harnett,2022-04-13
0,7,0,7,1,Harnett,2022-04-24
1,9,1,8,1,Harnett,2022-03-01
1,7,0,7,1,Harnett,2022-03-11
1,9,1,8,1,Harnett,2022-03-16
1,5,1,4,1,Harnett,2022-04-06
1,12,6,6,1,Harnett,2022-04-23
1,26,8,18,1,Harnett,2022-04-25
1,28,4,24,1,Harnett,2022-05-28
3,77,18,59,1,Harnett,2022-01-30
3,18,8,10,1,Harnett,2022-03-02
4,116,14,102,1,Harnett,2022-01-02
4,62,8,54,1,Harnett,2022-01-29
4,44,5,39,1,Harnett,2022-02-05
4,33,5,28,1,Harnett,2022-02-06
4,52,9,43,1,Harnett,2022-02-11
6,63,11,52,1,Harnett,2021-12-21
6,191,23,168,1,Harnett,2021-12-27
6,83,8,75,1,Harnett,2022-01-23
6,42,6,36,1,Harnett,2022-02-15
7,217,54,163,1,Harnett,2021-12-28
7,204,17,187,1,Harnett,2022-01-08
9,106,24,82,1,Harnett,2022-02-04
10,174,39,135,1,Harnett,2022-01-21
11,149,20,129,1,Harnett,2022-01-09
11,99,35,64,1,Harnett,2022-02-08
13,248,44,204,1,Harnett,2021-12-29
28,441,79,362,1,Harnett,2022-01-06
30,530,98,432,1,Harnett,2022-01-13
33,482,68,414,1,Harnett,2022-01-20
42,552,150,402,1,Harnett,2022-01-12
42,625,108,517,1,Harnett,2022-01-19
43,623,119,504,1,Harnett,2022-01-10
0,9,4,5,1,Haywood,2021-12-18
0,20,2,18,1,Haywood,2022-01-29
0,34,13,21,1,Haywood,2022-02-05
0,14,10,4,1,Haywood,2022-02-22
0,3,1,2,1,Haywood,2022-03-29
1,32,7,25,1,Haywood,2021-12-20
1,16,1,15,1,Haywood,2021-12-21
1,20,10,10,1,Haywood,2021-12-22
1,54,9,45,1,Haywood,2022-01-30
1,14,1,13,1,Haywood,2022-02-25
1,8,4,4,1,Haywood,2022-02-26
1,8,2,6,1,Haywood,2022-03-01
2,11,5,6,1,Haywood,2021-12-24
2,33,15,18,1,Haywood,2022-01-02
2,61,5,56,1,Haywood,2022-01-15
2,93,29,64,1,Haywood,2022-01-28
3,64,21,43,1,Haywood,2021-12-29
4,36,13,23,1,Haywood,2022-02-06
4,45,15,30,1,Haywood,2022-02-08
4,23,12,11,1,Haywood,2022-02-24
5,59,27,32,1,Haywood,2021-12-31
5,53,26,27,1,Haywood,2022-02-07
5,27,8,19,1,Haywood,2022-02-16
6,112,29,83,1,Haywood,2022-01-27
6,106,46,60,1,Haywood,2022-01-31
7,89,30,59,1,Haywood,2022-02-02
7,43,19,24,1,Haywood,2022-02-14
9,61,20,41,1,Haywood,2022-01-17
9,93,48,45,1,Haywood,2022-02-01
15,141,54,87,1,Haywood,2022-01-11
16,166,51,115,1,Haywood,2022-01-14
0,10,4,6,1,Henderson,2022-03-01
0,3,2,1,1,Henderson,2022-03-09
0,1,0,1,1,Henderson,2022-03-17
0,3,0,3,1,Henderson,2022-03-19
1,24,5,19,1,Henderson,2021-12-25
2,62,27,35,1,Henderson,2021-12-15
2,24,12,12,1,Henderson,2022-02-12
2,7,5,2,1,Henderson,2022-03-11
2,36,12,24,1,Henderson,2022-05-13
2,16,3,13,1,Henderson,2022-05-15
3,67,19,48,1,Henderson,2022-02-10
3,49,15,34,1,Henderson,2022-02-11
3,32,18,14,1,Henderson,2022-02-18
3,22,7,15,1,Henderson,2022-02-22
5,31,9,22,1,Henderson,2022-05-25
6,46,21,25,1,Henderson,2022-02-06
8,165,29,136,1,Henderson,2021-12-29
9,65,18,47,1,Henderson,2022-02-08
10,108,34,74,1,Henderson,2022-02-01
10,106,36,70,1,Henderson,2022-02-04
15,108,36,72,1,Henderson,2022-02-07
18,152,50,102,1,Henderson,2022-01-31
19,248,89,159,1,Henderson,2022-01-14
22,177,40,137,1,Henderson,2021-12-30
26,230,86,144,1,Henderson,2022-01-18
,0,0,0,1,Hertford,2022-04-05
0,3,0,3,1,Hertford,2021-12-15
0,2,0,2,1,Hertford,2022-01-22
0,13,3,10,1,Hertford,2022-01-31
0,1,0,1,1,Hertford,2022-02-11
0,4,1,3,1,Hertford,2022-02-16
2,20,3,17,1,Hertford,2022-01-28
4,19,1,18,1,Hertford,2022-01-02
5,48,7,41,1,Hertford,2022-01-19
10,79,18,61,1,Hertford,2022-01-13
0,54,4,50,1,Hoke,2022-02-02
0,13,2,11,1,Hoke,2022-02-17
0,2,0,2,1,Hoke,2022-02-20
0,6,0,6,1,Hoke,2022-02-28
0,1,0,1,1,Hoke,2022-03-01
1,55,6,49,1,Hoke,2022-02-04
1,8,1,7,1,Hoke,2022-02-18
1,1,0,1,1,Hoke,2022-04-04
3,27,7,20,1,Hoke,2022-06-08
4,177,8,169,1,Hoke,2022-01-15
4,93,17,76,1,Hoke,2022-01-27
4,77,4,73,1,Hoke,2022-01-28
5,39,4,35,1,Hoke,2022-06-06
7,75,14,61,1,Hoke,2022-02-01
8,65,3,62,1,Hoke,2022-01-01
14,150,6,144,1,Hoke,2022-01-09
17,310,27,283,1,Hoke,2022-01-19
21,215,34,181,1,Hoke,2022-01-24
0,3,0,3,1,Hyde,2021-12-30
2,7,1,6,1,Hyde,2022-01-06
0,1,0,1,1,Iredell,2022-03-12
0,1,1,0,1,Iredell,2022-04-02
1,25,10,15,1,Iredell,2022-02-20
2,65,22,43,1,Iredell,2021-12-24
2,37,13,24,1,Iredell,2022-02-22
2,18,12,6,1,Iredell,2022-03-03
2,29,10,19,1,Iredell,2022-05-21
3,158,52,106,1,Iredell,2021-12-20
3,22,8,14,1,Iredell,2022-02-19
3,62,24,38,1,Iredell,2022-02-21
3,28,12,16,1,Iredell,2022-02-23
3,31,10,21,1,Iredell,2022-02-28
3,29,8,21,1,Iredell,2022-05-15
4,117,24,93,1,Iredell,2021-12-14
5,58,23,35,1,Iredell,2022-02-15
5,50,17,33,1,Iredell,2022-02-16
5,26,9,17,1,Iredell,2022-02-24
7,67,14,53,1,Iredell,2022-02-05
7,84,34,50,1,Iredell,2022-02-11
9,118,49,69,1,Iredell,2022-02-08
9,103,37,66,1,Iredell,2022-02-10
9,82,31,51,1,Iredell,2022-05-25
11,178,69,109,1,Iredell,2022-01-17
12,141,75,66,1,Iredell,2022-01-01
12,190,59,131,1,Iredell,2022-02-03
12,89,35,54,1,Iredell,2022-05-23
19,219,86,133,1,Iredell,2022-02-01
20,275,99,176,1,Iredell,2022-01-27
24,427,137,290,1,Iredell,2021-12-28
35,444,156,288,1,Iredell,2021-12-29
36,403,135,268,1,Iredell,2021-12-30
44,638,194,444,1,Iredell,2022-01-13
53,631,239,392,1,Iredell,2022-01-19
55,640,193,447,1,Iredell,2022-01-12
,0,0,0,1,Jackson,2022-04-15
0,9,3,6,1,Jackson,2021-12-21
0,7,3,4,1,Jackson,2022-03-03
0,1,0,1,1,Jackson,2022-03-27
2,15,6,9,1,Jackson,2022-02-11
2,23,10,13,1,Jackson,2022-02-14
2,11,4,7,1,Jackson,2022-02-22
2,9,5,4,1,Jackson,2022-02-25
2,5,2,3,1,Jackson,2022-02-27
3,17,7,10,1,Jackson,2022-01-01
3,42,14,28,1,Jackson,2022-02-04
6,73,25,48,1,Jackson,2022-01-26
8,150,27,123,1,Jackson,2022-01-04
10,102,38,64,1,Jackson,2022-01-27
11,99,22,77,1,Jackson,2022-01-07
11,71,8,63,1,Jackson,2022-01-21
12,129,39,90,1,Jackson,2022-01-14
14,120,28,92,1,Jackson,2022-01-06
1,34,11,23,1,Johnston,2021-12-25
1,16,3,13,1,Johnston,2022-02-27
1,17,0,17,1,Johnston,2022-03-04
1,11,4,7,1,Johnston,2022-03-10
1,7,1,6,1,Johnston,2022-03-13
1,9,4,5,1,Johnston,2022-03-15
2,111,20,91,1,Johnston,2021-12-15
2,29,9,20,1,Johnston,2022-02-23
2,17,3,14,1,Johnston,2022-03-07
2,33,3,30,1,Johnston,2022-05-08
3,41,6,35,1,Johnston,2022-02-22
3,10,4,6,1,Johnston,2022-03-24
4,49,6,43,1,Johnston,2022-05-21
5,149,17,132,1,Johnston,2021-12-20
5,99,15,84,1,Johnston,2022-02-05
5,99,18,81,1,Johnston,2022-05-24
7,94,26,68,1,Johnston,2022-05-17
8,153,32,121,1,Johnston,2021-12-22
10,261,54,207,1,Johnston,2022-01-21
10,72,22,50,1,Johnston,2022-05-10
10,74,13,61,1,Johnston,2022-05-29
11,132,28,104,1,Johnston,2022-01-16
11,85,16,69,1,Johnston,2022-05-09
12,108,34,74,1,Johnston,2022-02-09
15,160,31,129,1,Johnston,2022-01-23
17,202,40,162,1,Johnston,2022-02-07
23,253,60,193,1,Johnston,2022-02-02
24,365,81,284,1,Johnston,2022-01-31
28,382,24,358,1,Johnston,2022-01-08
29,280,69,211,1,Johnston,2022-02-01
40,496,85,411,1,Johnston,2022-01-15
42,615,104,511,1,Johnston,2021-12-30
47,552,76,476,1,Johnston,2021-12-29
65,864,150,714,1,Johnston,2022-01-24
69,938,122,816,1,Johnston,2022-01-04
80,1027,185,842,1,Johnston,2022-01-11
85,979,138,841,1,Johnston,2022-01-19
104,1205,197,1008,1,Johnston,2022-01-18
1,21,15,6,1,Jones,2022-01-26
,0,0,0,1,Lee,2022-04-01
0,15,1,14,1,Lee,2022-02-05
0,6,3,3,1,Lee,2022-02-13
0,13,4,9,1,Lee,2022-02-14
0,6,0,6,1,Lee,2022-02-22
0,3,3,0,1,Lee,2022-03-06
0,7,1,6,1,Lee,2022-03-08
0,4,1,3,1,Lee,2022-03-12
1,27,3,24,1,Lee,2021-12-15
1,16,2,14,1,Lee,2022-02-17
2,13,2,11,1,Lee,2021-12-24
2,25,2,23,1,Lee,2022-02-16
2,9,4,5,1,Lee,2022-03-10
3,69,5,64,1,Lee,2022-01-28
3,53,10,43,1,Lee,2022-02-01
3,21,5,16,1,Lee,2022-05-23
4,30,5,25,1,Lee,2022-02-09
5,103,7,96,1,Lee,2022-01-08
10,194,39,155,1,Lee,2022-01-04
12,159,39,120,1,Lee,2022-01-17
15,163,9,154,1,Lee,2022-01-06
17,320,67,253,1,Lee,2022-01-10
18,256,46,210,1,Lee,2022-01-14
27,307,41,266,1,Lee,2022-01-12
,0,0,0,1,Lenoir,2022-03-26
0,35,7,28,1,Lenoir,2022-01-01
0,14,3,11,1,Lenoir,2022-01-30
0,10,1,9,1,Lenoir,2022-02-06
0,3,0,3,1,Lenoir,2022-02-13
0,2,0,2,1,Lenoir,2022-02-23
0,6,1,5,1,Lenoir,2022-02-25
0,1,0,1,1,Lenoir,2022-03-04
0,1,1,0,1,Lenoir,2022-03-05
0,1,0,1,1,Lenoir,2022-03-06
0,3,1,2,1,Lenoir,2022-03-10
0,2,1,1,1,Lenoir,2022-04-14
1,2,0,2,1,Lenoir,2022-03-08
2,13,3,10,1,Lenoir,2022-02-15
3,25,10,15,1,Lenoir,2022-01-29
3,16,3,13,1,Lenoir,2022-02-05
4,50,13,37,1,Lenoir,2022-01-09
4,19,2,17,1,Lenoir,2022-02-14
4,24,8,16,1,Lenoir,2022-05-31
5,51,13,38,1,Lenoir,2022-02-07
6,58,15,43,1,Lenoir,2022-02-01
10,124,13,111,1,Lenoir,2021-12-28
10,89,18,71,1,Lenoir,2022-01-31
12,139,30,109,1,Lenoir,2022-01-26
16,160,21,139,1,Lenoir,2022-01-03
16,186,35,151,1,Lenoir,2022-01-25
20,195,47,148,1,Lenoir,2022-01-04
22,252,43,209,1,Lenoir,2022-01-24
27,352,70,282,1,Lenoir,2022-01-18
30,340,76,264,1,Lenoir,2022-01-19
0,9,2,7,1,Lincoln,2022-03-01
0,2,0,2,1,Lincoln,2022-03-18
0,1,0,1,1,Lincoln,2022-04-05
1,12,6,6,1,Lincoln,2022-02-22
1,3,0,3,1,Lincoln,2022-03-29
1,15,4,11,1,Lincoln,2022-05-02
2,31,8,23,1,Lincoln,2022-02-06
2,20,5,15,1,Lincoln,2022-02-18
3,66,14,52,1,Lincoln,2021-12-23
3,40,11,29,1,Lincoln,2022-01-30
3,23,11,12,1,Lincoln,2022-02-12
3,43,13,30,1,Lincoln,2022-02-15
3,37,9,28,1,Lincoln,2022-02-16
5,54,15,39,1,Lincoln,2022-01-02
6,41,10,31,1,Lincoln,2022-02-11
8,94,15,79,1,Lincoln,2022-01-08
10,71,25,46,1,Lincoln,2022-01-23
12,130,39,91,1,Lincoln,2022-02-01
14,147,45,102,1,Lincoln,2021-12-27
21,213,86,127,1,Lincoln,2022-01-10
31,270,66,204,1,Lincoln,2022-01-04
41,283,79,204,1,Lincoln,2022-01-12
42,339,113,226,1,Lincoln,2022-01-11
,0,0,0,1,Macon,2022-03-21
,0,0,0,1,Macon,2022-03-30
,0,0,0,1,Macon,2022-04-15
0,15,4,11,1,Macon,2021-12-14
0,1,0,1,1,Macon,2021-12-18
0,7,2,5,1,Macon,2021-12-25
0,1,0,1,1,Macon,2022-02-27
0,2,0,2,1,Macon,2022-03-02
0,5,3,2,1,Macon,2022-03-07
0,1,0,1,1,Macon,2022-03-19
0,3,2,1,1,Macon,2022-05-10
1,6,0,6,1,Macon,2022-01-01
1,18,5,13,1,Macon,2022-01-09
1,12,0,12,1,Macon,2022-01-16
1,34,11,23,1,Macon,2022-01-27
1,21,4,17,1,Macon,2022-02-08
1,6,2,4,1,Macon,2022-02-22
1,2,0,2,1,Macon,2022-04-13
2,41,15,26,1,Macon,2022-01-07
2,8,2,6,1,Macon,2022-02-17
2,5,2,3,1,Macon,2022-02-24
3,57,15,42,1,Macon,2022-01-31
4,33,12,21,1,Macon,2021-12-30
4,81,19,62,1,Macon,2022-01-03
7,76,16,60,1,Macon,2022-01-06
8,97,6,91,1,Macon,2022-01-14
19,108,29,79,1,Macon,2022-01-18
,0,0,0,1,Madison,2022-02-26
0,15,2,13,1,Madison,2021-12-23
0,15,3,12,1,Madison,2021-12-31
1,7,0,7,1,Madison,2022-01-08
1,4,0,4,1,Madison,2022-02-06
1,5,4,1,1,Madison,2022-02-22
1,2,2,0,1,Madison,2022-03-09
2,26,4,22,1,Madison,2022-02-11
3,34,6,28,1,Madison,2022-01-27
4,18,2,16,1,Madison,2022-02-08
6,52,3,49,1,Madison,2022-01-14
7,55,3,52,1,Madison,2022-01-18
8,54,12,42,1,Madison,2022-02-01
,0,0,0,1,Martin,2022-04-26
0,9,0,9,1,Martin,2022-01-02
0,2,0,2,1,Martin,2022-02-12
0,1,1,0,1,Martin,2022-02-13
0,1,0,1,1,Martin,2022-02-25
1,7,1,6,1,Martin,2022-02-09
1,2,0,2,1,Martin,2022-02-27
1,3,0,3,1,Martin,2022-02-28
2,16,3,13,1,Martin,2022-01-23
2,35,1,34,1,Martin,2022-01-27
4,54,5,49,1,Martin,2022-01-07
4,43,2,41,1,Martin,2022-01-26
6,87,7,80,1,Martin,2022-01-24
7,42,5,37,1,Martin,2021-12-28
9,115,5,110,1,Martin,2022-01-18
,0,0,0,1,McDowell,2022-03-22
0,17,7,10,1,McDowell,2022-02-21
0,8,3,5,1,McDowell,2022-03-03
0,3,0,3,1,McDowell,2022-03-06
0,2,0,2,1,McDowell,2022-03-08
1,25,8,17,1,McDowell,2021-12-20
1,6,1,5,1,McDowell,2022-03-02
2,12,7,5,1,McDowell,2022-01-16
2,33,5,28,1,McDowell,2022-02-16
3,9,2,7,1,McDowell,2022-05-30
4,29,8,21,1,McDowell,2022-01-01
4,53,12,41,1,McDowell,2022-01-23
4,52,14,38,1,McDowell,2022-02-04
4,32,10,22,1,McDowell,2022-02-06
5,60,17,43,1,McDowell,2022-01-09
5,57,25,32,1,McDowell,2022-01-15
5,98,16,82,1,McDowell,2022-01-18
6,68,19,49,1,McDowell,2022-02-02
7,82,28,54,1,McDowell,2022-02-01
9,42,11,31,1,McDowell,2022-02-14
10,120,25,95,1,McDowell,2022-01-03
13,167,60,107,1,McDowell,2022-01-24
15,126,34,92,1,McDowell,2022-01-25
16,76,21,55,1,McDowell,2022-02-03
20,176,52,124,1,McDowell,2022-01-11
28,131,49,82,1,McDowell,2022-01-13
0,29,4,25,1,Mecklenburg,2022-03-19
1,50,11,39,1,Mecklenburg,2022-03-16
1,53,11,42,1,Mecklenburg,2022-03-25
2,68,11,57,1,Mecklenburg,2022-03-04
2,46,10,36,1,Mecklenburg,2022-03-24
2,41,9,32,1,Mecklenburg,2022-04-02
2,50,12,38,1,Mecklenburg,2022-04-03
3,81,13,68,1,Mecklenburg,2022-03-07
3,54,8,46,1,Mecklenburg,2022-03-11
3,47,6,41,1,Mecklenburg,2022-03-28
4,135,29,106,1,Mecklenburg,2022-02-24
4,40,6,34,1,Mecklenburg,2022-03-06
4,52,7,45,1,Mecklenburg,2022-03-10
5,66,11,55,1,Mecklenburg,2022-02-27
5,47,6,41,1,Mecklenburg,2022-03-05
7,66,13,53,1,Mecklenburg,2022-03-21
8,93,17,76,1,Mecklenburg,2022-03-29
9,140,27,113,1,Mecklenburg,2022-02-19
10,224,37,187,1,Mecklenburg,2022-05-08
12,228,41,187,1,Mecklenburg,2022-02-21
12,182,31,151,1,Mecklenburg,2022-02-22
13,124,21,103,1,Mecklenburg,2022-04-08
19,234,47,187,1,Mecklenburg,2022-04-18
28,465,48,417,1,Mecklenburg,2021-12-18
35,452,58,394,1,Mecklenburg,2022-05-11
38,460,71,389,1,Mecklenburg,2022-05-12
42,504,62,442,1,Mecklenburg,2022-06-02
42,471,52,419,1,Mecklenburg,2022-06-08
46,429,65,364,1,Mecklenburg,2022-05-27
47,380,31,349,1,Mecklenburg,2022-06-10
55,599,73,526,1,Mecklenburg,2022-05-31
100,1266,234,1032,1,Mecklenburg,2022-01-01
147,1690,311,1379,1,Mecklenburg,2022-01-09
239,4081,526,3555,1,Mecklenburg,2022-01-12
,0,0,0,1,Mitchell,2022-03-21
1,27,15,12,1,Mitchell,2021-12-30
1,24,4,20,1,Mitchell,2022-01-13
1,6,4,2,1,Mitchell,2022-01-16
1,22,3,19,1,Mitchell,2022-01-19
1,6,3,3,1,Mitchell,2022-02-18
2,21,12,9,1,Mitchell,2022-01-03
2,46,3,43,1,Mitchell,2022-01-11
2,9,1,8,1,Mitchell,2022-01-22
2,19,9,10,1,Mitchell,2022-02-03
3,9,8,1,1,Mitchell,2022-02-13
4,17,5,12,1,Mitchell,2022-01-28
0,2,0,2,1,Montgomery,2022-01-30
0,16,1,15,1,Montgomery,2022-02-08
0,14,1,13,1,Montgomery,2022-02-09
0,3,1,2,1,Montgomery,2022-02-12
0,3,1,2,1,Montgomery,2022-02-19
0,5,0,5,1,Montgomery,2022-05-16
0,3,0,3,1,Montgomery,2022-06-05
1,12,2,10,1,Montgomery,2022-01-29
2,29,8,21,1,Montgomery,2021-12-30
2,34,6,28,1,Montgomery,2022-01-28
2,3,1,2,1,Montgomery,2022-02-06
2,13,0,13,1,Montgomery,2022-02-07
2,5,2,3,1,Montgomery,2022-05-30
4,54,2,52,1,Montgomery,2022-01-15
4,24,6,18,1,Montgomery,2022-02-02
5,31,9,22,1,Montgomery,2022-02-03
6,35,6,29,1,Montgomery,2022-01-09
9,129,21,108,1,Montgomery,2022-01-13
0,27,2,25,1,Moore,2021-12-18
0,20,2,18,1,Moore,2022-02-23
0,23,6,17,1,Moore,2022-02-24
0,10,1,9,1,Moore,2022-03-03
0,4,2,2,1,Moore,2022-03-06
0,3,1,2,1,Moore,2022-03-10
0,6,2,4,1,Moore,2022-03-11
1,31,3,28,1,Moore,2021-12-14
1,15,5,10,1,Moore,2022-02-19
1,14,2,12,1,Moore,2022-03-01
1,5,0,5,1,Moore,2022-03-05
1,4,2,2,1,Moore,2022-04-06
1,21,4,17,1,Moore,2022-05-03
2,32,4,28,1,Moore,2022-02-16
2,23,2,21,1,Moore,2022-02-18
3,55,7,48,1,Moore,2022-02-14
3,16,6,10,1,Moore,2022-04-28
4,30,10,20,1,Moore,2022-05-11
5,60,4,56,1,Moore,2021-12-22
5,92,10,82,1,Moore,2022-01-23
5,84,13,71,1,Moore,2022-02-03
5,74,15,59,1,Moore,2022-02-04
7,125,6,119,1,Moore,2022-01-02
11,194,36,158,1,Moore,2022-01-25
11,129,25,104,1,Moore,2022-02-01
17,295,36,259,1,Moore,2022-01-04
17,133,31,102,1,Moore,2022-01-27
20,294,46,248,1,Moore,2022-01-06
24,318,39,279,1,Moore,2022-01-24
26,428,69,359,1,Moore,2022-01-18
38,441,30,411,1,Moore,2022-01-10
0,1,0,1,1,Nash,2022-02-26
0,2,0,2,1,Nash,2022-03-22
0,2,1,1,1,Nash,2022-03-24
0,2,0,2,1,Nash,2022-04-10
1,53,15,38,1,Nash,2021-12-23
1,14,1,13,1,Nash,2022-02-12
1,14,6,8,1,Nash,2022-02-18
1,11,3,8,1,Nash,2022-02-19
1,5,0,5,1,Nash,2022-03-14
1,4,0,4,1,Nash,2022-04-06
1,5,4,1,1,Nash,2022-04-12
1,5,2,3,1,Nash,2022-04-16
1,8,2,6,1,Nash,2022-04-27
2,42,8,34,1,Nash,2021-12-17
2,21,5,16,1,Nash,2022-02-17
2,7,1,6,1,Nash,2022-02-20
2,3,1,2,1,Nash,2022-04-02
3,49,8,41,1,Nash,2022-01-23
3,38,8,30,1,Nash,2022-01-29
3,40,8,32,1,Nash,2022-02-08
3,24,7,17,1,Nash,2022-05-24
4,49,12,37,1,Nash,2022-02-11
4,25,4,21,1,Nash,2022-02-16
4,13,1,12,1,Nash,2022-02-22
4,14,5,9,1,Nash,2022-05-30
5,59,0,59,1,Nash,2022-01-21
5,29,2,27,1,Nash,2022-02-05
5,19,4,15,1,Nash,2022-02-23
5,25,5,20,1,Nash,2022-06-09
7,108,5,103,1,Nash,2022-01-09
9,109,19,90,1,Nash,2022-01-28
9,67,14,53,1,Nash,2022-02-04
9,69,10,59,1,Nash,2022-02-07
11,169,10,159,1,Nash,2021-12-31
11,135,14,121,1,Nash,2022-01-26
14,193,27,166,1,Nash,2021-12-27
14,123,11,112,1,Nash,2022-01-27
28,248,27,221,1,Nash,2022-01-25
30,313,21,292,1,Nash,2022-01-07
34,401,26,375,1,Nash,2022-01-06
35,593,18,575,1,Nash,2022-01-04
38,498,34,464,1,Nash,2022-01-18
40,348,31,317,1,Nash,2022-01-13
0,13,4,9,1,New Hanover,2022-02-26
0,18,2,16,1,New Hanover,2022-02-28
0,3,0,3,1,New Hanover,2022-03-05
0,7,1,6,1,New Hanover,2022-03-08
0,11,5,6,1,New Hanover,2022-03-11
0,5,0,5,1,New Hanover,2022-03-12
0,9,3,6,1,New Hanover,2022-03-17
0,4,1,3,1,New Hanover,2022-03-18
0,21,1,20,1,New Hanover,2022-05-01
1,79,19,60,1,New Hanover,2022-02-05
1,74,12,62,1,New Hanover,2022-02-06
1,21,9,12,1,New Hanover,2022-02-20
1,10,0,10,1,New Hanover,2022-03-10
1,5,0,5,1,New Hanover,2022-03-21
1,14,3,11,1,New Hanover,2022-04-06
1,35,7,28,1,New Hanover,2022-05-28
2,57,21,36,1,New Hanover,2021-12-14
2,13,3,10,1,New Hanover,2022-03-03
2,58,8,50,1,New Hanover,2022-05-25
3,26,4,22,1,New Hanover,2021-12-25
3,34,10,24,1,New Hanover,2022-02-13
3,70,17,53,1,New Hanover,2022-02-15
3,17,3,14,1,New Hanover,2022-03-02
4,172,42,130,1,New Hanover,2022-02-07
5,55,20,35,1,New Hanover,2022-02-17
5,19,8,11,1,New Hanover,2022-04-07
6,102,31,71,1,New Hanover,2022-01-30
7,122,21,101,1,New Hanover,2022-01-22
7,90,24,66,1,New Hanover,2022-02-09
10,191,48,143,1,New Hanover,2022-01-23
10,119,30,89,1,New Hanover,2022-02-10
15,228,50,178,1,New Hanover,2022-01-21
16,288,54,234,1,New Hanover,2022-01-09
18,265,62,203,1,New Hanover,2022-01-08
18,323,66,257,1,New Hanover,2022-01-31
20,337,58,279,1,New Hanover,2022-01-15
20,398,66,332,1,New Hanover,2022-01-26
36,464,110,354,1,New Hanover,2021-12-28
41,671,123,548,1,New Hanover,2022-01-13
41,652,169,483,1,New Hanover,2022-01-20
,0,0,0,1,Northampton,2022-02-27
0,2,0,2,1,Northampton,2021-12-14
0,8,1,7,1,Northampton,2022-01-21
0,4,0,4,1,Northampton,2022-01-30
0,3,0,3,1,Northampton,2022-02-12
0,1,0,1,1,Northampton,2022-02-13
0,6,0,6,1,Northampton,2022-02-22
0,1,0,1,1,Northampton,2022-03-16
1,10,4,6,1,Northampton,2022-02-04
2,64,14,50,1,Northampton,2022-01-12
2,21,3,18,1,Northampton,2022-01-31
2,15,5,10,1,Northampton,2022-02-02
4,27,8,19,1,Northampton,2022-01-28
8,68,19,49,1,Northampton,2022-01-11
0,6,1,5,1,Onslow,2022-02-27
0,15,1,14,1,Onslow,2022-03-05
0,8,1,7,1,Onslow,2022-03-11
0,4,0,4,1,Onslow,2022-03-22
1,3,0,3,1,Onslow,2022-03-16
1,5,1,4,1,Onslow,2022-04-07
1,6,0,6,1,Onslow,2022-04-30
2,25,4,21,1,Onslow,2022-02-24
3,62,5,57,1,Onslow,2022-02-17
3,81,10,71,1,Onslow,2022-05-16
4,53,8,45,1,Onslow,2021-12-26
4,37,12,25,1,Onslow,2022-05-21
7,80,12,68,1,Onslow,2022-05-24
13,107,33,74,1,Onslow,2022-01-01
15,240,19,221,1,Onslow,2022-01-16
15,179,27,152,1,Onslow,2022-01-21
17,261,39,222,1,Onslow,2022-02-07
21,273,31,242,1,Onslow,2022-02-01
39,427,59,368,1,Onslow,2022-01-26
57,883,114,769,1,Onslow,2022-01-19
66,807,157,650,1,Onslow,2022-01-05
70,996,114,882,1,Onslow,2022-01-11
0,55,5,50,1,Orange,2022-01-30
0,38,3,35,1,Orange,2022-02-12
0,42,3,39,1,Orange,2022-02-21
0,15,2,13,1,Orange,2022-03-03
0,8,0,8,1,Orange,2022-03-17
0,9,0,9,1,Orange,2022-03-19
1,20,1,19,1,Orange,2022-03-07
2,60,6,54,1,Orange,2022-04-09
3,51,2,49,1,Orange,2022-02-06
3,72,2,70,1,Orange,2022-02-10
3,62,7,55,1,Orange,2022-02-16
4,32,7,25,1,Orange,2022-01-16
4,105,3,102,1,Orange,2022-02-04
5,123,4,119,1,Orange,2022-01-23
6,132,9,123,1,Orange,2022-01-09
7,285,12,273,1,Orange,2022-01-25
8,211,17,194,1,Orange,2022-01-08
10,182,7,175,1,Orange,2022-01-27
19,415,14,401,1,Orange,2022-01-24
20,430,30,400,1,Orange,2022-01-14
31,514,25,489,1,Orange,2022-01-04
,0,0,0,1,Pamlico,2022-05-08
0,24,2,22,1,Pamlico,2022-01-03
2,16,0,16,1,Pamlico,2022-02-01
,0,0,0,1,Pasquotank,2022-03-18
,0,0,0,1,Pasquotank,2022-03-20
,0,0,0,1,Pasquotank,2022-03-22
0,3,0,3,1,Pasquotank,2022-02-11
1,26,7,19,1,Pasquotank,2022-01-21
1,14,1,13,1,Pasquotank,2022-01-30
1,9,1,8,1,Pasquotank,2022-02-05
2,29,2,27,1,Pasquotank,2022-01-23
2,30,5,25,1,Pasquotank,2022-02-02
4,90,24,66,1,Pasquotank,2022-01-25
5,45,19,26,1,Pasquotank,2022-01-16
6,34,11,23,1,Pasquotank,2022-02-03
0,8,2,6,1,Pender,2021-12-18
0,9,5,4,1,Pender,2022-02-19
1,35,0,35,1,Pender,2022-01-29
1,35,6,29,1,Pender,2022-02-09
1,29,7,22,1,Pender,2022-02-14
2,7,1,6,1,Pender,2022-02-25
2,17,4,13,1,Pender,2022-05-17
2,15,2,13,1,Pender,2022-05-27
3,89,15,74,1,Pender,2021-12-27
3,18,0,18,1,Pender,2022-02-06
4,55,6,49,1,Pender,2022-02-04
5,53,7,46,1,Pender,2022-01-21
5,60,9,51,1,Pender,2022-02-03
8,114,21,93,1,Pender,2022-01-15
8,63,7,56,1,Pender,2022-01-16
8,116,10,106,1,Pender,2022-01-31
9,121,13,108,1,Pender,2022-01-26
11,88,16,72,1,Pender,2022-01-09
13,228,42,186,1,Pender,2022-01-17
15,221,20,201,1,Pender,2022-01-11
16,184,23,161,1,Pender,2022-01-14
16,165,16,149,1,Pender,2022-01-25
,0,0,0,1,Perquimans,2022-02-16
,0,0,0,1,Perquimans,2022-03-21
0,3,1,2,1,Perquimans,2022-02-04
3,34,6,28,1,Perquimans,2022-01-12
4,32,16,16,1,Perquimans,2022-01-07
5,45,7,38,1,Perquimans,2022-01-18
0,20,5,15,1,Person,2022-01-29
0,6,1,5,1,Person,2022-02-21
0,1,1,0,1,Person,2022-03-16
1,6,2,4,1,Person,2022-02-19
1,5,3,2,1,Person,2022-02-24
2,64,8,56,1,Person,2022-01-08
2,14,2,12,1,Person,2022-02-09
4,48,18,30,1,Person,2022-02-01
5,39,11,28,1,Person,2022-02-03
6,118,19,99,1,Person,2022-01-06
7,76,21,55,1,Person,2021-12-30
9,188,14,174,1,Person,2022-01-19
13,184,32,152,1,Person,2022-01-18
18,111,24,87,1,Person,2022-01-20
0,5,2,3,1,Pitt,2022-03-05
0,3,1,2,1,Pitt,2022-03-06
0,4,2,2,1,Pitt,2022-03-08
0,2,0,2,1,Pitt,2022-03-16
0,9,1,8,1,Pitt,2022-03-17
0,3,0,3,1,Pitt,2022-03-19
0,4,0,4,1,Pitt,2022-03-25
1,15,2,13,1,Pitt,2022-03-04
1,4,0,4,1,Pitt,2022-03-14
2,67,5,62,1,Pitt,2021-12-14
2,42,7,35,1,Pitt,2022-02-16
2,43,3,40,1,Pitt,2022-02-18
2,22,3,19,1,Pitt,2022-02-23
2,23,6,17,1,Pitt,2022-02-24
2,20,1,19,1,Pitt,2022-02-25
2,11,1,10,1,Pitt,2022-03-02
2,11,0,11,1,Pitt,2022-04-15
5,94,10,84,1,Pitt,2022-02-09
5,63,7,56,1,Pitt,2022-02-11
6,56,1,55,1,Pitt,2022-01-22
6,69,6,63,1,Pitt,2022-02-14
12,159,15,144,1,Pitt,2022-02-03
15,146,11,135,1,Pitt,2022-02-07
20,175,12,163,1,Pitt,2022-02-02
24,287,26,261,1,Pitt,2022-01-28
28,310,32,278,1,Pitt,2022-01-31
53,669,77,592,1,Pitt,2022-01-17
75,813,58,755,1,Pitt,2022-01-06
84,819,74,745,1,Pitt,2022-01-14
,0,0,0,1,Polk,2022-03-03
,0,0,0,1,Polk,2022-03-08
,0,0,0,1,Polk,2022-04-11
,0,0,0,1,Polk,2022-04-19
0,12,5,7,1,Polk,2022-01-30
0,12,5,7,1,Polk,2022-02-04
0,22,14,8,1,Polk,2022-02-08
0,2,1,1,1,Polk,2022-02-20
0,1,0,1,1,Polk,2022-03-14
1,11,4,7,1,Polk,2022-02-09
1,7,4,3,1,Polk,2022-02-17
3,17,12,5,1,Polk,2022-02-03
6,18,17,1,1,Polk,2022-01-17
9,59,28,31,1,Polk,2022-01-11
0,5,1,4,1,Randolph,2022-03-08
0,5,1,4,1,Randolph,2022-03-16
0,5,0,5,1,Randolph,2022-03-20
0,4,1,3,1,Randolph,2022-04-15
0,15,5,10,1,Randolph,2022-04-19
1,7,0,7,1,Randolph,2022-03-11
2,8,1,7,1,Randolph,2022-02-26
2,14,9,5,1,Randolph,2022-03-02
2,16,6,10,1,Randolph,2022-03-03
2,20,10,10,1,Randolph,2022-05-15
3,66,24,42,1,Randolph,2021-12-22
3,47,23,24,1,Randolph,2021-12-24
3,25,5,20,1,Randolph,2022-02-22
4,28,15,13,1,Randolph,2022-05-02
4,36,13,23,1,Randolph,2022-06-03
5,98,45,53,1,Randolph,2021-12-20
5,76,24,52,1,Randolph,2022-01-22
5,62,15,47,1,Randolph,2022-02-15
6,57,15,42,1,Randolph,2022-02-11
7,94,22,72,1,Randolph,2022-02-08
8,81,31,50,1,Randolph,2022-01-01
9,60,16,44,1,Randolph,2022-01-29
9,136,32,104,1,Randolph,2022-02-03
10,66,16,50,1,Randolph,2022-02-10
16,169,59,110,1,Randolph,2022-01-28
18,320,113,207,1,Randolph,2022-01-03
18,162,19,143,1,Randolph,2022-01-08
18,136,46,90,1,Randolph,2022-02-02
18,116,40,76,1,Randolph,2022-02-07
20,231,96,135,1,Randolph,2021-12-29
21,266,63,203,1,Randolph,2022-01-06
27,304,112,192,1,Randolph,2022-01-05
27,249,83,166,1,Randolph,2022-01-27
40,473,107,366,1,Randolph,2022-01-12
50,580,144,436,1,Randolph,2022-01-10
53,630,145,485,1,Randolph,2022-01-19
57,613,148,465,1,Randolph,2022-01-18
,0,0,0,1,Richmond,2022-02-27
0,23,5,18,1,Richmond,2021-12-24
0,6,1,5,1,Richmond,2021-12-25
0,32,4,28,1,Richmond,2022-02-04
0,11,2,9,1,Richmond,2022-02-23
0,3,0,3,1,Richmond,2022-03-04
1,20,3,17,1,Richmond,2021-12-23
1,15,3,12,1,Richmond,2022-02-08
1,5,0,5,1,Richmond,2022-02-13
1,4,1,3,1,Richmond,2022-03-05
2,12,1,11,1,Richmond,2022-02-11
2,10,1,9,1,Richmond,2022-02-15
2,8,0,8,1,Richmond,2022-02-25
3,36,4,32,1,Richmond,2022-01-21
3,24,6,18,1,Richmond,2022-02-03
4,51,4,47,1,Richmond,2021-12-27
4,80,29,51,1,Richmond,2022-01-27
5,44,3,41,1,Richmond,2022-01-02
5,94,10,84,1,Richmond,2022-01-09
6,45,21,24,1,Richmond,2022-02-02
7,118,31,87,1,Richmond,2022-01-25
12,193,15,178,1,Richmond,2022-01-14
17,181,29,152,1,Richmond,2022-01-19
17,144,80,64,1,Richmond,2022-01-26
19,231,48,183,1,Richmond,2022-01-12
0,6,4,2,1,Robeson,2022-04-13
0,9,5,4,1,Robeson,2022-05-07
1,22,7,15,1,Robeson,2021-12-18
1,14,5,9,1,Robeson,2022-02-20
1,8,4,4,1,Robeson,2022-02-27
1,6,1,5,1,Robeson,2022-03-28
2,25,10,15,1,Robeson,2021-12-25
2,19,3,16,1,Robeson,2022-02-24
3,58,18,40,1,Robeson,2022-02-10
3,21,6,15,1,Robeson,2022-02-13
3,28,10,18,1,Robeson,2022-02-16
3,7,3,4,1,Robeson,2022-03-09
4,66,20,46,1,Robeson,2021-12-23
4,33,21,12,1,Robeson,2021-12-24
6,35,19,16,1,Robeson,2022-02-06
10,125,54,71,1,Robeson,2022-02-03
11,90,33,57,1,Robeson,2022-02-04
12,109,37,72,1,Robeson,2022-02-02
13,176,49,127,1,Robeson,2021-12-27
14,120,48,72,1,Robeson,2021-12-31
27,255,59,196,1,Robeson,2021-12-28
30,242,99,143,1,Robeson,2022-01-26
34,357,113,244,1,Robeson,2022-01-25
36,334,96,238,1,Robeson,2021-12-29
37,297,91,206,1,Robeson,2021-12-30
37,528,194,334,1,Robeson,2022-01-14
38,324,116,208,1,Robeson,2022-01-15
71,548,229,319,1,Robeson,2022-01-17
72,629,206,423,1,Robeson,2022-01-19
79,856,302,554,1,Robeson,2022-01-18
,0,0,0,1,Rockingham,2022-03-12
0,16,3,13,1,Rockingham,2022-02-18
0,7,1,6,1,Rockingham,2022-02-20
0,2,0,2,1,Rockingham,2022-03-26
0,1,0,1,1,Rockingham,2022-04-13
1,21,4,17,1,Rockingham,2021-12-18
1,10,1,9,1,Rockingham,2022-03-04
2,39,8,31,1,Rockingham,2021-12-14
2,27,3,24,1,Rockingham,2021-12-24
2,104,13,91,1,Rockingham,2022-01-09
2,44,7,37,1,Rockingham,2022-02-11
3,28,5,23,1,Rockingham,2022-02-15
3,32,2,30,1,Rockingham,2022-02-16
4,18,6,12,1,Rockingham,2022-01-16
4,57,10,47,1,Rockingham,2022-02-14
5,54,6,48,1,Rockingham,2022-01-01
5,24,2,22,1,Rockingham,2022-02-05
5,27,6,21,1,Rockingham,2022-02-21
6,49,5,44,1,Rockingham,2022-02-08
8,94,9,85,1,Rockingham,2022-01-23
8,177,27,150,1,Rockingham,2022-01-26
8,114,8,106,1,Rockingham,2022-01-28
10,133,42,91,1,Rockingham,2021-12-31
10,64,9,55,1,Rockingham,2022-02-09
11,149,26,123,1,Rockingham,2022-01-15
12,81,8,73,1,Rockingham,2022-02-07
14,159,24,135,1,Rockingham,2022-01-27
16,269,63,206,1,Rockingham,2022-01-18
19,195,35,160,1,Rockingham,2022-01-25
21,214,50,164,1,Rockingham,2021-12-30
23,324,50,274,1,Rockingham,2022-01-14
27,345,30,315,1,Rockingham,2022-01-10
28,343,64,279,1,Rockingham,2022-01-19
0,18,5,13,1,Rowan,2022-02-23
0,7,0,7,1,Rowan,2022-02-27
0,10,3,7,1,Rowan,2022-03-15
1,44,4,40,1,Rowan,2022-02-05
1,26,3,23,1,Rowan,2022-02-12
1,9,1,8,1,Rowan,2022-03-09
1,4,0,4,1,Rowan,2022-03-11
1,6,0,6,1,Rowan,2022-04-30
2,29,8,21,1,Rowan,2021-12-25
2,32,6,26,1,Rowan,2022-02-13
2,13,2,11,1,Rowan,2022-02-25
2,12,5,7,1,Rowan,2022-03-07
2,5,1,4,1,Rowan,2022-03-29
3,34,6,28,1,Rowan,2022-01-16
3,47,11,36,1,Rowan,2022-02-06
3,14,5,9,1,Rowan,2022-03-08
4,119,11,108,1,Rowan,2021-12-20
4,49,9,40,1,Rowan,2021-12-24
4,32,4,28,1,Rowan,2022-02-18
5,68,10,58,1,Rowan,2022-01-30
6,79,19,60,1,Rowan,2021-12-22
6,26,7,19,1,Rowan,2022-05-08
6,31,4,27,1,Rowan,2022-06-03
7,83,7,76,1,Rowan,2022-02-09
8,147,20,127,1,Rowan,2021-12-31
11,145,21,124,1,Rowan,2022-02-02
13,120,24,96,1,Rowan,2022-02-07
17,228,24,204,1,Rowan,2022-01-28
19,103,10,93,1,Rowan,2022-02-08
22,226,43,183,1,Rowan,2022-01-27
24,169,59,110,1,Rowan,2022-01-17
28,271,30,241,1,Rowan,2021-12-28
46,446,72,374,1,Rowan,2022-01-20
51,412,66,346,1,Rowan,2022-01-05
51,509,88,421,1,Rowan,2022-01-19
54,579,84,495,1,Rowan,2022-01-13
57,482,100,382,1,Rowan,2022-01-18
74,654,116,538,1,Rowan,2022-01-10
,0,0,0,1,Rutherford,2022-03-15
0,10,2,8,1,Rutherford,2021-12-14
0,10,0,10,1,Rutherford,2021-12-19
0,16,5,11,1,Rutherford,2022-02-17
0,10,2,8,1,Rutherford,2022-02-19
1,21,9,12,1,Rutherford,2022-02-05
1,6,1,5,1,Rutherford,2022-02-12
1,7,3,4,1,Rutherford,2022-02-23
1,4,1,3,1,Rutherford,2022-04-26
2,44,18,26,1,Rutherford,2022-01-29
2,26,15,11,1,Rutherford,2022-02-15
2,14,4,10,1,Rutherford,2022-02-24
2,9,3,6,1,Rutherford,2022-03-01
2,8,1,7,1,Rutherford,2022-05-11
3,59,28,31,1,Rutherford,2022-02-08
3,26,5,21,1,Rutherford,2022-02-11
3,12,3,9,1,Rutherford,2022-02-18
3,7,0,7,1,Rutherford,2022-05-02
4,84,41,43,1,Rutherford,2022-01-15
4,10,3,7,1,Rutherford,2022-05-10
5,57,18,39,1,Rutherford,2022-01-23
6,93,32,61,1,Rutherford,2022-01-28
8,69,34,35,1,Rutherford,2022-01-22
11,168,75,93,1,Rutherford,2022-01-14
13,142,35,107,1,Rutherford,2022-01-05
19,203,112,91,1,Rutherford,2022-01-13
25,187,60,127,1,Rutherford,2022-01-18
,0,0,0,1,Sampson,2022-03-20
,0,0,0,1,Sampson,2022-04-09
0,20,15,5,1,Sampson,2021-12-21
0,11,2,9,1,Sampson,2022-02-18
0,9,4,5,1,Sampson,2022-03-03
0,2,2,0,1,Sampson,2022-03-06
0,2,2,0,1,Sampson,2022-04-16
1,24,10,14,1,Sampson,2022-01-30
1,14,6,8,1,Sampson,2022-02-05
1,28,11,17,1,Sampson,2022-02-11
1,7,4,3,1,Sampson,2022-02-13
2,15,6,9,1,Sampson,2022-01-29
2,59,18,41,1,Sampson,2022-02-02
2,51,19,32,1,Sampson,2022-02-03
3,102,35,67,1,Sampson,2022-01-31
3,20,6,14,1,Sampson,2022-02-17
3,13,8,5,1,Sampson,2022-02-24
4,58,29,29,1,Sampson,2021-12-27
6,98,35,63,1,Sampson,2022-01-08
6,55,23,32,1,Sampson,2022-02-07
16,228,97,131,1,Sampson,2022-01-24
19,257,70,187,1,Sampson,2022-01-17
19,268,95,173,1,Sampson,2022-01-20
22,275,140,135,1,Sampson,2022-01-04
25,414,92,322,1,Sampson,2022-01-18
33,279,76,203,1,Sampson,2022-01-19
0,24,6,18,1,Scotland,2022-01-21
0,8,3,5,1,Scotland,2022-02-06
0,5,2,3,1,Scotland,2022-02-12
1,16,5,11,1,Scotland,2022-01-16
1,8,2,6,1,Scotland,2022-01-22
1,5,3,2,1,Scotland,2022-01-29
1,25,15,10,1,Scotland,2022-02-02
1,11,5,6,1,Scotland,2022-02-10
1,19,5,14,1,Scotland,2022-02-14
1,2,2,0,1,Scotland,2022-03-03
2,38,11,27,1,Scotland,2022-01-28
2,19,6,13,1,Scotland,2022-02-04
8,133,37,96,1,Scotland,2022-01-19
9,87,21,66,1,Scotland,2021-12-29
9,148,41,107,1,Scotland,2022-01-07
14,159,40,119,1,Scotland,2022-01-04
,0,0,0,1,Stanly,2022-02-27
,0,0,0,1,Stanly,2022-03-24
0,3,0,3,1,Stanly,2022-02-28
0,2,0,2,1,Stanly,2022-03-05
0,2,0,2,1,Stanly,2022-03-15
0,1,0,1,1,Stanly,2022-03-16
0,1,0,1,1,Stanly,2022-03-29
0,3,0,3,1,Stanly,2022-03-30
1,28,3,25,1,Stanly,2021-12-15
1,32,5,27,1,Stanly,2022-01-22
1,43,1,42,1,Stanly,2022-02-08
1,4,0,4,1,Stanly,2022-02-19
1,10,0,10,1,Stanly,2022-05-11
2,37,5,32,1,Stanly,2021-12-14
2,45,3,42,1,Stanly,2022-02-02
3,17,2,15,1,Stanly,2022-02-05
3,12,4,8,1,Stanly,2022-02-17
4,22,1,21,1,Stanly,2022-02-15
5,37,2,35,1,Stanly,2022-02-10
5,35,2,33,1,Stanly,2022-02-11
5,25,4,21,1,Stanly,2022-05-16
6,62,17,45,1,Stanly,2022-01-08
6,45,3,42,1,Stanly,2022-02-09
7,59,21,38,1,Stanly,2022-01-02
7,42,23,19,1,Stanly,2022-01-30
8,134,21,113,1,Stanly,2022-01-21
8,154,30,124,1,Stanly,2022-01-25
9,60,22,38,1,Stanly,2021-12-31
11,114,9,105,1,Stanly,2022-01-27
19,181,31,150,1,Stanly,2022-01-26
26,173,52,121,1,Stanly,2022-01-04
28,188,63,125,1,Stanly,2022-01-07
30,214,64,150,1,Stanly,2022-01-05
30,252,48,204,1,Stanly,2022-01-24
31,323,51,272,1,Stanly,2022-01-18
35,291,53,238,1,Stanly,2022-01-19
46,387,108,279,1,Stanly,2022-01-10
,0,0,0,1,Stokes,2022-04-10
0,6,1,5,1,Stokes,2022-03-01
0,3,0,3,1,Stokes,2022-03-11
0,1,0,1,1,Stokes,2022-04-02
1,36,5,31,1,Stokes,2021-12-22
1,13,2,11,1,Stokes,2022-02-24
1,5,4,1,1,Stokes,2022-03-03
1,2,1,1,1,Stokes,2022-05-01
2,36,6,30,1,Stokes,2022-02-04
2,13,2,11,1,Stokes,2022-02-16
2,20,3,17,1,Stokes,2022-02-21
3,73,10,63,1,Stokes,2022-01-15
3,30,13,17,1,Stokes,2022-01-17
3,12,3,9,1,Stokes,2022-01-30
3,23,3,20,1,Stokes,2022-02-11
3,26,2,24,1,Stokes,2022-02-15
4,48,8,40,1,Stokes,2022-01-08
4,63,4,59,1,Stokes,2022-01-28
5,38,6,32,1,Stokes,2022-02-07
5,20,4,16,1,Stokes,2022-02-22
6,90,19,71,1,Stokes,2022-01-21
7,126,23,103,1,Stokes,2022-01-04
7,112,33,79,1,Stokes,2022-01-05
8,84,16,68,1,Stokes,2022-01-26
15,154,25,129,1,Stokes,2022-01-12
15,107,28,79,1,Stokes,2022-01-14
28,186,50,136,1,Stokes,2022-01-10
0,34,11,23,1,Surry,2021-12-14
0,42,20,22,1,Surry,2021-12-15
0,27,9,18,1,Surry,2022-02-18
0,3,2,1,1,Surry,2022-03-11
0,2,0,2,1,Surry,2022-03-20
0,2,2,0,1,Surry,2022-03-22
0,3,1,2,1,Surry,2022-04-07
1,38,9,29,1,Surry,2022-02-05
1,16,5,11,1,Surry,2022-02-20
1,3,0,3,1,Surry,2022-04-23
2,57,22,35,1,Surry,2021-12-21
2,62,23,39,1,Surry,2021-12-22
3,72,26,46,1,Surry,2021-12-20
3,54,27,27,1,Surry,2022-01-01
3,108,21,87,1,Surry,2022-01-09
5,36,13,23,1,Surry,2022-05-24
10,149,55,94,1,Surry,2021-12-30
11,158,56,102,1,Surry,2022-01-21
11,116,44,72,1,Surry,2022-01-28
12,157,53,104,1,Surry,2022-01-25
13,121,34,87,1,Surry,2021-12-28
13,208,67,141,1,Surry,2022-01-18
14,120,45,75,1,Surry,2022-01-27
16,133,39,94,1,Surry,2022-01-26
20,253,72,181,1,Surry,2022-01-13
21,102,50,52,1,Surry,2022-01-17
22,160,60,100,1,Surry,2022-01-06
28,245,64,181,1,Surry,2022-01-19
,0,0,0,1,Swain,2022-03-08
0,17,12,5,1,Swain,2022-01-01
0,10,5,5,1,Swain,2022-02-14
0,1,0,1,1,Swain,2022-04-23
0,10,2,8,1,Swain,2022-05-20
1,35,8,27,1,Swain,2022-01-14
1,13,6,7,1,Swain,2022-01-30
2,26,13,13,1,Swain,2021-12-27
2,17,10,7,1,Swain,2022-01-08
2,6,2,4,1,Swain,2022-02-06
3,16,7,9,1,Swain,2022-01-28
,0,0,0,1,Transylvania,2022-02-27
,0,0,0,1,Transylvania,2022-03-21
0,8,5,3,1,Transylvania,2022-02-17
0,3,2,1,1,Transylvania,2022-03-03
0,2,0,2,1,Transylvania,2022-05-02
1,30,6,24,1,Transylvania,2021-12-27
1,36,15,21,1,Transylvania,2021-12-30
1,36,22,14,1,Transylvania,2022-01-18
1,9,4,5,1,Transylvania,2022-02-23
1,2,0,2,1,Transylvania,2022-03-02
2,41,18,23,1,Transylvania,2022-01-06
2,53,15,38,1,Transylvania,2022-01-13
2,15,7,8,1,Transylvania,2022-01-17
2,13,6,7,1,Transylvania,2022-02-08
2,20,3,17,1,Transylvania,2022-02-09
3,19,11,8,1,Transylvania,2021-12-17
3,23,17,6,1,Transylvania,2022-01-02
3,40,13,27,1,Transylvania,2022-01-19
4,23,14,9,1,Transylvania,2022-01-22
4,17,6,11,1,Transylvania,2022-02-07
5,42,15,27,1,Transylvania,2022-01-07
5,64,28,36,1,Transylvania,2022-01-12
0,1,0,1,1,Tyrrell,2022-02-09
0,32,10,22,1,Union,2022-02-22
0,18,4,14,1,Union,2022-02-24
0,9,2,7,1,Union,2022-03-05
0,3,1,2,1,Union,2022-03-13
0,8,1,7,1,Union,2022-03-31
0,10,0,10,1,Union,2022-04-17
1,9,3,6,1,Union,2022-03-21
1,18,4,14,1,Union,2022-04-15
2,22,2,20,1,Union,2022-04-07
3,107,32,75,1,Union,2021-12-15
3,61,12,49,1,Union,2022-02-17
3,12,4,8,1,Union,2022-02-27
4,73,20,53,1,Union,2022-05-04
6,143,35,108,1,Union,2022-02-08
6,69,15,54,1,Union,2022-06-08
7,92,17,75,1,Union,2022-02-05
7,73,26,47,1,Union,2022-02-15
8,108,11,97,1,Union,2021-12-24
8,109,19,90,1,Union,2022-06-01
16,118,21,97,1,Union,2022-05-19
19,226,64,162,1,Union,2022-01-23
20,255,52,203,1,Union,2022-02-01
29,387,84,303,1,Union,2022-01-08
31,413,99,314,1,Union,2022-01-26
33,337,58,279,1,Union,2022-01-27
36,375,71,304,1,Union,2021-12-27
42,483,96,387,1,Union,2022-01-25
44,535,112,423,1,Union,2021-12-30
65,895,193,702,1,Union,2022-01-18
79,985,217,768,1,Union,2022-01-10
0,1,0,1,1,Vance,2022-03-14
1,26,1,25,1,Vance,2022-02-03
2,35,4,31,1,Vance,2022-01-23
2,25,3,22,1,Vance,2022-02-04
2,9,2,7,1,Vance,2022-02-15
3,60,6,54,1,Vance,2022-01-27
6,133,24,109,1,Vance,2022-01-04
7,92,10,82,1,Vance,2022-01-25
7,62,8,54,1,Vance,2022-01-31
8,118,14,104,1,Vance,2022-01-20
10,125,25,100,1,Vance,2022-01-06
11,156,74,82,1,Vance,2022-01-03
1,31,3,28,1,Wake,2022-03-19
2,28,7,21,1,Wake,2022-03-13
2,68,7,61,1,Wake,2022-03-15
2,77,5,72,1,Wake,2022-03-25
2,29,6,23,1,Wake,2022-03-27
3,59,7,52,1,Wake,2022-03-11
3,80,5,75,1,Wake,2022-03-16
3,92,15,77,1,Wake,2022-03-24
3,58,2,56,1,Wake,2022-04-02
8,89,13,76,1,Wake,2022-03-31
8,147,13,134,1,Wake,2022-04-04
8,190,37,153,1,Wake,2022-04-24
9,213,17,196,1,Wake,2022-02-25
9,99,14,85,1,Wake,2022-03-04
9,100,9,91,1,Wake,2022-03-30
10,134,8,126,1,Wake,2022-04-09
10,200,28,172,1,Wake,2022-05-01
11,175,23,152,1,Wake,2022-04-15
14,429,45,384,1,Wake,2021-12-14
15,305,39,266,1,Wake,2022-04-22
15,355,60,295,1,Wake,2022-05-08
25,390,62,328,1,Wake,2022-05-22
31,488,63,425,1,Wake,2022-05-28
32,380,42,338,1,Wake,2022-04-28
36,649,114,535,1,Wake,2021-12-24
36,448,70,378,1,Wake,2022-05-15
37,533,43,490,1,Wake,2022-05-07
41,580,69,511,1,Wake,2022-05-05
58,799,87,712,1,Wake,2022-02-09
71,1039,103,936,1,Wake,2021-12-21
73,1458,122,1336,1,Wake,2022-02-01
75,1324,133,1191,1,Wake,2022-01-02
77,1315,117,1198,1,Wake,2022-01-09
80,1084,136,948,1,Wake,2022-05-17
87,1825,71,1754,1,Wake,2022-01-01
87,1023,107,916,1,Wake,2022-05-19
90,1153,123,1030,1,Wake,2022-05-16
94,1432,123,1309,1,Wake,2021-12-23
242,3642,212,3430,1,Wake,2021-12-27
300,5115,352,4763,1,Wake,2022-01-03
308,4875,199,4676,1,Wake,2022-01-07
335,5901,316,5585,1,Wake,2022-01-11
366,6507,352,6155,1,Wake,2022-01-10
,0,0,0,1,Warren,2022-03-07
0,7,1,6,1,Warren,2021-12-16
0,2,0,2,1,Warren,2022-02-12
0,2,1,1,1,Warren,2022-02-13
0,1,1,0,1,Warren,2022-04-08
1,18,3,15,1,Warren,2022-01-23
1,21,6,15,1,Warren,2022-01-27
5,83,20,63,1,Warren,2022-01-10
5,26,4,22,1,Warren,2022-01-28
,0,0,0,1,Washington,2022-02-19
0,2,0,2,1,Washington,2021-12-26
0,24,11,13,1,Washington,2022-01-31
0,4,1,3,1,Washington,2022-02-05
0,4,0,4,1,Washington,2022-02-06
0,1,0,1,1,Washington,2022-02-21
0,3,2,1,1,Washington,2022-05-16
1,18,13,5,1,Washington,2022-01-28
1,2,0,2,1,Washington,2022-03-01
2,18,7,11,1,Washington,2022-02-02
2,8,3,5,1,Washington,2022-02-11
3,44,7,37,1,Washington,2022-01-17
,0,0,0,1,Watauga,2022-03-25
0,9,1,8,1,Watauga,2022-03-04
0,6,4,2,1,Watauga,2022-03-06
0,3,2,1,1,Watauga,2022-03-13
1,18,10,8,1,Watauga,2022-02-23
1,5,2,3,1,Watauga,2022-03-28
2,13,5,8,1,Watauga,2022-03-01
3,19,1,18,1,Watauga,2022-02-25
4,35,19,16,1,Watauga,2022-02-15
5,73,42,31,1,Watauga,2022-01-07
5,90,52,38,1,Watauga,2022-02-07
6,101,40,61,1,Watauga,2022-02-02
7,72,34,38,1,Watauga,2022-02-03
8,41,20,21,1,Watauga,2022-02-10
11,148,53,95,1,Watauga,2022-01-13
16,160,70,90,1,Watauga,2022-01-21
23,197,65,132,1,Watauga,2022-01-11
0,5,1,4,1,Wayne,2022-02-20
0,8,4,4,1,Wayne,2022-02-24
0,8,2,6,1,Wayne,2022-03-04
0,8,4,4,1,Wayne,2022-03-09
0,12,3,9,1,Wayne,2022-03-17
0,3,2,1,1,Wayne,2022-03-21
0,1,1,0,1,Wayne,2022-03-27
0,3,0,3,1,Wayne,2022-04-10
1,42,1,41,1,Wayne,2022-01-29
1,36,23,13,1,Wayne,2022-02-16
1,10,7,3,1,Wayne,2022-03-02
1,3,1,2,1,Wayne,2022-03-06
1,7,4,3,1,Wayne,2022-03-10
1,3,1,2,1,Wayne,2022-03-12
1,3,2,1,1,Wayne,2022-03-25
1,7,2,5,1,Wayne,2022-04-24
1,18,11,7,1,Wayne,2022-04-25
1,11,6,5,1,Wayne,2022-05-08
2,33,15,18,1,Wayne,2021-12-24
2,11,5,6,1,Wayne,2022-04-27
3,31,7,24,1,Wayne,2022-02-05
3,53,17,36,1,Wayne,2022-02-11
3,8,3,5,1,Wayne,2022-03-15
4,32,4,28,1,Wayne,2022-02-06
6,53,30,23,1,Wayne,2022-02-14
6,18,8,10,1,Wayne,2022-03-07
7,43,23,20,1,Wayne,2022-02-15
9,114,52,62,1,Wayne,2021-12-31
9,107,55,52,1,Wayne,2022-02-02
10,117,58,59,1,Wayne,2021-12-27
10,88,44,44,1,Wayne,2022-02-03
12,102,14,88,1,Wayne,2022-01-23
13,152,70,82,1,Wayne,2022-02-01
25,485,215,270,1,Wayne,2022-01-13
29,334,125,209,1,Wayne,2022-01-03
32,408,222,186,1,Wayne,2022-01-05
45,423,208,215,1,Wayne,2022-01-17
46,560,283,277,1,Wayne,2022-01-14
56,630,290,340,1,Wayne,2022-01-12
59,712,295,417,1,Wayne,2022-01-18
,0,0,0,1,Wilkes,2022-04-15
0,25,5,20,1,Wilkes,2021-12-14
0,20,5,15,1,Wilkes,2022-02-12
0,28,9,19,1,Wilkes,2022-02-28
0,10,1,9,1,Wilkes,2022-03-07
0,4,2,2,1,Wilkes,2022-03-10
0,2,1,1,1,Wilkes,2022-03-16
0,2,0,2,1,Wilkes,2022-03-25
0,1,1,0,1,Wilkes,2022-04-13
1,39,19,20,1,Wilkes,2021-12-21
1,39,10,29,1,Wilkes,2021-12-22
1,48,16,32,1,Wilkes,2021-12-23
1,28,15,13,1,Wilkes,2021-12-26
1,48,19,29,1,Wilkes,2022-01-29
1,26,12,14,1,Wilkes,2022-02-23
1,2,0,2,1,Wilkes,2022-03-15
1,19,7,12,1,Wilkes,2022-05-17
2,30,22,8,1,Wilkes,2022-02-06
3,102,32,70,1,Wilkes,2021-12-27
3,63,41,22,1,Wilkes,2022-01-02
4,94,32,62,1,Wilkes,2022-01-08
4,50,7,43,1,Wilkes,2022-01-17
4,28,13,15,1,Wilkes,2022-06-10
5,64,24,40,1,Wilkes,2022-02-09
5,30,18,12,1,Wilkes,2022-06-06
6,130,30,100,1,Wilkes,2022-01-26
6,37,23,14,1,Wilkes,2022-05-31
8,63,35,28,1,Wilkes,2022-01-09
9,122,43,79,1,Wilkes,2022-01-31
10,91,29,62,1,Wilkes,2022-01-22
10,111,54,57,1,Wilkes,2022-01-28
12,180,61,119,1,Wilkes,2022-01-21
16,148,71,77,1,Wilkes,2022-01-04
17,111,42,69,1,Wilkes,2022-02-01
18,213,79,134,1,Wilkes,2022-01-11
22,230,75,155,1,Wilkes,2022-01-12
,0,0,0,1,Wilson,2022-03-05
,0,0,0,1,Wilson,2022-03-20
0,1,1,0,1,Wilson,2022-03-13
0,1,0,1,1,Wilson,2022-03-28
0,1,1,0,1,Wilson,2022-04-05
1,16,6,10,1,Wilson,2022-02-05
1,20,3,17,1,Wilson,2022-02-06
1,16,1,15,1,Wilson,2022-02-11
1,26,6,20,1,Wilson,2022-02-14
1,30,5,25,1,Wilson,2022-02-15
1,14,5,9,1,Wilson,2022-02-21
1,9,6,3,1,Wilson,2022-02-24
1,7,0,7,1,Wilson,2022-02-25
1,3,0,3,1,Wilson,2022-02-26
1,5,2,3,1,Wilson,2022-03-04
1,6,4,2,1,Wilson,2022-03-07
1,3,1,2,1,Wilson,2022-03-19
1,9,3,6,1,Wilson,2022-05-15
2,38,8,30,1,Wilson,2021-12-22
2,73,12,61,1,Wilson,2022-02-02
2,12,2,10,1,Wilson,2022-02-18
2,15,6,9,1,Wilson,2022-05-21
2,10,3,7,1,Wilson,2022-05-29
3,46,18,28,1,Wilson,2022-01-01
3,20,12,8,1,Wilson,2022-06-07
4,29,10,19,1,Wilson,2021-12-23
4,67,20,47,1,Wilson,2022-01-02
4,52,10,42,1,Wilson,2022-01-21
5,43,18,25,1,Wilson,2022-02-07
7,60,19,41,1,Wilson,2022-01-23
8,81,18,63,1,Wilson,2022-01-15
8,31,14,17,1,Wilson,2022-05-23
19,258,80,178,1,Wilson,2022-01-24
20,185,52,133,1,Wilson,2021-12-28
25,278,59,219,1,Wilson,2022-01-14
26,249,46,203,1,Wilson,2021-12-30
26,305,73,232,1,Wilson,2022-01-11
28,351,64,287,1,Wilson,2022-01-06
31,301,65,236,1,Wilson,2022-01-13
0,45,17,28,1,Yadkin,2021-12-20
0,34,17,17,1,Yadkin,2021-12-26
0,21,9,12,1,Yadkin,2022-02-14
0,20,1,19,1,Yadkin,2022-02-15
0,3,0,3,1,Yadkin,2022-03-08
0,1,1,0,1,Yadkin,2022-03-10
0,3,0,3,1,Yadkin,2022-04-01
0,2,0,2,1,Yadkin,2022-04-15
1,10,3,7,1,Yadkin,2022-02-17
1,11,2,9,1,Yadkin,2022-02-21
1,1,1,0,1,Yadkin,2022-03-14
1,2,1,1,1,Yadkin,2022-03-16
3,45,13,32,1,Yadkin,2021-12-23
3,55,17,38,1,Yadkin,2022-01-31
4,99,36,63,1,Yadkin,2021-12-27
4,28,6,22,1,Yadkin,2022-01-17
4,48,19,29,1,Yadkin,2022-01-23
4,45,12,33,1,Yadkin,2022-01-28
5,60,17,43,1,Yadkin,2022-01-27
10,113,33,80,1,Yadkin,2021-12-30
11,150,17,133,1,Yadkin,2022-01-12
11,113,27,86,1,Yadkin,2022-01-25
21,154,42,112,1,Yadkin,2022-01-20
0,12,10,2,1,Yancey,2021-12-24
0,16,7,9,1,Yancey,2022-01-01
1,19,14,5,1,Yancey,2021-12-22
1,12,8,4,1,Yancey,2021-12-31
2,7,6,1,1,Yancey,2022-01-16
2,34,18,16,1,Yancey,2022-01-25
2,9,6,3,1,Yancey,2022-02-12
2,4,0,4,1,Yancey,2022-03-01
3,34,20,14,1,Yancey,2022-01-04
3,26,11,15,1,Yancey,2022-01-27
5,21,19,2,1,Yancey,2022-01-23
7,44,12,32,1,Yancey,2022-01-21
8,86,33,53,1,Yancey,2022-01-10
9,73,22,51,1,Yancey,2022-01-24
10,50,16,34,1,Yancey,2022-01-14
18,89,21,68,1,Yancey,2022-01-19
0,37,4,33,2,Alamance,2021-12-18
1,36,5,31,2,Alamance,2022-02-19
1,23,7,16,2,Alamance,2022-04-06
2,29,3,26,2,Alamance,2022-01-16
4,69,4,65,2,Alamance,2022-02-16
7,86,9,77,2,Alamance,2022-01-29
7,82,9,73,2,Alamance,2022-02-11
7,47,7,40,2,Alamance,2022-02-17
10,43,9,34,2,Alamance,2022-02-22
16,269,34,235,2,Alamance,2022-01-21
19,165,28,137,2,Alamance,2022-02-01
26,319,31,288,2,Alamance,2022-01-26
49,631,80,551,2,Alamance,2022-01-07
54,669,75,594,2,Alamance,2022-01-06
71,861,87,774,2,Alamance,2022-01-10
0,2,1,1,2,Alexander,2022-02-27
0,2,1,1,2,Alexander,2022-03-10
1,5,1,4,2,Alexander,2022-02-26
13,111,24,87,2,Alexander,2022-01-24
5,30,13,17,2,Alleghany,2022-02-01
7,71,17,54,2,Ashe,2022-01-25
7,111,20,91,2,Beaufort,2022-01-25
14,119,43,76,2,Beaufort,2022-01-17
20,216,30,186,2,Beaufort,2022-01-14
0,15,3,12,2,Bladen,2022-02-17
7,117,42,75,2,Bladen,2022-01-17
10,73,22,51,2,Bladen,2022-01-26
23,196,46,150,2,Bladen,2022-01-18
0,36,4,32,2,Brunswick,2022-02-21
0,16,3,13,2,Brunswick,2022-03-01
1,2,0,2,2,Brunswick,2022-03-06
2,22,3,19,2,Brunswick,2022-03-07
7,120,17,103,2,Brunswick,2022-01-23
9,93,15,78,2,Brunswick,2022-02-08
10,165,24,141,2,Brunswick,2022-01-15
13,142,15,127,2,Brunswick,2022-02-03
16,398,65,333,2,Brunswick,2022-01-20
17,183,23,160,2,Brunswick,2022-02-01
29,438,61,377,2,Brunswick,2022-01-12
1,53,7,46,2,Buncombe,2022-01-16
1,8,2,6,2,Buncombe,2022-03-20
2,39,7,32,2,Buncombe,2021-12-25
2,43,10,33,2,Buncombe,2022-02-19
2,54,17,37,2,Buncombe,2022-02-25
2,26,8,18,2,Buncombe,2022-03-04
3,141,27,114,2,Buncombe,2021-12-20
3,69,26,43,2,Buncombe,2022-02-23
6,90,35,55,2,Buncombe,2022-02-18
7,137,23,114,2,Buncombe,2022-01-30
11,279,76,203,2,Buncombe,2022-01-28
14,313,72,241,2,Buncombe,2021-12-31
21,364,73,291,2,Buncombe,2021-12-27
29,460,115,345,2,Buncombe,2022-01-21
39,619,169,450,2,Buncombe,2022-01-06
52,843,290,553,2,Buncombe,2022-01-10
0,32,12,20,2,Burke,2022-02-12
0,9,2,7,2,Burke,2022-02-25
0,12,2,10,2,Burke,2022-03-08
1,23,8,15,2,Burke,2021-12-14
2,115,16,99,2,Burke,2021-12-27
2,69,7,62,2,Burke,2022-01-02
2,51,16,35,2,Burke,2022-02-11
5,30,11,19,2,Burke,2022-02-17
6,127,31,96,2,Burke,2021-12-29
9,137,35,102,2,Burke,2022-01-28
22,226,66,160,2,Burke,2022-01-04
27,349,108,241,2,Burke,2022-01-14
1,15,2,13,2,Cabarrus,2022-02-26
2,27,5,22,2,Cabarrus,2022-02-25
3,46,11,35,2,Cabarrus,2022-02-12
6,58,6,52,2,Cabarrus,2021-12-25
8,102,30,72,2,Cabarrus,2022-02-10
18,227,67,160,2,Cabarrus,2022-01-23
24,305,88,217,2,Cabarrus,2022-01-17
25,237,62,175,2,Cabarrus,2022-02-01
26,386,99,287,2,Cabarrus,2022-01-25
31,322,98,224,2,Cabarrus,2022-01-31
48,611,131,480,2,Cabarrus,2022-01-20
54,647,130,517,2,Cabarrus,2022-01-05
58,728,173,555,2,Cabarrus,2022-01-11
0,10,0,10,2,Caldwell,2022-02-25
1,13,3,10,2,Caldwell,2022-02-23
4,40,3,37,2,Caldwell,2022-02-06
5,23,3,20,2,Caldwell,2022-01-16
9,78,14,64,2,Caldwell,2022-02-04
10,120,18,102,2,Caldwell,2022-01-22
12,101,16,85,2,Caldwell,2022-02-02
18,100,25,75,2,Caldwell,2022-01-28
28,188,36,152,2,Caldwell,2022-01-31
36,362,77,285,2,Caldwell,2022-01-11
37,264,54,210,2,Caldwell,2022-01-14
0,24,14,10,2,Carteret,2022-02-16
0,1,1,0,2,Carteret,2022-03-16
7,116,44,72,2,Carteret,2022-01-04
7,77,25,52,2,Carteret,2022-01-28
9,118,57,61,2,Carteret,2022-01-31
3,32,3,29,2,Caswell,2022-02-03
0,10,2,8,2,Catawba,2022-02-26
0,2,0,2,2,Catawba,2022-03-27
1,8,4,4,2,Catawba,2022-02-27
1,17,4,13,2,Catawba,2022-03-03
1,6,5,1,2,Catawba,2022-03-23
2,108,36,72,2,Catawba,2021-12-22
2,30,16,14,2,Catawba,2022-02-24
2,11,7,4,2,Catawba,2022-03-08
3,45,20,25,2,Catawba,2022-02-12
7,129,27,102,2,Catawba,2021-12-23
9,79,37,42,2,Catawba,2022-02-16
16,169,53,116,2,Catawba,2022-01-17
16,91,49,42,2,Catawba,2022-02-14
19,185,35,150,2,Catawba,2022-01-02
22,244,110,134,2,Catawba,2022-02-01
23,282,110,172,2,Catawba,2022-01-15
26,352,139,213,2,Catawba,2022-01-26
30,318,109,209,2,Catawba,2022-01-27
38,503,196,307,2,Catawba,2022-01-03
43,452,178,274,2,Catawba,2022-01-21
45,605,228,377,2,Catawba,2022-01-20
46,419,165,254,2,Catawba,2022-01-04
75,724,274,450,2,Catawba,2022-01-19
79,778,324,454,2,Catawba,2022-01-10
86,686,236,450,2,Catawba,2022-01-13
88,758,277,481,2,Catawba,2022-01-12
2,64,20,44,2,Chatham,2022-01-23
0,29,1,28,2,Cherokee,2022-02-04
3,47,7,40,2,Cherokee,2022-01-05
4,22,4,18,2,Cherokee,2022-02-11
5,31,2,29,2,Chowan,2022-01-27
0,16,2,14,2,Cleveland,2022-02-23
0,3,0,3,2,Cleveland,2022-03-23
1,55,9,46,2,Cleveland,2021-12-20
1,10,1,9,2,Cleveland,2022-02-26
3,57,6,51,2,Cleveland,2021-12-14
4,33,9,24,2,Cleveland,2022-02-18
5,62,8,54,2,Cleveland,2022-02-05
5,67,18,49,2,Cleveland,2022-02-10
6,57,10,47,2,Cleveland,2022-02-11
10,61,11,50,2,Cleveland,2022-02-14
14,151,21,130,2,Cleveland,2022-02-02
31,339,54,285,2,Cleveland,2022-01-14
37,385,69,316,2,Cleveland,2022-01-19
4,25,16,9,2,Columbus,2022-02-14
16,187,64,123,2,Columbus,2022-01-20
22,326,156,170,2,Columbus,2022-01-12
35,326,116,210,2,Columbus,2022-01-18
35,266,107,159,2,Columbus,2022-01-24
0,36,3,33,2,Craven,2022-01-22
3,41,14,27,2,Craven,2022-02-17
6,130,42,88,2,Craven,2022-01-15
7,164,36,128,2,Craven,2022-01-28
7,146,40,106,2,Craven,2022-02-01
7,108,32,76,2,Craven,2022-02-03
7,63,14,49,2,Craven,2022-02-14
9,124,23,101,2,Craven,2022-02-02
17,397,99,298,2,Craven,2022-01-24
20,328,129,199,2,Craven,2022-01-17
24,520,149,371,2,Craven,2022-01-18
2,26,8,18,2,Cumberland,2022-02-20
2,11,3,8,2,Cumberland,2022-03-05
3,18,2,16,2,Cumberland,2022-03-04
8,140,17,123,2,Cumberland,2022-02-16
8,72,13,59,2,Cumberland,2022-02-23
9,93,18,75,2,Cumberland,2022-02-06
9,77,16,61,2,Cumberland,2022-04-26
11,121,26,95,2,Cumberland,2022-02-17
12,151,30,121,2,Cumberland,2022-02-11
12,114,6,108,2,Cumberland,2022-02-22
12,111,19,92,2,Cumberland,2022-05-09
14,209,12,197,2,Cumberland,2022-01-22
15,209,21,188,2,Cumberland,2022-01-29
19,196,21,175,2,Cumberland,2022-01-16
21,294,25,269,2,Cumberland,2022-01-01
24,305,63,242,2,Cumberland,2022-02-07
32,367,46,321,2,Cumberland,2022-02-04
35,621,82,539,2,Cumberland,2022-01-28
37,724,58,666,2,Cumberland,2022-01-26
44,438,57,381,2,Cumberland,2022-02-02
54,986,120,866,2,Cumberland,2022-01-17
95,1631,159,1472,2,Cumberland,2022-01-18
96,1462,127,1335,2,Cumberland,2022-01-19
104,1468,140,1328,2,Cumberland,2022-01-11
118,1025,125,900,2,Cumberland,2022-01-06
0,7,0,7,2,Dare,2022-02-20
1,54,6,48,2,Davidson,2021-12-24
2,15,4,11,2,Davidson,2022-03-02
3,28,2,26,2,Davidson,2021-12-25
3,29,4,25,2,Davidson,2022-01-16
4,28,2,26,2,Davidson,2022-02-13
5,105,16,89,2,Davidson,2022-01-22
9,133,29,104,2,Davidson,2022-02-07
13,101,11,90,2,Davidson,2022-02-08
14,152,23,129,2,Davidson,2022-01-23
17,148,21,127,2,Davidson,2022-01-17
27,258,34,224,2,Davidson,2022-01-31
43,363,49,314,2,Davidson,2022-01-07
67,643,86,557,2,Davidson,2022-01-12
75,656,116,540,2,Davidson,2022-01-13
1,39,14,25,2,Davie,2022-01-17
3,60,13,47,2,Davie,2022-01-27
8,93,20,73,2,Davie,2022-01-31
0,26,3,23,2,Duplin,2022-01-01
0,3,1,2,2,Duplin,2022-03-08
1,9,2,7,2,Duplin,2022-02-05
3,22,8,14,2,Duplin,2022-02-15
4,40,13,27,2,Duplin,2022-02-08
10,99,52,47,2,Duplin,2022-01-28
18,170,60,110,2,Duplin,2022-01-25
2,30,1,29,2,Durham,2022-03-21
3,75,15,60,2,Durham,2022-02-18
3,21,2,19,2,Durham,2022-02-27
6,66,6,60,2,Durham,2022-04-05
7,176,13,163,2,Durham,2022-02-08
7,132,12,120,2,Durham,2022-02-11
15,338,30,308,2,Durham,2022-01-28
24,425,10,415,2,Durham,2022-01-23
41,668,21,647,2,Durham,2022-01-15
42,639,43,596,2,Durham,2022-01-26
44,871,34,837,2,Durham,2022-01-20
49,946,66,880,2,Durham,2022-01-14
94,1356,81,1275,2,Durham,2022-01-11
4,43,1,42,2,Edgecombe,2022-01-28
23,216,7,209,2,Edgecombe,2022-01-18
25,185,10,175,2,Edgecombe,2022-01-12
0,17,3,14,2,Forsyth,2022-03-04
2,24,1,23,2,Forsyth,2022-02-26
3,36,6,30,2,Forsyth,2022-02-25
3,36,5,31,2,Forsyth,2022-03-03
6,153,13,140,2,Forsyth,2022-02-05
9,188,19,169,2,Forsyth,2022-01-29
10,122,23,99,2,Forsyth,2022-02-15
13,95,22,73,2,Forsyth,2022-04-25
14,158,25,133,2,Forsyth,2022-02-14
15,271,55,216,2,Forsyth,2022-01-17
22,333,46,287,2,Forsyth,2021-12-23
22,302,25,277,2,Forsyth,2022-01-23
27,427,34,393,2,Forsyth,2022-01-09
41,695,73,622,2,Forsyth,2022-01-26
75,1037,101,936,2,Forsyth,2022-01-03
101,1176,119,1057,2,Forsyth,2022-01-06
101,1515,126,1389,2,Forsyth,2022-01-11
29,361,27,334,2,Franklin,2022-01-24
0,1,0,1,2,Gaston,2022-03-12
2,51,9,42,2,Gaston,2022-02-13
2,18,7,11,2,Gaston,2022-03-01
5,121,25,96,2,Gaston,2021-12-15
6,85,26,59,2,Gaston,2021-12-24
8,92,19,73,2,Gaston,2022-02-06
9,77,13,64,2,Gaston,2022-02-17
13,154,31,123,2,Gaston,2022-01-30
13,116,38,78,2,Gaston,2022-02-14
19,216,43,173,2,Gaston,2022-02-03
42,358,86,272,2,Gaston,2022-01-31
46,451,98,353,2,Gaston,2022-01-26
51,525,103,422,2,Gaston,2022-01-21
55,689,135,554,2,Gaston,2022-01-14
57,582,94,488,2,Gaston,2021-12-30
68,714,141,573,2,Gaston,2022-01-20
69,737,96,641,2,Gaston,2022-01-04
92,913,151,762,2,Gaston,2022-01-10
12,114,10,104,2,Granville,2022-01-25
,0,0,0,2,Greene,2022-03-15
0,48,10,38,2,Guilford,2022-02-25
0,23,6,17,2,Guilford,2022-03-09
0,7,1,6,2,Guilford,2022-03-13
0,13,4,9,2,Guilford,2022-03-25
0,9,1,8,2,Guilford,2022-03-27
3,52,18,34,2,Guilford,2022-03-01
5,42,8,34,2,Guilford,2022-04-09
6,91,26,65,2,Guilford,2022-04-13
7,112,14,98,2,Guilford,2022-02-12
10,198,41,157,2,Guilford,2022-02-15
12,198,43,155,2,Guilford,2021-12-24
12,226,45,181,2,Guilford,2022-02-09
14,178,40,138,2,Guilford,2022-02-14
15,213,33,180,2,Guilford,2022-01-29
21,207,30,177,2,Guilford,2022-05-24
25,412,62,350,2,Guilford,2021-12-22
28,438,88,350,2,Guilford,2022-02-02
36,282,43,239,2,Guilford,2022-05-31
74,1253,205,1048,2,Guilford,2021-12-29
92,1192,165,1027,2,Guilford,2022-01-03
127,1701,335,1366,2,Guilford,2022-01-06
0,8,0,8,2,Halifax,2022-02-22
0,1,0,1,2,Halifax,2022-03-13
2,29,10,19,2,Halifax,2022-02-04
3,34,8,26,2,Halifax,2022-02-03
18,172,34,138,2,Halifax,2022-01-24
19,203,29,174,2,Halifax,2022-01-14
23,242,23,219,2,Halifax,2022-01-11
2,50,15,35,2,Harnett,2021-12-15
8,177,54,123,2,Harnett,2022-02-01
13,240,39,201,2,Harnett,2022-01-15
21,268,54,214,2,Harnett,2022-01-26
34,498,107,391,2,Harnett,2022-01-24
38,555,119,436,2,Harnett,2022-01-14
42,382,97,285,2,Harnett,2022-01-17
0,27,10,17,2,Haywood,2022-02-11
0,4,1,3,2,Haywood,2022-03-04
0,7,2,5,2,Haywood,2022-03-08
1,22,5,17,2,Haywood,2022-02-15
1,12,4,8,2,Haywood,2022-03-07
1,3,1,2,2,Haywood,2022-03-09
3,13,8,5,2,Haywood,2022-02-20
4,65,21,44,2,Haywood,2021-12-27
4,65,19,46,2,Haywood,2022-02-03
0,7,2,5,2,Henderson,2022-03-10
1,14,2,12,2,Henderson,2022-01-16
2,19,8,11,2,Henderson,2022-04-26
6,89,27,62,2,Henderson,2022-01-08
6,55,19,36,2,Henderson,2022-01-30
7,78,23,55,2,Henderson,2022-01-22
7,49,21,28,2,Henderson,2022-02-05
8,123,40,83,2,Henderson,2022-02-02
9,38,19,19,2,Henderson,2022-02-21
10,137,18,119,2,Henderson,2021-12-28
11,103,37,66,2,Henderson,2022-01-09
11,92,37,55,2,Henderson,2022-01-23
15,156,50,106,2,Henderson,2022-01-27
18,184,71,113,2,Henderson,2022-01-03
18,137,54,83,2,Henderson,2022-01-28
22,277,82,195,2,Henderson,2022-01-13
29,276,100,176,2,Henderson,2022-01-19
1,50,11,39,2,Hoke,2022-02-03
7,116,19,97,2,Hoke,2022-01-26
18,277,17,260,2,Hoke,2022-01-13
0,2,1,1,2,Iredell,2022-03-05
1,37,9,28,2,Iredell,2022-02-12
2,62,19,43,2,Iredell,2021-12-18
2,36,14,22,2,Iredell,2022-02-13
3,91,21,70,2,Iredell,2022-01-29
3,43,14,29,2,Iredell,2022-02-18
4,152,52,100,2,Iredell,2021-12-22
5,106,45,61,2,Iredell,2022-02-09
7,80,30,50,2,Iredell,2022-02-14
13,192,96,96,2,Iredell,2022-01-02
13,220,65,155,2,Iredell,2022-01-15
16,320,109,211,2,Iredell,2021-12-27
20,334,113,221,2,Iredell,2022-01-21
28,334,102,232,2,Iredell,2022-01-31
32,506,159,347,2,Iredell,2022-01-20
37,451,190,261,2,Iredell,2022-01-03
42,479,168,311,2,Iredell,2022-01-06
65,633,242,391,2,Iredell,2022-01-10
0,5,3,2,2,Johnston,2022-03-27
1,31,8,23,2,Johnston,2022-02-19
1,24,2,22,2,Johnston,2022-03-01
2,41,13,28,2,Johnston,2022-02-13
2,16,3,13,2,Johnston,2022-02-26
3,15,4,11,2,Johnston,2022-03-03
6,85,21,64,2,Johnston,2022-02-16
8,204,26,178,2,Johnston,2022-01-02
8,97,24,73,2,Johnston,2022-02-14
9,97,17,80,2,Johnston,2022-01-22
11,109,26,83,2,Johnston,2022-02-10
11,88,19,69,2,Johnston,2022-02-15
16,330,78,252,2,Johnston,2022-01-28
20,409,59,350,2,Johnston,2022-01-27
63,852,164,688,2,Johnston,2022-01-17
68,969,159,810,2,Johnston,2022-01-14
76,859,130,729,2,Johnston,2022-01-03
0,20,0,20,2,Lee,2021-12-14
0,7,1,6,2,Lee,2021-12-25
1,23,3,20,2,Lee,2022-01-22
0,6,3,3,2,Lenoir,2022-02-17
0,9,4,5,2,Lenoir,2022-02-28
0,4,0,4,2,Lenoir,2022-03-01
0,2,0,2,2,Lenoir,2022-03-23
2,25,5,20,2,Lenoir,2021-12-22
5,33,12,21,2,Lenoir,2022-02-08
8,105,28,77,2,Lenoir,2022-01-27
9,100,17,83,2,Lenoir,2022-01-28
0,1,0,1,2,Lincoln,2022-03-16
2,14,7,7,2,Lincoln,2022-02-20
5,49,11,38,2,Lincoln,2022-02-10
6,45,11,34,2,Lincoln,2022-01-29
12,78,22,56,2,Lincoln,2022-02-07
18,185,61,124,2,Lincoln,2022-01-21
21,163,69,94,2,Lincoln,2022-01-31
23,286,67,219,2,Lincoln,2022-01-18
33,253,69,184,2,Lincoln,2022-01-20
1,16,2,14,2,Macon,2022-02-10
5,61,18,43,2,Macon,2022-01-19
4,18,0,18,2,Martin,2022-02-03
6,91,28,63,2,McDowell,2022-02-07
9,60,14,46,2,McDowell,2022-02-08
15,148,52,96,2,McDowell,2022-01-20
0,49,17,32,2,Mecklenburg,2022-03-17
1,22,4,18,2,Mecklenburg,2022-03-20
4,93,18,75,2,Mecklenburg,2022-03-01
5,137,28,109,2,Mecklenburg,2022-02-25
5,66,12,54,2,Mecklenburg,2022-03-08
9,129,23,106,2,Mecklenburg,2022-02-28
13,237,41,196,2,Mecklenburg,2022-02-17
17,459,92,367,2,Mecklenburg,2021-12-14
18,484,70,414,2,Mecklenburg,2021-12-15
19,367,25,342,2,Mecklenburg,2021-12-25
24,218,43,175,2,Mecklenburg,2022-04-19
25,263,43,220,2,Mecklenburg,2022-06-04
30,397,69,328,2,Mecklenburg,2022-02-11
41,400,52,348,2,Mecklenburg,2022-05-04
47,499,80,419,2,Mecklenburg,2022-05-23
54,1223,106,1117,2,Mecklenburg,2021-12-20
156,2141,438,1703,2,Mecklenburg,2021-12-31
212,2944,358,2586,2,Mecklenburg,2021-12-27
285,3657,651,3006,2,Mecklenburg,2022-01-03
2,10,0,10,2,Montgomery,2022-02-05
0,23,3,20,2,Moore,2022-02-12
0,3,1,2,2,Moore,2022-03-09
1,26,5,21,2,Moore,2022-01-30
1,50,6,44,2,Moore,2022-02-08
1,51,15,36,2,Moore,2022-02-11
1,39,10,29,2,Moore,2022-02-15
2,52,14,38,2,Moore,2022-02-09
5,48,8,40,2,Moore,2022-02-10
7,203,23,180,2,Moore,2022-01-09
10,105,18,87,2,Moore,2022-02-02
17,317,38,279,2,Moore,2022-01-05
23,309,52,257,2,Moore,2022-01-20
29,472,53,419,2,Moore,2022-01-11
33,424,62,362,2,Moore,2022-01-19
0,1,0,1,2,Nash,2022-03-06
2,46,4,42,2,Nash,2021-12-15
3,34,3,31,2,Nash,2022-02-10
4,40,2,38,2,Nash,2022-01-16
5,34,4,30,2,Nash,2022-01-30
10,82,11,71,2,Nash,2022-02-02
15,92,7,85,2,Nash,2022-01-15
22,282,34,248,2,Nash,2022-01-24
41,456,31,425,2,Nash,2022-01-03
45,579,52,527,2,Nash,2022-01-10
46,387,26,361,2,Nash,2022-01-19
0,10,2,8,2,New Hanover,2022-02-27
1,66,17,49,2,New Hanover,2022-02-16
1,20,9,11,2,New Hanover,2022-02-19
6,88,24,64,2,New Hanover,2022-01-01
8,113,23,90,2,New Hanover,2022-01-29
8,208,34,174,2,New Hanover,2022-02-04
9,132,32,100,2,New Hanover,2022-02-08
11,300,62,238,2,New Hanover,2022-01-28
16,258,84,174,2,New Hanover,2021-12-31
16,249,46,203,2,New Hanover,2022-02-01
40,689,133,556,2,New Hanover,2022-01-12
61,872,297,575,2,New Hanover,2022-01-18
3,18,7,11,2,Northampton,2022-01-27
0,116,10,106,2,Onslow,2021-12-20
0,32,4,28,2,Onslow,2022-02-13
0,7,0,7,2,Onslow,2022-02-26
0,10,4,6,2,Onslow,2022-03-02
1,38,5,33,2,Onslow,2022-02-18
2,74,6,68,2,Onslow,2022-02-11
2,37,4,33,2,Onslow,2022-02-12
3,96,13,83,2,Onslow,2022-02-09
3,54,5,49,2,Onslow,2022-02-22
5,67,2,65,2,Onslow,2022-02-06
6,46,1,45,2,Onslow,2022-02-05
6,147,17,130,2,Onslow,2022-02-10
12,245,35,210,2,Onslow,2022-02-02
13,311,9,302,2,Onslow,2022-01-15
41,789,87,702,2,Onslow,2022-01-24
43,549,108,441,2,Onslow,2022-01-14
48,756,109,647,2,Onslow,2022-01-20
1,36,3,33,2,Orange,2022-02-18
22,555,19,536,2,Orange,2022-01-19
1,43,8,35,2,Pasquotank,2022-01-28
1,19,5,14,2,Pasquotank,2022-02-04
7,103,20,83,2,Pasquotank,2022-01-18
,0,0,0,2,Pender,2022-03-26
3,24,4,20,2,Pender,2022-02-11
3,73,3,70,2,Person,2022-01-25
1,18,0,18,2,Pitt,2022-02-20
1,7,1,6,2,Pitt,2022-02-26
2,35,11,24,2,Pitt,2021-12-24
18,247,11,236,2,Pitt,2022-01-23
25,241,24,217,2,Pitt,2022-02-01
42,483,39,444,2,Pitt,2022-01-25
46,450,52,398,2,Pitt,2022-01-26
105,1048,63,985,2,Pitt,2022-01-10
105,907,58,849,2,Pitt,2022-01-12
110,1030,86,944,2,Pitt,2022-01-18
1,19,9,10,2,Polk,2022-01-28
0,16,3,13,2,Randolph,2022-02-20
0,10,2,8,2,Randolph,2022-03-07
0,3,0,3,2,Randolph,2022-03-17
0,3,1,2,2,Randolph,2022-04-08
2,77,27,50,2,Randolph,2021-12-14
2,26,4,22,2,Randolph,2022-02-12
2,44,12,32,2,Randolph,2022-02-16
3,21,7,14,2,Randolph,2022-02-13
4,46,7,39,2,Randolph,2022-02-06
7,112,48,64,2,Randolph,2022-01-02
7,32,9,23,2,Randolph,2022-02-17
11,87,34,53,2,Randolph,2022-02-04
13,157,39,118,2,Randolph,2022-02-01
17,161,33,128,2,Randolph,2022-01-23
19,271,69,202,2,Randolph,2022-01-26
23,238,52,186,2,Randolph,2022-01-15
26,265,80,185,2,Randolph,2021-12-28
30,323,108,215,2,Randolph,2022-01-21
31,405,80,325,2,Randolph,2022-01-14
33,396,98,298,2,Randolph,2022-01-24
49,470,94,376,2,Randolph,2022-01-13
0,9,2,7,2,Richmond,2022-01-22
1,5,1,4,2,Richmond,2022-02-06
2,14,3,11,2,Richmond,2022-01-29
6,53,22,31,2,Richmond,2022-02-07
9,122,10,112,2,Richmond,2022-01-03
19,148,38,110,2,Richmond,2022-01-20
19,178,47,131,2,Richmond,2022-01-24
0,16,7,9,2,Robeson,2022-02-23
1,12,6,6,2,Robeson,2022-02-25
1,3,0,3,2,Robeson,2022-03-13
3,28,16,12,2,Robeson,2022-02-21
4,74,18,56,2,Robeson,2022-02-08
4,32,9,23,2,Robeson,2022-02-17
5,57,23,34,2,Robeson,2022-02-09
5,23,9,14,2,Robeson,2022-02-18
7,87,31,56,2,Robeson,2022-01-21
13,83,58,25,2,Robeson,2022-01-16
24,111,50,61,2,Robeson,2022-02-07
39,449,154,295,2,Robeson,2022-01-05
0,11,0,11,2,Rockingham,2021-12-25
0,14,2,12,2,Rockingham,2022-02-13
1,15,1,14,2,Rockingham,2022-02-25
1,13,0,13,2,Rockingham,2022-03-02
3,72,8,64,2,Rockingham,2022-02-03
3,63,4,59,2,Rockingham,2022-02-04
12,209,21,188,2,Rockingham,2022-01-21
15,130,9,121,2,Rockingham,2022-01-31
17,277,54,223,2,Rockingham,2022-01-06
18,199,38,161,2,Rockingham,2021-12-29
23,332,27,305,2,Rockingham,2022-01-11
,0,0,0,2,Rowan,2022-03-05
,0,0,0,2,Rowan,2022-03-19
0,6,2,4,2,Rowan,2022-03-10
0,4,0,4,2,Rowan,2022-03-20
1,12,1,11,2,Rowan,2022-02-24
2,65,4,61,2,Rowan,2021-12-15
3,22,2,20,2,Rowan,2022-04-26
4,36,6,30,2,Rowan,2022-02-21
6,104,9,95,2,Rowan,2022-02-04
10,162,29,133,2,Rowan,2022-01-08
13,108,35,73,2,Rowan,2022-01-23
15,256,38,218,2,Rowan,2022-01-21
45,359,88,271,2,Rowan,2022-01-03
0,23,3,20,2,Rutherford,2021-12-21
0,9,2,7,2,Rutherford,2022-02-13
1,4,1,3,2,Rutherford,2022-03-02
3,13,8,5,2,Rutherford,2022-01-16
4,90,38,52,2,Rutherford,2022-02-01
6,73,14,59,2,Rutherford,2022-02-03
6,46,15,31,2,Rutherford,2022-02-09
8,37,13,24,2,Rutherford,2022-01-01
8,203,126,77,2,Rutherford,2022-01-25
18,195,77,118,2,Rutherford,2022-01-24
0,7,3,4,2,Sampson,2022-02-06
0,34,10,24,2,Sampson,2022-02-08
0,2,0,2,2,Sampson,2022-02-20
1,18,7,11,2,Sampson,2022-02-23
3,28,13,15,2,Sampson,2022-02-16
4,156,55,101,2,Sampson,2022-01-26
10,192,73,119,2,Sampson,2022-01-25
0,12,7,5,2,Scotland,2022-01-30
4,33,8,25,2,Scotland,2022-02-01
6,78,13,65,2,Scotland,2022-01-09
11,115,35,80,2,Scotland,2022-01-24
0,5,0,5,2,Stanly,2022-03-01
8,62,30,32,2,Stanly,2022-01-23
10,52,3,49,2,Stanly,2022-02-04
18,111,16,95,2,Stanly,2022-01-31
20,213,85,128,2,Stanly,2022-01-03
23,266,40,226,2,Stanly,2022-01-14
37,311,67,244,2,Stanly,2022-01-13
51,358,65,293,2,Stanly,2022-01-12
0,12,0,12,2,Stokes,2022-02-12
1,19,5,14,2,Stokes,2022-01-29
1,3,0,3,2,Stokes,2022-03-05
2,41,5,36,2,Stokes,2022-02-03
3,27,2,25,2,Stokes,2022-02-10
10,106,18,88,2,Stokes,2022-01-25
17,131,19,112,2,Stokes,2022-01-18
,0,0,0,2,Surry,2022-03-19
0,7,0,7,2,Surry,2022-03-14
1,7,2,5,2,Surry,2022-03-03
2,58,29,29,2,Surry,2022-01-30
3,22,7,15,2,Surry,2022-02-22
4,47,12,35,2,Surry,2022-02-11
10,79,34,45,2,Surry,2022-01-02
22,225,72,153,2,Surry,2022-01-14
25,346,121,225,2,Surry,2022-01-10
31,321,78,243,2,Surry,2022-01-12
1,5,0,5,2,Swain,2021-12-21
2,11,4,7,2,Swain,2022-02-09
1,25,4,21,2,Transylvania,2022-02-04
0,14,1,13,2,Union,2022-03-28
1,14,5,9,2,Union,2022-03-08
3,41,11,30,2,Union,2022-02-21
5,188,27,161,2,Union,2021-12-22
5,53,15,38,2,Union,2022-02-18
8,88,17,71,2,Union,2022-02-14
9,180,45,135,2,Union,2022-02-02
10,170,44,126,2,Union,2022-02-07
11,99,29,70,2,Union,2022-02-09
21,383,112,271,2,Union,2022-01-15
27,297,61,236,2,Union,2022-01-28
30,523,109,414,2,Union,2021-12-28
41,575,153,422,2,Union,2022-01-03
49,568,107,461,2,Union,2022-01-21
60,862,159,703,2,Union,2022-01-11
65,768,172,596,2,Union,2022-01-04
86,891,174,717,2,Union,2022-01-12
0,4,2,2,2,Vance,2022-04-11
4,23,3,20,2,Vance,2022-01-30
1,44,8,36,2,Wake,2022-03-06
1,97,4,93,2,Wake,2022-03-08
2,126,15,111,2,Wake,2022-02-26
4,45,8,37,2,Wake,2022-03-20
5,124,12,112,2,Wake,2022-03-03
5,61,8,53,2,Wake,2022-03-12
6,83,7,76,2,Wake,2022-03-10
6,122,13,109,2,Wake,2022-03-21
9,219,32,187,2,Wake,2022-02-24
14,437,42,395,2,Wake,2021-12-15
14,243,17,226,2,Wake,2022-04-14
15,297,31,266,2,Wake,2022-02-22
27,384,40,344,2,Wake,2022-02-21
34,757,46,711,2,Wake,2022-02-05
34,570,51,519,2,Wake,2022-02-11
41,789,52,737,2,Wake,2021-12-20
42,667,64,603,2,Wake,2022-05-02
68,1101,98,1003,2,Wake,2022-02-03
73,999,101,898,2,Wake,2022-05-09
97,1828,134,1694,2,Wake,2022-01-28
141,3102,212,2890,2,Wake,2022-01-25
279,4909,241,4668,2,Wake,2022-01-14
314,5343,292,5051,2,Wake,2022-01-19
2,24,5,19,2,Watauga,2021-12-23
2,40,17,23,2,Watauga,2022-02-09
3,39,21,18,2,Watauga,2022-01-22
5,55,26,29,2,Watauga,2022-01-23
5,89,47,42,2,Watauga,2022-01-28
0,1,1,0,2,Wayne,2022-03-19
1,46,26,20,2,Wayne,2021-12-22
3,58,4,54,2,Wayne,2022-01-30
5,51,22,29,2,Wayne,2022-02-09
8,99,61,38,2,Wayne,2022-02-07
14,165,61,104,2,Wayne,2022-01-28
17,191,82,109,2,Wayne,2022-01-31
45,435,206,229,2,Wayne,2022-01-24
56,656,342,314,2,Wayne,2022-01-11
2,45,22,23,2,Wilkes,2022-02-11
2,30,11,19,2,Wilkes,2022-02-17
3,33,11,22,2,Wilkes,2022-02-16
5,26,3,23,2,Wilkes,2022-01-16
5,101,69,32,2,Wilkes,2022-02-08
10,200,44,156,2,Wilkes,2022-01-24
10,57,18,39,2,Wilkes,2022-02-07
13,107,38,69,2,Wilkes,2022-01-27
1,28,7,21,2,Wilson,2022-02-10
3,10,1,9,2,Wilson,2022-02-19
4,95,27,68,2,Wilson,2022-01-31
5,36,11,25,2,Wilson,2022-01-16
9,114,25,89,2,Wilson,2022-01-27
22,190,41,149,2,Wilson,2022-01-25
38,342,72,270,2,Wilson,2022-01-12
38,336,70,266,2,Wilson,2022-01-18
39,430,91,339,2,Wilson,2022-01-10
0,2,0,2,2,Yadkin,2022-03-22
2,21,4,17,2,Yadkin,2021-12-25
2,2,1,1,2,Yadkin,2022-02-27
5,70,13,57,2,Yadkin,2022-01-08
7,50,12,38,2,Yadkin,2022-02-02
3,50,34,16,2,Yancey,2022-01-18
3,32,9,23,3,Alamance,2022-02-13
12,88,10,78,3,Alamance,2022-02-10
13,141,12,129,3,Alamance,2022-02-02
13,139,15,124,3,Alamance,2022-02-04
18,205,15,190,3,Alamance,2022-01-28
20,239,27,212,3,Alamance,2022-01-31
46,557,77,480,3,Alamance,2022-01-18
46,556,44,512,3,Alamance,2022-01-19
53,717,76,641,3,Alamance,2022-01-12
1,10,0,10,3,Bertie,2022-01-29
2,48,10,38,3,Brunswick,2022-02-15
3,29,6,23,3,Brunswick,2022-02-19
4,88,6,82,3,Brunswick,2022-01-29
4,87,20,67,3,Brunswick,2022-01-30
4,114,19,95,3,Brunswick,2022-02-04
6,71,2,69,3,Brunswick,2022-02-05
6,59,9,50,3,Brunswick,2022-02-10
8,392,55,337,3,Brunswick,2022-01-24
44,482,77,405,3,Brunswick,2022-01-19
0,26,4,22,3,Buncombe,2022-03-07
0,36,6,30,3,Buncombe,2022-05-01
6,98,21,77,3,Buncombe,2022-01-29
7,177,77,100,3,Buncombe,2022-02-14
7,115,56,59,3,Buncombe,2022-05-03
8,208,77,131,3,Buncombe,2022-02-08
16,289,47,242,3,Buncombe,2022-01-08
17,235,87,148,3,Buncombe,2022-02-04
21,219,98,121,3,Buncombe,2022-02-07
35,697,213,484,3,Buncombe,2022-01-20
7,97,30,67,3,Burke,2022-02-08
10,110,31,79,3,Burke,2022-02-03
23,292,93,199,3,Burke,2022-01-24
1,28,10,18,3,Cabarrus,2022-02-19
2,23,5,18,3,Cabarrus,2022-02-20
2,14,3,11,3,Cabarrus,2022-03-02
3,59,7,52,3,Cabarrus,2021-12-18
4,46,14,32,3,Cabarrus,2022-02-13
4,19,5,14,3,Cabarrus,2022-03-01
6,97,20,77,3,Cabarrus,2022-02-05
9,117,32,85,3,Cabarrus,2022-01-29
14,199,34,165,3,Cabarrus,2021-12-22
16,182,39,143,3,Cabarrus,2022-02-03
18,209,52,157,3,Cabarrus,2021-12-23
28,313,73,240,3,Cabarrus,2022-01-27
51,679,128,551,3,Cabarrus,2022-01-12
60,636,176,460,3,Cabarrus,2022-01-06
2,36,3,33,3,Caldwell,2022-02-05
5,45,8,37,3,Caldwell,2022-02-11
13,138,28,110,3,Caldwell,2022-02-01
24,187,38,149,3,Caldwell,2022-01-27
2,34,9,25,3,Catawba,2022-02-23
3,69,24,45,3,Catawba,2022-02-05
3,23,10,13,3,Catawba,2022-02-19
6,53,13,40,3,Catawba,2022-02-18
13,114,41,73,3,Catawba,2022-02-10
46,410,156,254,3,Catawba,2022-01-25
53,609,195,414,3,Catawba,2022-01-18
1,20,8,12,3,Cleveland,2022-02-22
3,59,8,51,3,Cleveland,2022-02-09
8,107,19,88,3,Cleveland,2022-02-07
16,93,18,75,3,Cleveland,2022-02-08
34,324,44,280,3,Cleveland,2022-01-20
6,45,18,27,3,Columbus,2022-02-03
8,123,52,71,3,Columbus,2022-01-26
4,42,4,38,3,Cumberland,2022-02-25
6,89,15,74,3,Cumberland,2022-02-12
9,110,10,100,3,Cumberland,2022-02-18
21,406,29,377,3,Cumberland,2022-01-08
24,174,48,126,3,Cumberland,2022-02-10
27,379,51,328,3,Cumberland,2022-02-03
29,470,54,416,3,Cumberland,2022-01-15
53,978,131,847,3,Cumberland,2022-01-14
54,1030,73,957,3,Cumberland,2022-01-25
1,34,3,31,3,Davidson,2022-02-12
1,20,5,15,3,Davidson,2022-02-24
5,94,12,82,3,Davidson,2021-12-22
7,44,11,33,3,Davidson,2022-02-21
10,80,7,73,3,Davidson,2022-01-29
13,152,17,135,3,Davidson,2022-01-02
16,169,28,141,3,Davidson,2022-02-02
16,148,17,131,3,Davidson,2022-02-04
17,198,15,183,3,Davidson,2022-02-01
21,341,36,305,3,Davidson,2022-01-25
70,629,76,553,3,Davidson,2022-01-14
26,350,146,204,3,Duplin,2022-01-19
2,61,5,56,3,Durham,2022-02-13
21,315,20,295,3,Durham,2022-01-21
33,662,27,635,3,Durham,2022-01-25
1,4,1,3,3,Edgecombe,2022-02-06
1,95,3,92,3,Forsyth,2021-12-18
10,93,12,81,3,Forsyth,2022-02-22
13,167,30,137,3,Forsyth,2022-02-10
13,132,18,114,3,Forsyth,2022-02-11
14,357,22,335,3,Forsyth,2022-01-22
15,287,34,253,3,Forsyth,2022-02-03
20,197,37,160,3,Forsyth,2022-02-09
34,726,94,632,3,Forsyth,2021-12-27
55,788,89,699,3,Forsyth,2022-01-25
67,1004,138,866,3,Forsyth,2022-01-18
109,1642,163,1479,3,Forsyth,2022-01-10
1,34,12,22,3,Gaston,2022-02-19
6,58,10,48,3,Gaston,2022-01-16
11,128,31,97,3,Gaston,2022-02-10
15,187,40,147,3,Gaston,2022-02-08
17,280,47,233,3,Gaston,2022-01-08
20,212,35,177,3,Gaston,2022-01-22
22,284,63,221,3,Gaston,2022-01-17
28,387,57,330,3,Gaston,2022-01-27
28,168,39,129,3,Gaston,2022-02-09
69,615,97,518,3,Gaston,2022-01-03
88,839,157,682,3,Gaston,2022-01-11
2,45,7,38,3,Guilford,2022-03-02
2,47,10,37,3,Guilford,2022-03-04
2,23,3,20,3,Guilford,2022-03-15
3,105,27,78,3,Guilford,2022-02-22
4,185,40,145,3,Guilford,2022-02-11
4,91,24,67,3,Guilford,2022-02-13
4,94,32,62,3,Guilford,2022-02-23
6,157,36,121,3,Guilford,2022-02-16
9,117,21,96,3,Guilford,2022-02-06
12,238,41,197,3,Guilford,2022-02-08
15,156,22,134,3,Guilford,2022-06-10
19,300,56,244,3,Guilford,2022-02-07
29,423,113,310,3,Guilford,2022-01-17
29,471,82,389,3,Guilford,2022-02-01
48,897,85,812,3,Guilford,2022-01-25
0,15,4,11,3,Halifax,2022-01-30
0,23,6,17,3,Harnett,2022-02-13
4,70,13,57,3,Harnett,2022-02-10
14,392,119,273,3,Harnett,2022-01-25
5,130,36,94,3,Haywood,2022-01-05
8,46,27,19,3,Haywood,2022-02-21
11,187,63,124,3,Haywood,2022-01-10
6,71,28,43,3,Henderson,2022-01-15
6,22,10,12,3,Henderson,2022-02-13
8,104,53,51,3,Henderson,2022-01-17
8,91,34,57,3,Henderson,2022-02-09
9,100,32,68,3,Henderson,2022-02-03
12,147,54,93,3,Henderson,2022-01-26
14,188,35,153,3,Henderson,2022-01-07
30,264,118,146,3,Henderson,2022-01-20
5,101,32,69,3,Iredell,2022-01-30
10,175,56,119,3,Iredell,2022-01-22
12,202,100,102,3,Iredell,2022-01-23
21,373,99,274,3,Iredell,2022-01-07
23,218,63,155,3,Iredell,2022-01-08
29,473,104,369,3,Iredell,2022-01-14
32,376,106,270,3,Iredell,2022-01-26
43,568,220,348,3,Iredell,2022-01-18
6,99,24,75,3,Johnston,2022-02-11
8,69,15,54,3,Johnston,2022-02-12
11,143,32,111,3,Johnston,2022-02-08
13,125,27,98,3,Johnston,2022-01-30
18,186,44,142,3,Johnston,2022-02-04
42,600,110,490,3,Johnston,2022-01-25
4,34,7,27,3,Lee,2022-02-08
4,24,5,19,3,Lenoir,2022-02-09
10,90,23,67,3,Lincoln,2022-02-04
23,306,88,218,3,Lincoln,2022-01-13
35,337,83,254,3,Lincoln,2022-01-19
11,105,25,80,3,Macon,2022-01-20
1,12,0,12,3,Madison,2022-01-09
3,60,21,39,3,McDowell,2022-02-10
9,37,11,26,3,McDowell,2022-02-11
3,122,28,94,3,Mecklenburg,2022-02-20
6,193,24,169,3,Mecklenburg,2022-02-12
6,82,15,67,3,Mecklenburg,2022-03-03
7,177,30,147,3,Mecklenburg,2022-02-13
14,221,37,184,3,Mecklenburg,2022-02-18
20,299,43,256,3,Mecklenburg,2022-02-16
23,354,45,309,3,Mecklenburg,2022-02-05
31,456,82,374,3,Mecklenburg,2022-02-10
55,911,130,781,3,Mecklenburg,2022-02-02
62,1162,142,1020,3,Mecklenburg,2021-12-26
69,1145,161,984,3,Mecklenburg,2021-12-24
82,1334,154,1180,3,Mecklenburg,2022-01-27
105,1651,196,1455,3,Mecklenburg,2021-12-22
112,1886,191,1695,3,Mecklenburg,2021-12-23
113,1725,325,1400,3,Mecklenburg,2022-01-08
187,3061,361,2700,3,Mecklenburg,2022-01-14
0,19,4,15,3,Moore,2022-02-06
3,26,11,15,3,Moore,2022-01-16
17,182,34,148,3,Moore,2022-01-26
4,27,2,25,3,Nash,2022-02-15
26,163,26,137,3,Nash,2022-01-31
0,20,3,17,3,New Hanover,2022-02-25
1,41,15,26,3,New Hanover,2022-02-12
1,90,28,62,3,New Hanover,2022-02-14
4,53,12,41,3,New Hanover,2022-02-21
16,196,53,143,3,New Hanover,2022-02-03
18,508,128,380,3,New Hanover,2022-01-25
24,361,78,283,3,New Hanover,2022-01-27
31,770,217,553,3,New Hanover,2022-01-24
43,742,132,610,3,New Hanover,2022-01-11
4,49,12,37,3,Northampton,2022-01-24
1,7,2,5,3,Onslow,2022-03-10
2,59,6,53,3,Onslow,2022-02-16
4,199,37,162,3,Onslow,2022-02-03
7,273,22,251,3,Onslow,2022-01-23
10,159,22,137,3,Onslow,2022-02-04
21,305,39,266,3,Onslow,2022-01-27
27,516,89,427,3,Onslow,2022-01-25
76,1042,137,905,3,Onslow,2022-01-10
1,20,1,19,3,Pitt,2022-02-12
1,11,2,9,3,Pitt,2022-02-19
3,48,7,41,3,Pitt,2022-02-05
1,51,12,39,3,Randolph,2022-02-14
1,31,7,24,3,Randolph,2022-02-18
1,36,12,24,3,Randolph,2022-02-21
5,44,15,29,3,Randolph,2022-02-05
11,84,29,55,3,Randolph,2022-02-09
30,403,107,296,3,Randolph,2022-01-20
3,53,22,31,3,Robeson,2022-01-29
3,44,15,29,3,Robeson,2022-02-11
4,56,24,32,3,Robeson,2022-01-30
5,49,27,22,3,Robeson,2022-02-05
11,166,57,109,3,Robeson,2022-01-28
16,195,60,135,3,Robeson,2022-01-27
0,2,0,2,3,Rockingham,2022-03-09
1,38,1,37,3,Rockingham,2022-01-29
8,72,8,64,3,Rockingham,2022-02-02
9,84,22,62,3,Rowan,2022-01-22
9,82,9,73,3,Rowan,2022-02-10
9,68,4,64,3,Rowan,2022-02-11
28,279,43,236,3,Rowan,2022-01-26
43,402,43,359,3,Rowan,2022-01-04
50,477,89,388,3,Rowan,2022-01-24
63,610,96,514,3,Rowan,2022-01-11
66,561,60,501,3,Rowan,2022-01-12
4,55,12,43,3,Rutherford,2022-02-04
13,115,42,73,3,Rutherford,2022-01-31
1,10,2,8,3,Stokes,2022-01-16
1,14,2,12,3,Stokes,2022-02-18
2,56,9,47,3,Stokes,2022-01-22
11,80,18,62,3,Stokes,2022-01-06
2,14,10,4,3,Surry,2022-01-16
5,75,25,50,3,Surry,2022-02-08
6,40,15,25,3,Surry,2022-02-06
8,65,25,40,3,Surry,2022-02-04
10,67,34,33,3,Surry,2022-01-23
1,89,16,73,3,Union,2021-12-14
4,58,17,41,3,Union,2022-02-12
5,107,22,85,3,Union,2022-02-11
10,127,33,94,3,Union,2022-01-29
14,213,38,175,3,Union,2022-01-22
42,497,93,404,3,Union,2022-01-17
49,667,121,546,3,Union,2022-01-24
54,673,131,542,3,Union,2022-01-20
60,672,145,527,3,Union,2022-01-07
0,2,2,0,3,Vance,2022-02-19
1,70,8,62,3,Wake,2022-03-18
8,241,21,220,3,Wake,2022-02-19
12,130,8,122,3,Wake,2022-03-07
15,463,25,438,3,Wake,2022-01-22
18,416,41,375,3,Wake,2022-01-16
19,395,49,346,3,Wake,2022-02-17
22,377,41,336,3,Wake,2022-02-18
22,272,27,245,3,Wake,2022-02-23
25,529,65,464,3,Wake,2022-01-30
58,1344,94,1250,3,Wake,2022-02-02
72,907,78,829,3,Wake,2022-05-11
125,2541,162,2379,3,Wake,2022-01-26
143,2819,144,2675,3,Wake,2022-01-15
230,4145,230,3915,3,Wake,2022-01-20
273,3944,232,3712,3,Wake,2021-12-28
339,6163,399,5764,3,Wake,2022-01-18
386,5670,261,5409,3,Wake,2022-01-06
474,6671,306,6365,3,Wake,2022-01-04
2,35,5,30,3,Warren,2022-01-08
2,22,13,9,3,Wayne,2022-02-28
8,82,36,46,3,Wayne,2022-02-10
16,156,36,120,3,Wayne,2022-01-21
26,345,167,178,3,Wayne,2022-01-25
4,52,32,20,3,Wilkes,2022-01-30
7,80,29,51,3,Wilkes,2022-02-03
11,76,31,45,3,Wilkes,2022-02-04
14,183,80,103,3,Wilkes,2022-01-18
1,13,2,11,3,Wilson,2022-02-13
4,61,5,56,3,Wilson,2022-02-03
8,79,22,57,3,Wilson,2022-01-28
0,57,9,48,4,Alamance,2022-02-05
16,275,28,247,4,Alamance,2022-01-27
19,301,68,233,4,Brunswick,2022-01-25
7,86,27,59,4,Buncombe,2022-02-13
7,96,24,72,4,Buncombe,2022-02-16
14,261,60,201,4,Buncombe,2022-01-15
21,426,117,309,4,Buncombe,2022-01-26
29,367,138,229,4,Buncombe,2022-01-31
33,449,142,307,4,Buncombe,2022-01-25
46,742,214,528,4,Buncombe,2022-01-13
7,139,50,89,4,Burke,2022-02-07
7,75,15,60,4,Cabarrus,2022-02-15
10,235,70,165,4,Cabarrus,2022-02-02
28,264,100,164,4,Cabarrus,2022-01-02
45,656,153,503,4,Cabarrus,2022-01-19
3,81,22,59,4,Caldwell,2022-02-07
20,135,23,112,4,Caldwell,2022-01-15
2,21,10,11,4,Catawba,2022-03-09
7,148,74,74,4,Catawba,2022-02-08
14,114,48,66,4,Catawba,2022-02-09
75,664,232,432,4,Catawba,2022-01-14
40,332,52,280,4,Cleveland,2022-01-24
6,35,8,27,4,Cumberland,2022-02-19
37,685,66,619,4,Cumberland,2022-01-27
126,1548,168,1380,4,Cumberland,2022-01-10
12,95,14,81,4,Davidson,2022-02-09
32,562,33,529,4,Durham,2022-01-09
0,21,3,18,4,Forsyth,2022-03-10
2,34,5,29,4,Forsyth,2022-03-01
3,100,21,79,4,Forsyth,2022-02-18
4,80,10,70,4,Forsyth,2022-01-16
20,289,33,256,4,Forsyth,2022-02-04
39,664,28,636,4,Forsyth,2022-01-08
42,543,64,479,4,Forsyth,2022-01-27
45,756,60,696,4,Forsyth,2022-01-15
49,551,88,463,4,Forsyth,2022-01-31
65,864,120,744,4,Forsyth,2021-12-30
3,30,7,23,4,Gaston,2022-02-20
4,46,8,38,4,Gaston,2022-02-23
22,242,73,169,4,Gaston,2022-02-07
26,310,69,241,4,Gaston,2022-02-01
46,536,116,420,4,Gaston,2022-01-25
54,656,85,571,4,Gaston,2022-01-06
55,618,110,508,4,Gaston,2022-01-24
74,866,129,737,4,Gaston,2022-01-19
4,104,23,81,4,Guilford,2022-02-18
4,63,17,46,4,Guilford,2022-02-24
11,234,36,198,4,Guilford,2022-01-30
16,227,51,176,4,Guilford,2022-02-10
23,359,34,325,4,Guilford,2022-01-22
36,533,77,456,4,Guilford,2022-01-28
42,874,72,802,4,Guilford,2022-01-15
54,800,78,722,4,Guilford,2022-01-09
93,1630,255,1375,4,Guilford,2022-01-14
130,2048,341,1707,4,Guilford,2022-01-10
7,150,54,96,4,Haywood,2022-01-24
3,47,11,36,4,Iredell,2022-02-17
10,211,48,163,4,Iredell,2022-01-28
21,379,151,228,4,Iredell,2022-01-25
44,576,197,379,4,Iredell,2022-01-04
4,104,21,83,4,Johnston,2022-01-29
13,230,37,193,4,Johnston,2022-02-03
17,146,48,98,4,Lincoln,2022-01-27
24,324,63,261,4,Mecklenburg,2022-02-15
25,495,81,414,4,Mecklenburg,2022-02-09
93,1755,310,1445,4,Mecklenburg,2022-01-21
112,1530,254,1276,4,Mecklenburg,2022-01-17
128,2162,337,1825,4,Mecklenburg,2022-01-24
237,3496,570,2926,4,Mecklenburg,2021-12-29
268,3480,573,2907,4,Mecklenburg,2022-01-07
6,74,14,60,4,Moore,2022-02-07
2,39,7,32,4,New Hanover,2022-02-22
67,774,167,607,4,New Hanover,2022-01-10
10,90,10,80,4,Onslow,2022-01-22
14,326,37,289,4,Onslow,2022-01-28
2,26,4,22,4,Randolph,2022-01-16
41,242,83,159,4,Randolph,2022-01-31
1,10,3,7,4,Robeson,2022-03-01
15,156,74,82,4,Robeson,2022-01-23
56,528,148,380,4,Robeson,2022-01-20
5,83,13,70,4,Rockingham,2022-01-22
27,284,40,244,4,Rockingham,2022-01-20
19,219,27,192,4,Rowan,2022-01-15
2,19,1,18,4,Stokes,2022-02-17
3,30,12,18,4,Surry,2022-02-15
6,81,28,53,4,Surry,2022-01-22
6,56,17,39,4,Surry,2022-01-29
9,88,24,64,4,Union,2022-02-06
10,176,73,103,4,Union,2022-02-04
0,52,8,44,4,Wake,2022-03-05
5,96,7,89,4,Wake,2022-03-09
22,453,65,388,4,Wake,2022-02-15
25,380,28,352,4,Wake,2022-02-12
54,1062,90,972,4,Wake,2022-02-04
173,3187,282,2905,4,Wake,2022-01-17
201,3211,115,3096,4,Wake,2022-01-08
220,4432,289,4143,4,Wake,2022-01-24
356,5937,294,5643,4,Wake,2022-01-12
6,93,43,50,4,Wayne,2022-02-04
9,212,83,129,4,Wilkes,2022-01-20
10,144,28,116,4,Wilson,2022-01-26
30,319,60,259,4,Wilson,2022-01-07
6,64,10,54,5,Alamance,2022-02-06
73,768,70,698,5,Alamance,2022-01-11
0,11,4,7,5,Bladen,2022-02-10
1,40,14,26,5,Buncombe,2022-02-20
9,114,24,90,5,Buncombe,2022-02-05
38,629,218,411,5,Buncombe,2022-01-24
21,304,65,239,5,Cabarrus,2022-01-15
65,851,213,638,5,Cabarrus,2022-01-10
0,7,2,5,5,Catawba,2022-03-17
21,197,76,121,5,Catawba,2022-02-02
24,225,61,164,5,Catawba,2022-01-08
29,287,116,171,5,Catawba,2022-01-28
2,40,7,33,5,Cumberland,2022-02-13
10,247,42,205,5,Cumberland,2022-01-23
95,1589,134,1455,5,Cumberland,2022-01-24
1,32,1,31,5,Forsyth,2022-02-20
8,64,8,56,5,Forsyth,2022-02-12
9,203,26,177,5,Forsyth,2022-01-30
35,496,65,431,5,Forsyth,2022-01-28
69,1166,122,1044,5,Forsyth,2022-01-20
96,1466,126,1340,5,Forsyth,2022-01-14
97,1242,122,1120,5,Forsyth,2022-01-19
7,64,11,53,5,Gaston,2022-02-16
9,201,44,157,5,Gaston,2022-01-23
12,111,24,87,5,Gaston,2022-02-05
20,168,46,122,5,Gaston,2022-02-04
28,324,63,261,5,Gaston,2022-01-28
0,22,2,20,5,Guilford,2022-03-05
6,145,23,122,5,Guilford,2022-02-05
8,122,33,89,5,Guilford,2022-02-21
20,335,67,268,5,Guilford,2022-02-03
26,497,94,403,5,Guilford,2022-01-02
15,180,62,118,5,Henderson,2022-01-25
7,211,70,141,5,Iredell,2022-02-02
12,154,47,107,5,Iredell,2022-02-04
33,456,85,371,5,Johnston,2022-01-26
11,162,30,132,5,Mecklenburg,2022-02-23
62,772,113,659,5,Mecklenburg,2022-02-03
68,941,138,803,5,Mecklenburg,2022-02-01
173,2792,405,2387,5,Mecklenburg,2022-01-20
250,3376,381,2995,5,Mecklenburg,2021-12-28
307,4528,715,3813,5,Mecklenburg,2022-01-10
5,85,31,54,5,Randolph,2022-01-30
21,280,81,199,5,Randolph,2022-01-25
5,27,9,18,5,Surry,2022-02-17
10,110,35,75,5,Surry,2022-02-01
25,209,50,159,5,Union,2022-02-03
58,725,131,594,5,Union,2022-01-06
56,1186,98,1088,5,Wake,2022-02-07
102,1974,126,1848,5,Wake,2022-01-27
301,5083,238,4845,5,Wake,2022-01-13
16,138,42,96,5,Wilkes,2022-01-25
51,641,174,467,6,Cabarrus,2022-01-14
11,179,54,125,6,Catawba,2022-01-23
9,202,28,174,6,Cumberland,2022-01-30
38,509,49,460,6,Cumberland,2022-01-21
7,142,40,102,6,Forsyth,2022-02-16
10,99,33,66,6,Gaston,2022-02-15
11,76,17,59,6,Gaston,2022-02-12
15,168,30,138,6,Gaston,2022-01-29
37,316,61,255,6,Gaston,2022-01-15
100,1839,216,1623,6,Guilford,2022-01-12
10,236,40,196,6,Mecklenburg,2022-01-16
27,550,91,459,6,Mecklenburg,2022-01-30
39,767,161,606,6,Mecklenburg,2022-01-22
65,1135,138,997,6,Mecklenburg,2022-01-28
120,1585,250,1335,6,Mecklenburg,2022-01-26
211,3257,445,2812,6,Mecklenburg,2022-01-18
316,4094,639,3455,6,Mecklenburg,2022-01-06
358,4441,585,3856,6,Mecklenburg,2022-01-04
21,296,33,263,6,Pitt,2022-01-27
26,137,32,105,6,Stokes,2022-01-20
9,99,22,77,6,Surry,2022-01-08
11,232,40,192,6,Wake,2022-02-13
27,608,68,540,6,Wake,2022-01-29
33,619,62,557,6,Wake,2022-02-10
48,1076,128,948,6,Wake,2022-01-23
70,1109,151,958,6,Wake,2022-01-21
53,918,88,830,7,Forsyth,2022-01-21
8,148,26,122,7,Guilford,2022-01-16
32,488,47,441,7,Guilford,2022-01-23
69,1272,212,1060,7,Guilford,2022-01-18
78,1195,172,1023,7,Guilford,2022-01-24
79,1349,167,1182,7,Guilford,2022-01-20
144,2012,179,1833,7,Guilford,2022-01-11
23,341,48,293,7,Mecklenburg,2022-02-06
49,688,112,576,7,Mecklenburg,2022-02-07
122,1818,305,1513,7,Mecklenburg,2022-01-02
203,3194,417,2777,7,Mecklenburg,2022-01-19
283,3537,655,2882,7,Mecklenburg,2021-12-30
296,4120,689,3431,7,Mecklenburg,2022-01-11
3,20,11,9,7,Surry,2022-02-12
27,330,81,249,8,Cabarrus,2022-01-28
11,109,21,88,8,Cleveland,2022-02-03
25,279,50,229,8,Forsyth,2022-02-07
84,731,134,597,8,Gaston,2022-01-18
14,321,47,274,8,Guilford,2022-02-04
28,514,97,417,8,Mecklenburg,2022-01-29
68,1001,169,832,8,Mecklenburg,2022-01-23
39,887,88,799,8,Wake,2022-02-08
8,113,8,105,9,Forsyth,2022-02-06
52,753,106,647,9,Guilford,2022-01-26
75,1172,189,983,9,Mecklenburg,2022-01-31
70,1011,112,899,10,Forsyth,2022-01-24
48,654,93,561,10,Guilford,2022-01-27
233,3723,504,3219,10,Mecklenburg,2022-01-13
9,69,9,60,10,Onslow,2022-01-29
45,578,109,469,11,Mecklenburg,2022-02-08
115,1812,305,1507,11,Mecklenburg,2022-01-25
53,669,91,578,12,Mecklenburg,2022-02-04
